0 0 0 0 13 0 0 0 13 0 0 0
0 0 0 18 13 13 18 13 13 18 0 0
0 0 18 18 13 13 13 13 13 18 18 0
0 18 18 13 18 18 18 18 18 13 18 18
0 18 13 18 18 18 14 18 18 18 13 18
0 18 18 18 18 14 14 14 18 18 18 18
0 18 18 14 14 14 14 14 14 14 18 18
18 18 18 14 16 14 14 14 16 14 18 18
18 18 18 14 16 14 14 14 16 14 18 18
18 18 18 10 10 14 13 14 10 10 18 18
0 18 18 18 14 14 14 14 14 18 18 18
0 0 0 0 0 1 1 1 0 0 0 0
---
0 0 0 0 18 0 0 0 18 0 0 0
0 0 0 13 18 18 16 18 18 14 0 0
0 0 13 13 18 18 18 18 18 14 14 0
0 13 13 18 13 13 13 13 14 1 14 14
0 13 18 13 13 13 18 14 14 14 1 14
0 18 13 13 13 18 18 18 14 14 14 14
0 18 18 18 18 18 18 18 18 18 14 14
18 18 18 18 10 18 18 18 10 18 14 14
18 18 18 18 10 18 18 18 10 18 14 14
18 18 18 18 18 18 1 18 18 18 14 14
0 14 14 14 18 18 18 18 18 14 14 14
0 0 0 0 0 16 16 16 0 0 0 0
