0 0 0 0 0 0 0 0 0 0 0 16 16 16 16 16 0 0 0 0 0 0
0 0 0 0 0 0 0 0 0 16 16 14 14 14 14 7 16 0 0 0 0 0
0 0 0 0 0 0 0 0 16 14 14 7 7 7 7 16 0 0 0 0 0 0
0 0 0 0 0 0 0 16 7 16 7 7 16 16 7 7 16 0 0 0 0 0
0 0 0 0 0 0 16 7 7 7 7 7 7 7 7 7 16 0 0 0 0 0
0 0 0 0 0 16 7 14 16 16 7 14 14 16 16 7 7 16 0 0 0 0
0 0 0 0 0 16 7 14 16 16 7 14 14 16 16 7 7 16 0 0 0 0
0 0 0 0 16 14 7 14 14 14 7 14 14 14 14 7 7 16 0 0 0 0
0 0 0 16 16 16 10 10 7 7 7 7 7 7 10 10 7 16 0 0 0 0
0 0 16 14 14 7 16 7 7 7 12 12 7 7 7 7 7 7 16 0 0 0
0 0 16 7 7 7 16 7 7 7 12 12 7 7 7 7 7 2 15 16 0 0
0 0 16 16 16 16 15 2 2 7 7 7 7 7 7 7 2 15 15 15 16 0
0 16 16 15 5 5 15 15 15 2 2 2 7 2 2 2 5 15 15 15 16 0
16 7 14 2 2 2 2 2 15 15 15 15 2 5 5 5 15 16 16 2 7 16
16 14 14 14 14 14 7 7 2 2 15 15 15 5 5 5 15 15 7 7 7 16
16 14 14 14 14 7 7 7 7 7 2 15 15 15 15 15 15 16 7 7 16 0
16 7 7 7 16 7 16 7 7 7 7 2 15 15 15 15 15 16 16 16 0 0
16 7 2 7 7 16 7 7 7 7 7 7 2 15 15 15 15 16 0 0 0 0
0 16 15 2 2 2 2 2 2 2 2 2 2 2 2 2 2 15 16 0 0 0
0 16 16 15 15 15 15 15 15 15 15 15 15 5 5 5 15 15 16 0 0 0
0 0 16 5 5 5 15 15 2 15 15 15 15 15 5 5 15 16 0 0 0 0
0 0 16 16 2 2 2 16 16 16 16 16 16 2 2 2 16 16 0 0 0 0
0 0 0 16 7 7 7 16 0 0 0 0 16 7 7 7 16 0 0 0 0 0
0 0 0 0 16 16 16 0 0 0 0 0 0 16 16 16 0 0 0 0 0 0
---
0 0 0 0 0 0 0 0 0 0 0 7 7 7 7 7 0 0 0 0 0 0
0 0 0 0 0 0 0 0 0 7 7 16 16 16 16 16 7 0 0 0 0 0
0 0 0 0 0 0 0 0 7 16 16 16 16 16 16 7 0 0 0 0 0 0
0 0 0 0 0 0 0 7 16 7 16 16 2 2 16 16 7 0 0 0 0 0
0 0 0 0 0 0 7 16 16 16 16 16 16 16 16 16 7 0 0 0 0 0
0 0 0 0 0 7 16 15 15 15 16 15 15 15 15 16 16 7 0 0 0 0
0 0 0 0 0 7 16 15 15 15 16 15 15 15 15 16 16 7 0 0 0 0
0 0 0 0 7 16 16 15 15 15 16 15 15 15 15 16 16 7 0 0 0 0
0 0 0 7 7 7 15 15 16 16 16 16 16 16 15 15 16 7 0 0 0 0
0 0 7 16 16 16 7 16 16 16 5 5 16 16 16 16 16 16 7 0 0 0
0 0 7 16 16 16 7 16 16 16 5 5 16 16 16 16 16 16 2 7 0 0
0 0 7 7 7 7 2 16 16 16 16 16 16 16 16 16 16 2 2 2 7 0
0 7 7 12 12 12 2 2 2 16 16 16 16 16 16 16 16 2 2 2 7 0
7 12 15 7 7 7 7 7 2 2 2 2 16 16 16 16 2 2 2 5 14 7
7 15 15 15 15 15 15 15 7 7 2 2 2 16 16 16 2 2 14 14 14 7
7 15 15 15 15 15 15 15 15 15 7 2 2 2 2 2 2 7 14 14 7 0
7 15 15 15 10 15 10 15 15 15 15 7 2 2 2 2 2 7 7 7 0 0
7 15 7 15 15 10 15 15 15 15 15 15 7 2 2 2 2 7 0 0 0 0
0 7 14 7 7 7 7 7 7 7 7 7 7 7 7 7 7 2 7 0 0 0
0 7 7 14 14 14 14 14 14 14 14 14 14 14 14 14 2 2 7 0 0 0
0 0 7 14 14 14 14 14 10 14 14 14 14 14 14 14 2 7 0 0 0 0
0 0 7 7 5 5 5 7 7 7 7 7 7 5 5 5 7 7 0 0 0 0
0 0 0 7 5 5 5 7 0 0 0 0 7 5 5 5 7 0 0 0 0 0
0 0 0 0 7 7 7 0 0 0 0 0 0 7 7 7 0 0 0 0 0 0
