0 0 0 0 0 0 0 0 0 0 0 0 0 0 17 17 17 17 17 0 0 0 0
0 0 0 0 0 0 0 0 0 0 0 0 0 17 6 6 6 6 6 17 0 0 0
0 0 0 0 0 0 17 17 17 17 17 0 17 6 6 6 14 14 6 6 17 0 0
0 0 0 0 17 17 5 5 5 5 5 17 17 6 6 6 17 14 6 6 6 17 0
0 0 0 17 5 5 5 5 5 5 5 5 17 6 6 6 17 14 6 6 6 17 0
0 0 17 5 5 5 5 5 5 5 5 5 17 6 6 6 6 6 6 6 6 6 17
0 17 5 5 5 5 5 5 5 5 5 5 5 17 15 15 15 6 6 6 6 6 17
0 17 5 5 5 5 5 5 5 5 5 5 5 5 17 17 17 6 6 6 6 6 17
17 17 5 5 5 5 5 5 5 5 5 5 5 5 5 17 14 17 6 6 6 6 17
17 14 17 17 5 5 5 5 5 5 5 5 17 17 17 14 14 17 6 6 6 6 17
17 14 14 14 17 17 17 17 17 17 17 17 14 14 14 14 17 6 6 6 6 17 0
0 17 17 14 14 14 14 14 14 14 14 14 14 17 17 17 17 17 6 6 17 0 0
0 17 6 17 17 17 17 17 17 17 17 17 17 6 17 15 15 17 17 17 17 0 0
17 6 6 17 15 15 15 15 15 15 17 6 6 6 17 15 15 15 17 17 17 0 0
17 6 6 6 17 17 15 15 15 17 17 6 6 6 17 15 17 17 6 6 6 17 0
17 6 6 6 17 0 17 17 17 17 6 6 6 17 17 17 0 17 6 6 6 17 0
0 17 17 17 0 0 0 0 0 0 17 17 17 0 0 0 0 0 17 17 17 0 0
---
0 0 0 0 0 0 0 0 0 0 0 0 0 0 5 5 5 5 5 0 0 0 0
0 0 0 0 0 0 0 0 0 0 0 0 0 5 17 17 17 17 17 5 0 0 0
0 0 0 0 0 0 5 5 5 5 5 0 5 17 17 17 15 15 17 17 5 0 0
0 0 0 0 5 5 6 6 6 6 6 5 5 17 17 17 15 15 17 17 17 5 0
0 0 0 5 6 6 6 6 6 6 6 6 5 17 17 17 15 15 17 17 17 5 0
0 0 5 6 6 6 6 6 6 6 6 6 5 17 17 17 17 17 17 17 17 17 5
0 5 6 6 6 6 6 6 6 6 6 6 6 5 17 17 17 17 17 17 17 17 5
0 5 6 6 6 6 6 6 6 6 6 6 6 6 5 5 5 17 17 17 17 17 5
5 5 6 6 6 6 6 6 6 6 6 6 6 6 6 5 17 5 17 17 17 17 5
5 17 5 5 6 6 6 6 6 6 6 6 5 5 5 17 17 5 17 17 17 17 5
5 17 17 17 5 5 5 5 5 5 5 5 17 17 17 17 5 17 17 17 17 5 0
0 14 14 17 17 17 17 17 17 17 17 17 17 6 6 5 5 5 17 17 5 0 0
0 14 17 14 14 14 14 14 14 14 6 6 6 17 6 17 17 5 5 5 5 0 0
14 17 17 14 17 17 17 17 17 17 6 17 17 17 6 17 17 17 5 15 15 0 0
14 17 17 17 14 14 17 17 17 14 6 17 17 17 6 17 15 15 17 17 17 15 0
14 17 17 17 14 0 14 14 14 14 17 17 17 6 15 15 0 15 17 17 17 15 0
0 14 14 14 0 0 0 0 0 0 6 6 6 0 0 0 0 0 15 15 15 0 0
