0 18 18 18 18 18 18 18 18 18 18 18 18 18 18 18 18 0
18 17 6 6 6 6 6 6 6 6 6 6 6 6 6 6 17 18
18 6 6 17 17 17 6 6 6 6 6 6 17 17 17 6 6 18
18 17 17 17 17 17 17 17 17 17 17 17 17 17 17 17 17 18
18 17 5 5 5 5 5 5 5 5 5 5 5 5 5 5 17 18
18 17 5 5 8 8 8 8 8 8 8 8 8 8 5 5 17 18
18 17 5 8 17 14 17 17 17 17 17 17 14 17 8 5 17 18
18 17 5 8 14 14 14 17 14 14 17 14 14 14 8 5 17 18
18 17 5 8 17 14 17 17 17 17 17 17 14 17 8 5 17 18
18 17 5 5 8 8 8 8 8 8 8 8 8 8 5 5 17 18
18 17 17 5 5 5 5 5 5 5 5 5 5 5 5 17 17 18
18 17 17 17 17 17 17 17 17 17 17 17 17 17 17 17 17 18
18 5 17 17 17 17 5 5 5 5 5 5 17 17 17 17 5 18
0 18 18 18 18 18 18 18 18 18 18 18 18 18 18 18 18 0
---
0 17 17 17 17 17 17 17 17 17 17 17 17 17 17 17 17 0
17 17 5 5 5 5 5 5 5 5 5 5 5 5 5 5 17 17
17 5 5 5 5 5 5 5 5 5 5 5 5 5 5 5 5 17
17 18 18 18 18 18 18 18 18 18 18 18 18 18 18 18 18 17
17 18 8 17 17 17 17 17 17 17 17 17 17 17 17 8 18 17
17 18 8 17 6 6 6 6 6 6 6 6 6 6 17 8 18 17
17 18 8 5 5 6 14 14 14 14 14 14 6 6 5 8 18 17
17 18 8 5 6 6 6 17 6 6 17 6 6 6 5 8 18 17
17 18 8 5 5 6 14 14 14 14 14 14 6 6 5 8 18 17
17 18 8 8 5 5 5 5 5 5 5 5 5 5 8 8 18 17
17 18 18 8 8 8 8 8 8 8 8 8 8 8 8 18 18 17
17 18 18 18 18 18 18 18 18 18 18 18 18 18 18 18 18 17
17 17 18 18 18 18 17 17 17 17 17 17 18 18 18 18 17 17
0 17 17 17 17 17 17 17 17 17 17 17 17 17 17 17 17 0
