0 10 0 0 0 0 0 0 0 0 10 10
0 0 0 16 16 16 16 16 16 0 0 0
0 16 16 14 10 10 10 10 10 16 0 0
0 16 14 10 15 15 15 15 10 10 16 0
16 10 10 10 16 16 16 15 10 10 10 16
16 10 10 10 16 14 16 15 10 10 10 16
16 8 10 10 16 16 16 16 10 10 10 16
16 8 15 10 14 10 10 10 10 10 15 16
0 16 8 15 10 10 10 10 15 15 16 0
0 0 16 15 15 15 15 15 15 16 16 0
10 0 0 16 16 16 16 16 16 0 0 0
0 10 0 0 0 0 0 0 0 0 10 0
---
0 16 0 0 0 0 0 0 0 0 14 14
0 0 0 10 10 10 10 10 10 0 0 0
0 10 10 8 16 16 16 16 16 10 0 0
0 10 8 16 10 10 10 10 16 16 10 0
10 16 16 16 15 15 15 10 16 16 16 10
15 16 16 16 15 14 15 10 16 16 16 10
15 16 16 16 15 15 15 15 16 16 16 10
15 16 10 16 14 16 16 16 16 16 10 10
0 15 16 10 16 16 16 16 10 10 10 0
0 0 15 10 10 10 10 10 10 10 10 0
15 0 0 15 10 10 10 10 10 0 0 0
0 15 0 0 0 0 0 0 0 0 8 0
