0 0 0 18 18 18 18 18 18 0 0 0
0 0 18 3 3 3 3 3 3 18 0 0
0 0 18 15 9 15 15 9 15 18 0 0
0 18 15 15 9 15 15 9 15 15 18 0
0 18 15 14 9 14 14 9 14 15 18 0
18 15 15 9 15 15 15 15 9 15 15 18
18 3 3 3 3 3 3 3 3 3 3 18
18 18 18 18 18 18 18 18 18 18 18 18
0 0 0 18 3 3 3 3 18 0 0 0
0 0 0 0 18 3 3 18 0 0 0 0
0 0 0 18 2 2 2 2 18 0 0 0
0 0 0 0 18 18 18 18 0 0 0 0
---
0 0 0 15 15 15 15 15 15 0 0 0
0 0 15 18 18 18 18 18 18 15 0 0
0 0 15 18 3 18 18 3 18 15 0 0
0 15 18 18 3 18 18 3 18 18 15 0
0 15 18 2 3 18 18 3 2 18 15 0
15 18 18 18 18 18 18 18 18 18 18 15
15 9 9 9 9 9 9 9 9 2 2 15
15 3 3 3 3 3 3 3 3 3 3 15
0 0 0 3 18 18 18 18 3 0 0 0
0 0 0 0 3 18 18 3 0 0 0 0
0 0 0 3 18 18 18 18 3 0 0 0
0 0 0 0 14 14 14 14 0 0 0 0
