0 0 0 0 0 0 0 0 0 18 0 0 0 0 0 0 0 0 0
0 0 0 0 0 0 0 0 18 7 18 0 0 0 0 0 0 0 0
0 0 0 0 0 18 0 18 7 7 7 18 0 18 0 0 0 0 0
0 0 0 0 18 7 18 18 7 10 7 18 18 7 18 0 0 0 0
0 18 18 0 18 7 7 10 10 10 10 10 7 7 18 0 18 18 0
0 18 7 18 7 18 7 10 10 7 10 10 7 18 7 18 7 18 0
0 18 7 7 7 10 7 10 7 7 7 10 7 10 7 7 7 18 0
0 18 10 7 7 7 10 10 7 7 7 10 10 7 7 7 10 18 0
0 0 18 10 10 10 10 10 10 7 10 10 10 10 10 10 18 0 0
0 18 6 18 18 10 10 18 18 18 18 18 10 10 18 18 5 18 0
18 6 6 6 5 18 18 5 5 5 5 5 18 18 5 5 6 6 18
0 18 18 18 6 6 6 6 6 6 6 6 6 6 6 18 18 18 0
0 0 0 0 18 18 18 18 6 6 5 18 18 18 18 0 0 0 0
0 0 0 0 0 0 0 0 18 18 18 0 0 0 0 0 0 0 0
---
0 0 0 0 0 0 0 0 0 10 0 0 0 0 0 0 0 0 0
0 0 0 0 0 0 0 0 10 6 10 0 0 0 0 0 0 0 0
0 0 0 0 0 10 0 10 6 6 6 10 0 10 0 0 0 0 0
0 0 0 0 10 10 10 10 6 18 6 10 10 18 10 0 0 0 0
0 10 10 0 10 10 10 18 18 18 18 18 18 18 10 0 10 10 0
0 10 10 10 10 10 10 18 18 5 18 18 18 10 18 10 18 10 0
0 7 10 10 10 18 5 18 5 5 5 6 18 6 18 18 18 7 0
0 7 18 10 10 5 18 18 5 5 5 6 6 18 18 18 6 7 0
0 0 7 18 18 18 18 18 18 5 6 6 6 6 6 6 7 0 0
0 7 18 7 7 18 18 7 7 7 7 7 6 6 7 7 18 7 0
7 18 18 18 18 7 7 18 18 18 18 18 7 7 18 18 18 18 7
0 7 7 7 18 18 18 18 18 18 18 18 18 18 18 7 7 7 0
0 0 0 0 7 7 7 7 18 18 18 7 7 7 7 0 0 0 0
0 0 0 0 0 0 0 0 7 7 7 0 0 0 0 0 0 0 0
