0 0 16 16 0 0 0 0 0 0 0 0 0 0 16 16 0 0
0 16 9 9 16 0 0 16 16 16 16 0 0 16 9 9 16 0
16 14 14 9 9 16 16 9 9 9 9 16 16 9 9 14 14 16
16 14 14 14 9 9 9 9 9 9 9 9 9 9 14 14 14 16
16 14 14 16 9 14 14 9 9 9 9 14 14 9 16 14 14 16
16 14 16 9 14 14 14 14 9 9 14 14 14 14 9 16 14 16
14 16 9 14 14 2 2 2 9 9 2 2 2 14 14 9 16 0
16 9 14 14 2 14 16 2 9 9 2 16 14 2 14 14 9 16
16 9 14 2 2 16 16 2 9 9 2 16 16 2 2 14 9 16
16 9 14 2 2 2 2 14 14 14 14 2 2 2 2 14 9 16
0 16 14 2 2 2 14 14 16 16 14 14 2 2 2 14 16 0
0 0 16 16 14 14 14 14 14 14 14 14 14 14 16 16 0 0
0 0 0 0 16 16 16 14 14 14 14 16 16 16 0 0 0 0
0 0 0 0 0 0 0 16 16 16 16 0 0 0 0 0 0 0
---
0 0 9 9 0 0 0 0 0 0 0 0 0 0 9 9 0 0
0 9 16 16 9 0 0 9 9 9 9 0 0 9 16 16 9 0
9 9 9 16 16 9 9 16 16 16 16 9 9 16 16 9 9 9
9 9 9 9 16 16 16 16 2 2 16 16 16 16 9 9 9 9
14 9 9 14 16 16 16 2 2 2 2 16 16 16 14 9 9 9
14 9 14 16 16 16 16 16 2 2 16 16 16 16 16 14 9 14
9 14 16 16 16 14 14 14 2 2 14 14 14 16 16 16 14 0
14 16 16 16 14 16 14 14 2 2 14 14 16 14 16 16 16 14
14 16 16 14 14 14 14 14 2 2 14 14 14 14 14 16 16 14
14 16 16 14 14 14 14 2 2 2 2 14 14 14 14 16 16 14
0 14 16 14 14 14 2 2 2 2 2 2 14 14 14 16 14 0
0 0 14 14 2 2 2 9 9 9 9 2 2 2 14 14 0 0
0 0 0 0 14 14 14 9 9 9 9 14 14 14 0 0 0 0
0 0 0 0 0 0 0 14 14 14 14 0 0 0 0 0 0 0
