0 0 0 0 0 0 0 0 18 18 18 18 18 0 0 0 0
0 0 0 0 0 0 18 18 8 19 19 8 8 18 18 0 0
0 0 0 0 18 18 5 5 5 5 19 19 19 8 19 18 0
0 0 0 18 8 9 9 18 5 5 5 19 19 19 8 19 18
0 0 18 19 19 8 8 19 18 5 5 18 9 19 19 9 18
0 18 19 9 19 19 9 8 19 18 5 5 18 9 19 9 18
18 8 8 8 19 19 19 9 8 9 18 17 18 18 18 18 0
18 19 19 9 8 19 19 9 9 18 18 17 18 7 7 7 18
18 9 19 19 19 8 9 18 18 7 18 17 18 14 14 14 18
0 18 9 9 9 19 18 7 14 14 18 17 18 14 14 14 18
0 18 18 18 18 18 7 14 14 14 18 17 18 14 14 18 0
0 18 7 14 7 14 14 14 14 7 18 17 18 18 18 0 0
0 0 18 7 14 14 14 14 7 18 18 18 0 0 0 0 0
0 0 0 18 18 18 18 18 18 0 0 0 0 0 0 0 0
---
0 0 0 0 0 0 0 0 9 9 9 9 9 0 0 0 0
0 0 0 0 0 0 9 9 9 18 18 17 17 9 9 0 0
0 0 0 0 9 9 18 18 18 18 18 18 18 17 18 9 0
0 0 0 9 18 18 18 14 18 18 18 18 18 18 17 18 9
0 0 7 18 18 18 18 18 14 18 18 14 18 18 18 17 9
0 7 18 18 18 18 18 18 18 14 18 18 14 18 18 17 9
7 18 18 18 18 18 18 18 18 18 14 14 14 14 14 9 0
7 18 18 18 18 18 18 18 18 19 19 14 14 5 5 5 8
7 18 18 18 18 18 18 19 19 19 14 14 14 5 5 5 8
0 7 18 18 18 18 19 19 19 19 14 14 14 5 5 5 8
0 7 19 19 19 19 19 19 19 19 14 14 14 5 5 8 0
0 7 19 19 19 19 19 19 19 19 8 14 8 8 8 0 0
0 0 7 19 19 19 19 19 19 8 8 8 0 0 0 0 0
0 0 0 7 7 8 8 8 8 0 0 0 0 0 0 0 0
