0 0 0 0 0 0 0 0 16 9 9 0 0 0 0 0 0 0 0 0 0 0 0 0 0 0 0 0 0 0 0 0 0
0 0 0 0 0 0 0 9 9 16 16 9 9 0 0 0 0 0 0 0 0 0 0 0 0 0 0 0 0 0 0 0 0
0 0 0 0 0 0 0 16 16 9 9 16 16 9 9 0 0 0 0 0 0 0 0 0 0 0 0 0 0 0 0 0 0
0 0 0 0 0 0 0 0 0 16 16 9 9 16 16 9 9 18 0 0 0 0 0 0 0 0 0 0 0 0 0 0 0
0 0 0 0 0 0 0 0 18 18 18 16 16 9 9 16 16 9 9 18 18 18 0 0 0 0 0 0 0 0 0 0 0
0 0 0 0 0 12 12 12 12 14 14 14 1 16 16 9 9 16 16 9 9 14 18 18 0 0 0 0 0 0 0 0 0
0 0 0 12 12 14 14 14 14 12 1 1 1 1 1 16 16 9 9 16 16 9 9 14 18 18 0 0 0 0 0 0 0
0 0 12 7 14 10 10 10 7 14 12 8 8 8 8 8 2 16 16 9 9 16 16 9 9 14 18 0 0 0 0 0 0
0 0 12 7 10 10 14 14 14 7 12 2 5 2 5 2 2 19 19 16 16 9 9 16 16 9 9 18 0 0 0 0 0
0 18 12 7 10 14 7 10 10 12 12 12 12 15 15 15 15 2 2 15 2 16 16 9 9 16 16 9 9 0 0 0 0
0 18 12 7 10 7 7 7 12 8 14 14 14 12 9 9 15 5 5 15 15 15 2 16 16 9 9 16 16 9 9 0 0
18 14 12 7 7 10 10 12 8 14 14 14 14 14 12 2 2 15 2 2 2 15 15 2 2 16 16 9 9 16 16 9 9
18 14 1 12 7 7 7 12 8 14 14 19 19 14 14 12 9 15 15 9 5 2 5 5 2 2 1 16 16 9 9 16 16
18 14 1 1 12 12 12 12 8 14 14 19 19 19 14 12 2 2 15 2 5 9 2 15 2 2 1 1 14 16 16 16 0
18 3 14 1 2 15 2 12 8 8 14 14 19 19 14 12 2 15 5 2 2 9 2 15 2 2 1 14 3 18 0 0 0
0 18 14 14 2 15 2 19 12 8 8 14 14 14 14 12 5 15 2 2 15 5 15 5 5 2 14 14 18 0 0 0 0
0 18 13 14 14 2 15 2 2 12 8 8 8 8 12 12 5 5 5 15 15 2 2 2 2 14 14 13 18 0 0 0 0
0 0 18 3 14 14 14 2 9 2 12 12 12 12 12 5 5 5 2 2 2 2 2 14 14 14 3 18 0 0 0 0 0
0 0 18 3 13 14 14 14 14 2 9 9 5 5 5 2 2 2 2 2 2 14 14 14 3 13 3 18 0 0 0 0 0
0 0 0 18 3 3 13 3 14 14 14 14 2 9 9 2 2 2 14 14 14 14 3 13 3 3 18 0 0 0 0 0 0
0 0 0 0 18 3 13 3 13 13 3 14 14 14 14 14 14 14 14 3 13 13 3 13 3 18 0 0 0 0 0 0 0
0 0 0 0 0 18 3 3 3 13 3 13 13 13 3 3 13 13 13 3 13 3 3 3 18 0 0 0 0 0 0 0 0
0 0 0 0 0 0 18 3 3 3 3 3 13 13 3 3 13 13 3 3 3 3 3 18 0 0 0 0 0 0 0 0 0
0 0 0 0 0 0 0 18 18 4 3 3 3 3 3 3 3 3 3 3 4 18 18 0 0 0 0 0 0 0 0 0 0
0 0 0 0 0 0 0 0 0 18 4 4 1 3 3 3 3 1 4 4 18 0 0 0 0 0 0 0 0 0 0 0 0
0 0 0 0 0 0 0 0 0 0 18 18 18 1 1 1 1 18 18 18 0 0 0 0 0 0 0 0 0 0 0 0 0
0 0 0 0 0 0 0 0 0 0 0 0 0 18 18 18 18 0 0 0 0 0 0 0 0 0 0 0 0 0 0 0 0
---
0 0 0 0 0 0 0 0 14 18 18 0 0 0 0 0 0 0 0 0 0 0 0 0 0 0 0 0 0 0 0 0 0
0 0 0 0 0 0 0 18 18 14 14 18 18 0 0 0 0 0 0 0 0 0 0 0 0 0 0 0 0 0 0 0 0
0 0 0 0 0 0 0 14 14 18 18 14 14 18 18 0 0 0 0 0 0 0 0 0 0 0 0 0 0 0 0 0 0
0 0 0 0 0 0 0 0 0 14 14 18 18 14 14 18 18 13 0 0 0 0 0 0 0 0 0 0 0 0 0 0 0
0 0 0 0 0 0 0 0 13 13 13 14 14 18 18 14 14 18 18 7 7 7 0 0 0 0 0 0 0 0 0 0 0
0 0 0 0 0 3 3 3 3 13 13 13 8 14 14 18 18 14 14 18 18 15 7 7 0 0 0 0 0 0 0 0 0
0 0 0 3 3 13 13 13 13 3 8 8 8 8 8 14 14 18 18 14 14 18 18 15 7 7 0 0 0 0 0 0 0
0 0 3 1 13 9 9 9 14 13 3 13 13 13 13 13 1 14 14 18 18 14 14 18 18 15 7 0 0 0 0 0 0
0 0 3 1 9 9 13 13 13 14 3 1 13 1 13 1 1 10 10 14 14 18 18 14 14 18 18 7 0 0 0 0 0
0 16 3 1 9 13 1 14 14 3 3 3 3 8 8 8 8 1 1 4 10 14 14 18 18 14 14 18 18 0 0 0 0
0 16 3 1 9 1 1 1 3 15 5 5 5 3 2 2 8 10 10 4 4 4 12 14 14 18 18 14 14 18 18 0 0
16 9 3 1 1 9 9 3 15 5 5 5 5 5 3 2 2 8 7 7 7 4 4 12 12 14 14 18 18 14 14 18 18
16 9 14 3 1 1 1 3 15 5 5 9 9 5 5 3 2 8 8 10 10 7 16 16 12 12 18 14 14 18 18 14 14
16 9 14 14 3 3 3 3 15 5 5 9 9 9 5 3 2 2 8 15 10 10 7 16 12 12 18 18 9 14 14 14 0
16 15 9 14 3 3 3 3 15 15 5 5 9 9 5 3 2 8 10 15 15 10 7 16 12 12 18 9 15 16 0 0 0
0 16 9 9 3 3 3 15 3 15 15 5 5 5 5 3 19 8 15 15 16 16 16 16 16 12 9 9 16 0 0 0 0
0 16 14 9 9 3 3 3 3 3 15 15 15 15 3 3 19 19 19 16 16 12 12 12 12 9 9 15 16 0 0 0 0
0 0 16 2 9 9 9 3 15 3 3 3 3 3 3 19 19 19 12 12 12 12 12 9 9 9 2 16 0 0 0 0 0
0 0 16 2 14 9 9 9 9 3 12 12 19 19 19 12 12 12 12 12 12 9 9 9 2 14 2 16 0 0 0 0 0
0 0 0 16 2 2 14 2 9 9 9 9 15 2 2 12 12 12 9 9 9 9 2 14 2 2 16 0 0 0 0 0 0
0 0 0 0 16 2 14 2 14 14 2 9 9 9 9 9 9 9 9 2 14 14 2 14 2 16 0 0 0 0 0 0 0
0 0 0 0 0 16 2 2 2 14 2 14 14 14 2 2 14 14 14 2 14 2 2 2 16 0 0 0 0 0 0 0 0
0 0 0 0 0 0 16 2 2 2 2 2 14 14 2 2 14 14 2 2 2 2 2 16 0 0 0 0 0 0 0 0 0
0 0 0 0 0 0 0 16 16 12 2 2 2 2 2 2 2 2 2 2 12 16 16 0 0 0 0 0 0 0 0 0 0
0 0 0 0 0 0 0 0 0 16 12 12 12 2 2 2 2 12 12 12 16 0 0 0 0 0 0 0 0 0 0 0 0
0 0 0 0 0 0 0 0 0 0 16 16 16 12 12 12 12 16 16 16 0 0 0 0 0 0 0 0 0 0 0 0 0
0 0 0 0 0 0 0 0 0 0 0 0 0 16 16 16 16 0 0 0 0 0 0 0 0 0 0 0 0 0 0 0 0
