0 0 0 0 0 18 18 18 18 18 18 18 18 18 18 18 18 0 0 0 0 0
0 0 0 0 18 13 18 9 9 18 15 15 18 5 5 18 1 18 0 0 0 0
0 0 0 18 13 18 9 9 18 18 15 15 18 18 5 5 18 1 18 0 0 0
0 0 18 13 13 18 9 9 18 15 15 15 15 18 5 5 18 1 1 18 0 0
0 18 13 13 18 9 9 18 18 15 15 15 15 18 18 5 5 18 1 1 18 0
0 18 13 18 9 9 9 18 15 15 15 15 15 15 18 5 5 5 18 1 18 0
18 13 13 18 9 9 9 18 15 15 15 15 15 15 18 5 5 5 18 1 1 18
18 13 13 18 9 9 9 18 15 15 15 15 15 15 18 5 5 5 18 1 1 18
18 13 13 18 9 9 9 18 15 15 15 15 15 15 18 5 5 5 18 1 1 18
18 13 13 18 9 9 9 18 15 15 15 15 15 15 18 5 5 5 18 1 1 18
18 13 13 18 9 9 9 18 15 15 15 15 15 15 18 5 5 5 18 1 1 18
0 18 13 18 9 9 9 18 15 15 15 15 15 15 18 5 5 5 18 1 18 0
0 18 13 13 18 9 9 9 18 15 15 15 15 18 5 5 5 18 1 1 18 0
0 0 18 13 13 18 9 9 18 15 15 15 15 18 5 5 18 1 1 18 0 0
0 0 0 18 13 18 9 9 18 18 15 15 18 18 5 5 18 1 18 0 0 0
0 0 0 0 18 13 18 9 9 18 15 15 18 5 5 18 1 18 0 0 0 0
0 0 0 0 0 18 18 9 9 18 15 15 18 5 5 18 18 0 0 0 0 0
0 0 0 0 0 0 18 9 9 18 15 15 18 5 5 18 0 0 0 0 0 0
0 0 0 0 0 0 0 18 18 18 18 18 18 18 18 0 0 0 0 0 0 0
0 0 0 0 0 0 0 0 18 0 0 0 0 18 0 0 0 0 0 0 0 0
0 0 0 0 0 0 0 18 18 18 18 18 18 18 18 0 0 0 0 0 0 0
0 0 0 0 0 0 0 18 2 2 2 2 2 2 18 0 0 0 0 0 0 0
0 0 0 0 0 0 0 18 2 2 2 2 2 2 18 0 0 0 0 0 0 0
0 0 0 0 0 0 0 0 18 2 2 2 2 18 0 0 0 0 0 0 0 0
0 0 0 0 0 0 0 0 18 18 18 18 18 18 0 0 0 0 0 0 0 0
---
0 0 0 0 0 15 15 15 15 15 15 15 15 15 15 15 15 0 0 0 0 0
0 0 0 0 15 18 15 18 18 15 13 13 15 18 18 15 18 15 0 0 0 0
0 0 0 15 18 15 18 18 15 15 13 13 15 15 18 18 15 18 15 0 0 0
0 0 15 18 18 15 18 18 15 13 13 13 13 15 18 18 15 18 18 15 0 0
0 15 18 18 15 18 18 15 15 13 13 13 13 15 15 18 18 15 18 18 15 0
0 15 18 15 18 18 18 15 13 13 13 13 13 13 15 18 18 18 15 18 15 0
15 18 18 15 18 18 18 15 13 13 13 13 13 13 15 18 18 18 15 18 18 15
15 18 18 15 18 18 18 15 5 5 5 5 5 5 15 18 18 18 15 18 18 15
15 18 18 15 18 18 18 15 5 5 5 5 5 5 15 18 18 18 15 18 18 15
15 18 18 15 18 18 18 15 5 5 5 5 5 5 15 18 18 18 15 18 18 15
5 18 18 5 18 18 18 1 5 5 5 5 5 5 1 18 18 18 2 18 18 2
0 5 18 5 18 18 18 1 9 9 5 5 9 9 1 18 18 18 2 18 2 0
0 5 18 18 5 18 18 18 1 9 9 9 9 1 18 18 18 2 18 18 2 0
0 0 5 18 18 5 18 18 1 9 9 9 9 1 18 18 2 18 18 2 0 0
0 0 0 5 18 5 18 18 1 1 9 9 1 1 18 18 2 18 2 0 0 0
0 0 0 0 5 18 5 18 18 1 9 9 1 18 18 2 18 2 0 0 0 0
0 0 0 0 0 5 5 18 18 1 9 9 1 18 18 2 2 0 0 0 0 0
0 0 0 0 0 0 5 18 18 1 9 9 1 18 18 2 0 0 0 0 0 0
0 0 0 0 0 0 0 5 1 1 1 1 1 1 2 0 0 0 0 0 0 0
0 0 0 0 0 0 0 0 9 0 0 0 0 9 0 0 0 0 0 0 0 0
0 0 0 0 0 0 0 9 9 9 9 9 9 9 9 0 0 0 0 0 0 0
0 0 0 0 0 0 0 9 18 18 18 18 18 18 9 0 0 0 0 0 0 0
0 0 0 0 0 0 0 9 18 18 18 18 18 18 9 0 0 0 0 0 0 0
0 0 0 0 0 0 0 0 9 18 18 18 18 9 0 0 0 0 0 0 0 0
0 0 0 0 0 0 0 0 9 9 9 9 9 9 0 0 0 0 0 0 0 0
