0 0 19 0 0 0 0 0 0 0 0 0 0 19 0 0
19 14 9 0 0 0 0 0 0 0 0 0 0 9 14 19
19 9 9 0 0 0 0 0 0 0 0 0 0 9 9 19
19 9 9 0 0 16 0 0 0 0 16 0 0 9 9 19
9 13 0 0 0 2 9 9 9 9 2 0 0 0 13 9
0 13 0 0 19 14 19 19 19 19 14 19 0 0 13 0
0 0 13 0 19 19 14 14 14 14 19 19 0 13 0 0
0 0 0 13 9 9 19 19 19 19 9 9 13 0 0 0
0 16 16 9 13 9 9 9 9 9 9 13 9 16 16 0
16 0 0 2 9 9 9 9 9 9 9 9 2 0 0 16
0 0 0 13 0 2 2 2 2 2 2 0 13 0 0 0
0 0 13 0 0 0 0 0 0 0 0 0 0 13 0 0
---
0 0 13 0 0 0 0 0 0 0 0 0 0 2 0 0
13 13 13 0 0 0 0 0 0 0 0 0 0 2 9 2
13 13 13 0 0 0 0 0 0 0 0 0 0 2 2 2
13 13 13 0 0 14 0 0 0 0 14 0 0 2 2 2
13 9 0 0 0 14 14 14 14 14 14 0 0 0 9 2
0 9 0 0 9 9 9 9 9 9 9 9 0 0 9 0
0 0 9 0 9 9 9 9 9 9 9 9 0 9 0 0
0 0 0 9 19 19 9 9 9 9 19 19 9 0 0 0
0 9 9 19 9 19 19 19 19 19 19 9 19 13 13 0
9 0 0 16 19 19 19 19 19 19 19 19 16 0 0 13
0 0 0 9 0 16 16 16 16 16 16 0 19 0 0 0
0 0 9 0 0 0 0 0 0 0 0 0 0 19 0 0
