0 0 0 0 0 0 0 0 0
0 0 0 0 13 0 0 0 0
0 0 0 13 13 13 0 0 0
0 0 0 13 18 13 0 0 0
0 0 13 13 13 13 13 0 0
0 0 13 18 13 18 13 0 0
0 13 13 13 13 13 13 13 0
5 13 18 13 18 13 18 13 5
0 5 5 5 5 5 5 5 0
0 0 0 0 0 0 0 0 0
---
0 0 0 0 0 0 0 0 0
0 0 0 0 13 0 0 0 0
0 0 0 13 13 13 0 0 0
0 0 0 13 18 13 0 0 0
0 0 13 13 13 13 13 0 0
0 0 13 5 13 5 13 0 0
0 13 5 18 18 18 5 13 0
13 5 18 5 5 5 18 5 13
0 13 13 13 13 13 13 13 0
0 0 0 0 0 0 0 0 0
