0 0 0 0 0 0 0 0 0 5 5 0 0 0
0 0 0 0 0 0 0 18 5 5 5 5 0 0
0 0 0 0 0 0 0 18 18 0 0 0 0 0
0 0 0 0 18 18 0 18 0 18 18 0 0 0
0 0 0 18 15 15 18 18 18 15 15 18 0 0
0 0 0 18 15 15 15 15 15 15 15 18 0 0
0 0 18 15 15 15 15 15 15 15 15 18 0 0
0 0 18 15 15 15 15 15 15 15 15 15 18 0
0 18 15 15 15 18 18 14 15 18 18 14 18 0
0 18 15 15 15 18 18 14 15 18 18 14 18 0
18 15 15 15 15 15 15 15 15 15 15 15 15 18
18 15 14 14 14 15 15 15 18 18 18 15 14 18
18 15 15 14 14 14 15 15 15 18 18 15 14 18
18 15 15 14 14 14 18 18 18 18 14 14 14 18
18 15 15 14 14 14 14 14 14 14 14 14 14 18
0 18 15 15 14 14 14 14 14 14 14 14 18 0
0 0 18 18 18 18 18 18 18 18 18 18 0 0
---
0 0 0 0 0 0 0 0 0 18 18 0 0 0
0 0 0 0 0 0 0 15 18 18 18 18 0 0
0 0 0 0 0 0 0 15 15 0 0 0 0 0
0 0 0 0 15 15 0 15 0 15 15 0 0 0
0 0 0 15 14 14 15 15 15 18 18 15 0 0
0 0 0 15 14 14 14 14 18 18 18 15 0 0
0 0 15 14 14 14 14 14 18 18 18 15 0 0
0 0 15 14 14 14 14 14 18 18 18 18 15 0
0 15 14 14 14 15 15 15 18 15 15 18 15 0
0 15 14 14 14 15 15 15 18 15 15 18 15 0
15 14 14 14 14 14 15 18 18 18 18 18 18 15
15 14 18 18 18 5 5 5 15 15 15 18 18 15
15 14 14 18 18 18 5 5 5 15 15 18 18 15
15 14 14 18 18 18 15 15 15 15 18 18 18 15
15 14 14 18 18 18 18 18 18 18 18 18 18 15
0 15 14 14 18 18 18 18 18 18 18 18 15 0
0 0 15 15 15 15 15 15 15 15 15 15 0 0
