0 0 0 0 17 17 17 17 0 0 0 0
0 0 0 17 5 5 5 5 17 0 0 0
0 0 17 5 5 15 15 5 5 17 0 0
0 17 5 5 15 15 15 15 5 5 17 0
0 17 5 15 15 15 15 15 15 5 17 0
17 5 5 15 15 2 2 15 15 5 5 17
17 5 15 15 2 2 2 16 15 15 5 17
17 5 15 15 2 2 2 16 15 15 5 17
17 5 15 15 15 16 16 16 15 15 5 17
17 5 5 15 15 15 15 15 15 5 5 17
0 17 5 5 5 5 5 5 5 5 17 0
0 0 17 17 17 17 17 17 17 17 0 0
---
0 0 0 0 15 15 15 15 0 0 0 0
0 0 0 15 17 17 17 17 15 0 0 0
0 0 15 17 17 5 5 17 17 15 0 0
0 15 17 17 5 5 5 5 17 17 15 0
0 15 17 5 5 5 5 5 5 17 15 0
15 17 17 5 5 5 5 5 5 17 17 15
15 17 5 5 5 5 5 15 5 5 17 15
15 17 5 5 5 5 5 15 5 5 17 15
15 17 2 2 2 2 2 15 5 5 17 15
15 16 16 2 2 2 17 5 5 17 17 15
0 15 16 16 16 17 17 17 17 17 15 0
0 0 15 15 15 15 15 15 15 15 0 0
