6 6 6 6 6 6 6 6 6 6 6 6 6 6 6 6 6 6 6 6 6 6 6 6 6 6 6 6 6
6 6 6 6 6 6 6 6 6 6 6 6 6 6 6 6 6 6 6 6 6 6 6 6 6 6 6 6 6
6 6 18 18 18 18 18 18 18 14 18 18 14 14 14 14 14 14 18 14 18 18 18 18 18 18 18 6 6
6 6 18 14 14 14 14 14 18 14 14 14 14 14 14 14 14 14 18 14 18 14 14 14 14 14 18 6 6
6 6 18 14 18 18 18 14 18 14 18 14 14 18 18 18 14 18 14 14 18 14 18 18 18 14 18 6 6
6 6 18 14 18 18 18 14 18 14 18 18 14 18 18 14 18 14 14 14 18 14 18 18 18 14 18 6 6
6 6 18 14 18 18 18 14 18 14 18 18 18 18 14 14 14 18 14 14 18 14 18 18 18 14 18 6 6
6 6 18 14 14 14 14 14 18 14 14 18 14 14 18 18 14 14 14 14 18 14 14 14 14 14 18 6 6
6 6 18 18 18 18 18 18 18 14 18 14 18 14 18 14 18 14 18 14 18 18 18 18 18 18 18 6 6
6 6 14 14 14 14 14 14 14 14 14 18 14 18 14 14 14 14 18 14 14 14 14 14 14 14 14 6 6
6 6 18 18 18 18 14 14 18 14 18 14 14 14 18 14 18 14 18 18 14 14 18 18 18 14 18 6 6
6 6 14 14 14 14 18 14 14 18 14 18 14 14 14 14 18 14 18 14 14 18 14 14 14 18 14 6 6
6 6 14 18 18 18 18 14 18 18 14 14 14 18 18 18 14 14 14 14 18 18 18 14 14 14 14 6 6
6 6 14 18 18 18 18 14 14 18 14 14 14 18 14 18 18 18 18 18 18 18 18 18 18 14 14 6 6
6 6 14 14 18 14 14 18 18 14 14 18 14 14 18 18 14 18 14 14 14 14 18 14 18 18 18 6 6
6 6 14 14 14 14 18 18 14 14 18 18 18 14 18 14 14 18 18 14 14 14 18 14 14 14 18 6 6
6 6 14 18 14 18 14 14 18 18 14 14 14 14 14 18 18 14 18 18 14 14 18 14 18 18 14 6 6
6 6 18 14 18 18 18 14 14 14 18 18 14 14 18 14 14 14 18 18 18 18 18 14 14 14 18 6 6
6 6 14 14 14 18 18 18 18 14 14 18 14 14 18 18 14 18 18 18 18 18 18 14 18 18 18 6 6
6 6 14 14 14 14 14 14 14 14 18 18 14 14 18 18 18 14 18 14 14 14 18 14 18 14 18 6 6
6 6 18 18 18 18 18 18 18 14 14 14 14 14 14 18 18 14 18 14 18 14 18 14 18 18 18 6 6
6 6 18 14 14 14 14 14 18 14 14 14 18 14 18 14 14 14 18 14 14 14 18 14 14 18 14 6 6
6 6 18 14 18 18 18 14 18 14 14 18 18 14 14 14 14 14 18 18 18 18 18 14 14 18 18 6 6
6 6 18 14 18 18 18 14 18 14 18 18 14 18 14 18 18 14 14 18 18 14 18 14 18 18 18 6 6
6 6 18 14 18 18 18 14 18 14 18 14 14 18 18 14 18 18 14 14 18 14 18 14 18 18 14 6 6
6 6 18 14 14 14 14 14 18 14 18 14 14 18 18 18 18 18 14 18 14 14 18 14 18 14 14 6 6
6 6 18 18 18 18 18 18 18 14 18 18 18 14 14 14 18 14 14 14 18 18 18 18 18 18 18 6 6
6 6 6 6 6 6 6 6 6 6 6 6 6 6 6 6 6 6 6 6 6 6 6 6 6 6 6 6 6
6 6 6 6 6 6 6 6 6 6 6 6 6 6 6 6 6 6 6 6 6 6 6 6 6 6 6 6 6
---
6 6 6 6 6 6 6 6 6 6 6 6 6 6 6 6 6 6 6 6 6 6 6 6 6 6 6 6 6
6 14 14 14 14 14 14 14 14 14 14 14 14 14 14 14 14 14 14 14 14 14 14 14 14 14 14 14 6
6 18 6 6 6 6 6 6 6 18 6 6 18 18 18 18 18 18 14 18 14 14 14 14 14 14 14 18 6
6 18 6 6 6 6 6 6 6 18 18 18 18 18 18 18 18 18 14 18 14 14 14 14 14 14 14 18 6
6 18 6 6 6 6 6 6 6 18 14 18 18 14 14 14 18 14 18 18 14 14 14 14 14 14 14 18 6
6 18 6 6 6 6 6 6 6 18 14 14 18 14 14 18 14 18 18 18 14 14 14 14 14 14 14 18 6
6 18 6 6 6 6 6 6 6 18 14 14 14 14 18 18 18 14 18 18 14 14 14 14 14 14 14 18 6
6 18 6 6 6 6 6 6 6 18 18 14 18 18 14 14 18 18 18 18 14 14 14 14 14 14 14 18 6
6 18 6 6 6 6 6 6 6 18 14 18 14 18 14 18 14 18 14 18 14 14 14 14 14 14 14 18 6
6 18 18 18 18 18 18 18 18 18 18 14 18 14 18 18 18 18 14 18 18 18 18 18 18 18 18 18 6
6 18 14 14 14 14 18 18 14 18 14 18 18 18 14 18 14 18 14 14 18 18 14 14 14 18 14 18 6
6 18 18 18 18 18 14 18 18 14 18 14 18 18 18 18 14 18 14 18 18 14 18 18 18 14 18 18 6
6 18 18 14 14 14 14 18 14 14 18 18 18 14 14 14 18 18 18 18 14 14 14 18 18 18 18 18 6
6 18 18 14 14 14 14 18 18 14 18 18 18 14 18 14 14 14 14 14 14 14 14 14 14 18 18 18 6
6 18 18 18 14 18 18 14 14 18 18 14 18 18 14 14 18 14 6 6 6 6 14 6 14 14 14 18 6
6 18 18 18 18 18 14 14 18 18 14 14 14 18 14 18 18 14 14 6 6 6 14 6 6 6 14 18 6
6 18 18 14 18 14 18 18 14 14 18 18 18 18 18 14 14 18 14 14 6 6 14 6 14 14 6 18 6
6 18 14 18 14 14 14 18 18 18 14 14 18 18 14 18 18 18 14 14 14 14 14 6 6 6 14 18 6
6 18 18 18 18 14 14 14 14 18 18 14 18 18 14 14 18 14 14 14 14 14 14 6 14 14 14 18 6
6 18 18 18 18 18 18 18 18 18 14 14 18 18 14 14 14 18 14 18 18 18 14 6 14 14 14 18 6
6 18 14 14 14 14 14 14 14 18 18 18 18 18 18 14 14 18 14 18 14 18 14 6 14 14 14 18 6
6 18 14 6 6 6 6 6 14 18 18 18 14 18 14 18 18 18 14 18 18 18 14 6 6 14 14 18 6
6 18 14 6 6 6 6 6 14 18 18 14 14 18 18 18 18 18 14 14 14 14 14 6 6 14 14 18 6
6 18 14 6 6 6 6 6 14 18 14 14 18 14 18 14 14 18 18 14 14 18 14 6 14 14 14 18 6
6 18 14 6 6 6 6 6 14 18 14 18 18 14 14 14 14 14 18 18 14 18 14 6 14 14 14 18 6
6 18 14 6 6 6 6 6 14 18 14 18 18 14 14 14 14 14 18 14 18 18 14 6 14 14 14 18 6
6 18 14 14 14 14 14 14 14 18 14 14 14 18 18 18 14 18 18 18 14 14 14 14 14 14 14 18 6
6 18 18 18 18 18 18 18 18 18 18 18 18 18 18 18 18 18 18 18 18 18 18 18 18 18 18 18 6
6 6 6 6 6 6 6 6 6 6 6 6 6 6 6 6 6 6 6 6 6 6 6 6 6 6 6 6 6
