0 0 0 0 0 0 18 0 0 0 0 0 0 0
0 0 0 0 0 0 18 0 0 0 0 0 0 0
0 0 0 0 0 18 18 18 0 0 0 0 0 0
0 0 0 0 0 0 15 0 0 0 0 0 0 0
0 0 0 0 0 15 15 15 0 0 0 0 1 0
0 0 0 0 0 15 14 15 0 0 0 1 3 1
0 0 0 0 15 14 18 14 15 0 0 1 3 1
18 18 0 0 15 15 15 15 15 0 0 18 18 3
0 18 18 15 15 18 15 18 15 15 18 18 3 0
0 0 0 15 15 15 18 15 15 15 0 0 0 0
0 0 0 0 18 0 0 0 18 0 0 0 0 0
0 0 0 0 18 18 0 18 18 0 0 0 0 0
0 0 0 0 0 18 0 18 0 0 0 0 0 0
---
0 0 0 0 0 0 15 0 0 0 0 0 0 0
0 0 0 0 0 0 15 0 0 0 0 0 0 0
0 0 0 0 0 15 15 15 0 0 0 0 0 0
0 0 0 0 0 0 3 0 0 0 0 0 0 0
0 0 0 0 0 3 3 3 0 0 0 0 18 0
0 0 0 0 0 1 18 18 0 0 0 18 18 18
0 0 0 0 1 18 18 18 18 0 0 18 18 18
15 15 0 0 1 18 18 18 18 0 0 15 15 18
0 15 15 1 1 15 18 15 18 18 15 15 18 0
0 0 0 14 14 14 15 18 18 18 0 0 0 0
0 0 0 0 15 0 0 0 15 0 0 0 0 0
0 0 0 0 15 15 0 15 15 0 0 0 0 0
0 0 0 0 0 15 0 15 0 0 0 0 0 0
