0 0 0 0 18 18 18 18 18 0 0 0 18 18 18 0 18 18 18 0
0 0 18 18 1 1 1 1 1 18 0 18 14 17 17 18 14 17 17 18
0 18 4 1 1 1 1 1 1 1 18 18 14 17 17 18 14 17 17 18
0 18 4 1 1 18 18 18 1 1 1 18 14 14 14 18 14 14 14 18
18 4 1 1 18 1 1 1 18 1 1 1 18 6 18 0 18 6 18 0
18 4 1 18 4 1 1 1 1 18 1 1 18 6 18 0 18 6 18 0
18 4 1 18 4 1 1 1 1 18 1 1 18 6 18 0 18 6 18 0
18 4 1 18 4 1 1 4 1 18 1 1 18 6 18 0 18 6 18 0
18 4 1 1 18 4 1 4 1 18 1 1 18 6 18 18 18 6 18 0
18 4 1 1 1 18 18 1 4 18 1 18 0 18 6 6 6 18 0 0
0 18 4 1 1 1 1 4 18 17 18 18 0 18 6 6 6 18 0 0
0 0 18 4 4 4 18 4 18 17 6 6 18 18 6 12 12 18 0 0
0 0 0 18 18 18 17 18 6 6 6 6 6 6 6 6 6 18 18 0
0 0 0 18 17 17 17 6 6 6 6 6 6 6 6 6 6 6 18 0
0 0 0 0 18 18 18 18 18 18 18 18 18 18 18 18 18 18 0 0
---
0 0 0 0 4 4 4 4 4 0 0 0 6 6 6 0 6 6 6 0
0 0 4 4 18 18 18 18 18 4 0 6 6 6 6 6 6 6 6 6
0 4 18 18 18 18 18 18 18 18 4 6 6 6 6 6 6 6 6 6
0 4 18 18 18 1 1 1 18 18 18 6 6 6 6 6 6 6 6 6
4 18 18 18 1 17 17 17 1 18 18 18 6 18 14 0 14 18 6 0
4 18 18 1 1 17 17 17 17 1 18 18 6 18 14 0 14 18 6 0
4 18 18 1 1 17 17 17 17 1 18 18 6 18 14 0 14 18 6 0
4 18 18 1 1 17 17 4 18 1 18 18 1 18 14 0 14 18 1 0
4 18 18 18 1 1 17 4 18 1 18 18 1 18 1 14 14 18 1 0
4 18 18 18 18 1 1 18 18 1 18 1 0 1 18 18 18 1 0 0
0 4 18 18 18 18 18 18 1 12 1 1 0 1 18 18 18 1 0 0
0 0 4 18 18 18 1 18 1 12 18 18 1 1 18 18 18 1 0 0
0 0 0 1 1 1 18 1 18 18 18 18 18 18 18 18 18 1 1 0
0 0 0 1 18 18 18 18 18 18 18 18 18 18 18 18 18 18 1 0
0 0 0 0 1 1 1 1 1 1 1 1 1 1 1 1 1 1 0 0
