0 0 0 0 0 0 16 16 16 16 0 0 0 0 0 0
0 16 0 0 16 16 19 19 19 19 16 16 0 0 16 0
16 19 16 16 19 9 9 9 9 9 9 19 16 16 19 16
0 16 16 9 9 4 9 9 9 9 4 9 9 16 16 0
16 9 16 9 4 14 4 4 4 4 14 4 9 16 9 16
16 9 16 9 4 14 14 14 14 14 14 4 9 16 9 16
16 9 16 9 4 14 14 14 14 14 14 4 9 16 9 16
0 16 4 4 4 4 4 4 4 4 4 4 4 4 16 0
4 4 14 14 14 14 14 14 14 14 14 14 14 14 4 4
4 14 5 5 5 5 5 5 5 5 5 5 5 5 14 4
4 5 5 5 6 6 6 6 6 6 6 6 5 5 5 4
4 5 5 5 5 6 6 6 6 6 6 5 5 5 5 4
4 5 5 5 5 5 5 6 6 5 5 5 5 5 5 4
4 16 5 5 5 5 5 5 5 5 5 5 5 5 16 4
16 19 16 16 16 16 16 16 16 16 16 16 16 16 19 16
0 16 9 9 9 9 9 9 9 9 9 9 9 9 16 0
16 9 9 16 16 16 16 16 16 16 16 16 16 9 9 16
0 16 16 0 0 0 0 0 0 0 0 0 0 16 16 0
---
0 0 0 0 0 0 5 5 5 5 0 0 0 0 0 0
0 5 0 0 5 5 14 14 14 14 5 5 0 0 5 0
5 6 5 5 14 14 14 14 14 14 14 14 5 5 6 5
0 5 5 14 14 16 14 14 14 14 16 14 14 5 5 0
5 4 5 14 16 6 16 16 16 16 6 16 14 5 16 5
5 4 5 14 16 6 6 6 6 6 6 16 14 5 16 5
5 4 5 14 16 6 6 6 6 6 6 16 14 5 16 5
0 5 16 16 16 16 16 16 16 16 16 16 16 16 5 0
16 16 9 9 9 9 9 9 9 9 9 9 9 9 16 16
16 9 9 9 9 9 9 9 16 16 16 16 16 16 9 16
16 9 9 9 19 19 19 19 19 19 19 19 16 16 16 16
16 9 9 9 9 9 9 14 14 19 19 16 16 16 16 16
16 9 9 9 9 9 9 9 16 16 16 16 16 16 16 16
16 4 9 9 9 9 9 9 16 16 16 16 16 16 4 16
4 4 4 4 4 4 4 4 4 4 4 4 4 4 16 4
0 4 5 5 5 5 5 5 5 5 5 5 5 5 4 0
4 5 5 4 4 4 4 4 4 4 4 4 4 5 5 4
0 4 4 0 0 0 0 0 0 0 0 0 0 4 4 0
