0 0 0 0 0 0 18 18 18 18 18 0 0 0 0 0 0 0
0 0 0 0 18 18 1 14 14 14 14 18 18 0 0 0 0 0
0 0 0 18 1 1 14 14 18 18 18 18 18 18 18 0 0 0
0 0 18 1 14 14 14 18 18 18 18 18 18 18 18 18 0 0
0 18 1 14 14 14 14 18 18 18 15 18 18 18 14 18 18 0
0 18 1 14 14 14 18 18 18 15 15 15 18 18 18 18 18 0
18 1 14 14 14 14 18 18 18 18 15 18 18 18 18 18 18 18
18 1 14 14 14 14 18 18 18 18 18 18 18 18 18 18 18 18
18 1 14 14 14 14 18 18 18 18 18 18 18 18 15 18 18 18
18 1 14 14 14 14 1 18 18 14 18 18 18 15 15 15 18 18
18 1 1 14 14 14 1 18 18 18 18 18 18 18 15 18 18 0
18 1 1 14 14 14 14 1 18 18 18 14 18 18 18 18 18 18
0 18 1 1 14 14 14 14 14 18 18 18 18 18 18 18 14 18
0 18 1 1 14 14 14 14 14 14 18 18 18 18 18 14 1 18
0 0 18 1 1 14 14 14 14 14 14 14 14 14 14 1 18 0
0 0 0 18 1 1 1 14 14 14 14 14 14 14 1 18 0 0
0 0 0 0 18 18 1 1 1 1 1 1 1 18 18 0 0 0
0 0 0 0 0 0 18 18 18 18 18 18 18 0 0 0 0 0
---
0 0 0 0 0 0 18 18 18 18 18 0 0 0 0 0 0 0
0 0 0 0 18 18 18 1 1 1 1 14 14 0 0 0 0 0
0 0 0 18 18 18 1 1 14 14 14 14 14 14 14 0 0 0
0 0 18 18 1 1 1 14 14 14 14 14 14 14 14 14 0 0
0 18 18 1 1 1 1 14 14 14 1 14 14 14 18 14 18 0
0 18 18 1 1 1 14 14 14 1 1 1 14 14 14 14 18 0
18 18 1 1 1 1 14 14 14 14 1 14 14 14 14 14 18 18
18 18 1 1 1 1 18 18 14 14 14 14 18 18 14 18 14 18
18 18 1 1 1 1 18 18 14 14 14 14 18 18 14 18 18 18
18 18 1 1 1 15 18 18 14 18 14 14 18 14 14 14 18 18
18 18 18 15 15 15 18 18 14 14 14 14 18 18 14 18 18 0
18 18 18 15 15 15 15 18 18 18 14 18 18 18 14 18 14 18
0 18 18 18 15 15 18 18 18 18 14 14 14 14 14 14 18 18
0 18 18 18 18 18 18 18 18 18 18 18 18 18 18 18 18 18
0 0 18 18 18 18 18 18 18 18 18 18 18 18 18 18 18 0
0 0 0 18 18 18 18 18 18 18 18 18 18 18 18 18 0 0
0 0 0 0 18 18 18 18 18 18 18 18 18 18 18 0 0 0
0 0 0 0 0 0 18 18 18 18 18 18 18 0 0 0 0 0
