0 0 0 0 0 0 18 18 18 0 0 0 0 0 0 0
0 0 0 0 0 18 10 10 10 18 0 0 0 0 0 0
0 0 0 18 18 10 11 11 10 18 0 0 0 0 0 0
0 0 0 18 11 11 18 11 10 10 18 0 0 0 0 0
0 0 0 0 18 18 11 11 11 10 18 0 0 0 0 0
0 0 0 0 0 18 11 11 10 10 10 18 0 0 0 0
0 0 0 0 18 11 11 11 10 10 10 18 0 0 0 0
0 0 0 18 9 9 11 11 11 11 11 15 18 0 0 0
0 18 18 18 9 9 9 9 15 15 15 15 18 18 18 0
18 11 11 11 18 18 18 18 18 18 18 18 10 10 10 18
18 11 11 11 11 11 10 10 10 10 10 10 10 10 10 18
0 18 11 11 11 11 11 11 11 11 10 10 10 10 18 0
0 0 18 18 18 18 18 18 18 18 18 18 18 18 0 0
---
0 0 0 0 0 0 11 11 11 0 0 0 0 0 0 0
0 0 0 0 0 11 15 15 15 11 0 0 0 0 0 0
0 0 0 11 11 15 9 9 15 11 0 0 0 0 0 0
0 0 0 11 9 9 11 9 18 18 11 0 0 0 0 0
0 0 0 0 11 11 10 9 10 18 11 0 0 0 0 0
0 0 0 0 0 11 10 10 18 18 18 11 0 0 0 0
0 0 0 0 11 10 10 10 18 18 18 11 0 0 0 0
0 0 0 11 18 18 10 10 10 10 10 18 11 0 0 0
0 11 11 11 18 18 18 18 18 18 18 18 11 11 11 0
10 18 18 18 11 11 11 11 11 11 11 11 18 18 18 10
10 18 18 18 18 18 18 18 18 18 18 18 18 18 18 10
0 10 18 18 18 18 18 18 18 18 18 18 18 18 10 0
0 0 10 10 10 10 10 10 10 10 10 10 10 10 0 0
