0 0 0 0 0 16 16 16 16 0 0 0 0 0
0 0 0 0 0 16 10 10 16 0 0 0 0 0
0 0 0 0 0 16 10 10 16 0 0 0 0 0
0 0 0 0 0 16 10 10 16 0 0 0 0 0
0 0 0 0 0 16 10 10 16 0 0 0 0 0
0 16 16 16 16 16 16 16 16 16 16 16 16 0
16 3 3 3 3 3 3 3 3 3 3 3 3 16
16 16 16 16 16 16 16 16 16 16 16 16 16 16
0 16 14 14 14 16 10 10 16 14 14 14 16 0
0 16 14 14 14 16 10 10 16 14 14 14 16 0
0 16 14 14 14 16 10 10 16 14 14 14 16 0
0 16 9 9 9 9 9 9 9 16 16 9 16 0
0 16 2 2 16 16 2 2 2 16 16 2 16 0
0 16 2 2 16 16 2 2 2 2 2 2 16 0
0 0 16 2 2 2 2 16 16 2 2 16 0 0
0 0 16 2 2 2 2 16 16 2 2 16 0 0
0 0 16 16 2 2 2 2 2 2 16 16 0 0
0 0 0 16 16 16 16 16 16 16 16 0 0 0
---
0 0 0 0 0 2 2 2 2 0 0 0 0 0
0 0 0 0 0 2 16 16 2 0 0 0 0 0
0 0 0 0 0 2 16 16 2 0 0 0 0 0
0 0 0 0 0 2 16 16 2 0 0 0 0 0
0 0 0 0 0 2 16 16 2 0 0 0 0 0
0 2 2 2 2 2 2 2 2 2 2 2 2 0
3 16 16 16 16 16 16 16 16 16 16 16 16 14
3 3 3 3 3 2 3 3 2 14 14 14 14 14
0 3 16 16 16 2 9 9 2 16 16 16 14 0
0 3 16 16 16 2 9 9 2 16 16 16 14 0
0 10 16 16 16 2 9 9 2 16 16 16 14 0
0 10 16 16 16 16 16 16 16 16 16 16 14 0
0 10 16 16 16 16 16 16 16 16 16 16 14 0
0 10 16 16 16 16 16 16 16 16 16 16 14 0
0 0 10 16 16 16 16 9 3 16 16 14 0 0
0 0 10 16 16 16 16 9 3 16 16 14 0 0
0 0 10 10 16 16 16 16 16 16 14 14 0 0
0 0 0 10 10 10 10 10 10 14 14 0 0 0
