0 0 0 0 0 0 0 0 0 16 16 16 16 16 0 0 0 0 0 0 0 0 0 0 0 0 0
0 0 0 0 0 0 0 16 16 15 15 15 15 15 16 16 0 0 0 0 0 0 0 0 0 0 0
0 0 0 0 0 0 16 9 15 15 15 15 15 15 15 15 16 0 0 0 0 0 0 0 0 0 0
0 0 0 0 0 16 9 9 15 15 15 9 15 15 15 15 15 16 0 0 0 0 0 0 0 0 0
0 0 0 0 0 16 9 15 15 9 9 16 9 9 15 15 15 16 0 0 0 0 0 0 0 0 0
0 0 0 0 16 9 9 9 9 16 16 19 16 16 16 9 15 15 16 0 0 0 0 0 0 0 0
16 16 16 0 0 16 9 9 16 19 19 8 8 8 8 16 9 16 0 0 0 0 0 0 0 0 0
16 14 14 16 0 16 9 16 19 16 8 8 8 16 8 8 16 0 16 0 0 0 0 0 0 0 0
16 14 14 14 16 0 16 19 8 16 8 8 8 16 8 8 16 0 16 16 0 0 0 0 0 0 0
0 16 14 14 14 16 16 19 10 10 8 16 8 10 10 8 16 16 0 16 16 0 0 16 16 0 0
0 0 16 14 14 14 14 16 19 8 8 8 8 8 8 16 0 16 0 0 16 0 16 10 10 16 0
0 16 14 14 14 7 16 0 16 16 19 19 19 16 16 0 16 0 0 0 16 0 16 13 13 10 16
0 0 16 16 14 14 14 16 14 14 16 16 16 14 16 13 13 13 10 10 13 10 10 16 13 13 16
0 0 16 7 7 14 14 16 7 14 14 14 14 16 16 19 16 16 16 16 16 0 16 13 13 16 0
0 0 0 16 16 7 16 7 16 7 7 14 14 14 16 16 0 0 0 0 16 0 0 16 16 0 0
0 0 0 0 0 16 7 7 7 16 16 16 16 16 0 16 0 0 0 16 16 0 0 0 0 0 0
0 0 0 0 0 16 7 14 14 7 7 7 7 16 0 0 16 0 16 16 0 0 0 0 0 0 0
0 0 0 16 16 19 16 14 14 14 14 14 14 16 0 0 0 16 16 0 0 0 0 0 0 0 0
0 0 16 8 8 8 19 16 16 14 14 14 16 0 0 0 0 16 0 0 0 0 0 0 0 0 0
0 0 16 8 16 16 16 0 16 16 16 16 0 0 0 0 0 0 0 0 0 0 0 0 0 0 0
0 0 0 16 0 0 0 16 8 8 19 16 0 0 0 0 0 0 0 0 0 0 0 0 0 0 0
0 0 0 0 0 0 0 16 8 16 16 0 0 0 0 0 0 0 0 0 0 0 0 0 0 0 0
0 0 0 0 0 0 0 0 16 0 0 0 0 0 0 0 0 0 0 0 0 0 0 0 0 0 0
---
0 0 0 0 0 0 0 0 0 8 8 8 8 8 0 0 0 0 0 0 0 0 0 0 0 0 0
0 0 0 0 0 0 0 8 8 16 16 16 16 16 8 8 0 0 0 0 0 0 0 0 0 0 0
0 0 0 0 0 0 8 16 16 16 16 16 16 16 16 16 8 0 0 0 0 0 0 0 0 0 0
0 0 0 0 0 7 16 16 16 16 16 16 16 16 16 16 16 8 0 0 0 0 0 0 0 0 0
0 0 0 0 0 7 16 16 16 16 16 8 16 16 16 16 16 8 0 0 0 0 0 0 0 0 0
0 0 0 0 7 16 16 16 16 13 13 16 8 8 8 8 16 16 8 0 0 0 0 0 0 0 0
7 7 7 0 0 7 16 16 13 16 16 14 14 14 14 8 8 8 0 0 0 0 0 0 0 0 0
7 16 16 7 0 7 16 13 16 13 14 14 14 13 14 14 8 0 8 0 0 0 0 0 0 0 0
7 16 16 16 7 0 7 16 13 13 14 14 14 13 14 14 8 0 8 8 0 0 0 0 0 0 0
0 7 16 16 16 7 7 16 16 16 14 13 14 16 16 14 9 9 0 8 8 0 0 15 15 0 0
0 0 14 16 16 16 16 10 16 14 14 14 14 14 14 9 0 9 0 0 8 0 15 16 16 15 0
0 14 16 16 16 10 10 0 10 10 16 16 16 9 9 0 9 0 0 0 8 0 15 16 16 16 15
0 0 14 14 16 16 16 10 16 16 10 10 10 16 9 16 16 16 16 16 16 16 16 15 16 16 15
0 0 14 16 16 16 16 10 16 16 16 16 16 9 9 16 19 19 19 19 19 0 15 16 16 15 0
0 0 0 14 14 16 10 16 9 16 16 16 16 16 9 9 0 0 0 0 19 0 0 15 15 0 0
0 0 0 0 0 14 16 16 16 9 9 9 9 15 0 9 0 0 0 19 19 0 0 0 0 0 0
0 0 0 0 0 14 16 16 16 16 16 16 16 15 0 0 19 0 19 19 0 0 0 0 0 0 0
0 0 0 14 14 16 14 16 16 16 16 16 16 15 0 0 0 19 19 0 0 0 0 0 0 0 0
0 0 14 16 16 16 16 15 15 16 16 16 15 0 0 0 0 19 0 0 0 0 0 0 0 0 0
0 0 14 16 14 14 14 0 15 15 15 15 0 0 0 0 0 0 0 0 0 0 0 0 0 0 0
0 0 0 14 0 0 0 15 16 16 16 15 0 0 0 0 0 0 0 0 0 0 0 0 0 0 0
0 0 0 0 0 0 0 15 16 15 15 0 0 0 0 0 0 0 0 0 0 0 0 0 0 0 0
0 0 0 0 0 0 0 0 15 0 0 0 0 0 0 0 0 0 0 0 0 0 0 0 0 0 0
