0 0 0 0 0 0 0 0 4 4 4 4 4 4 0 0 0 0 0 0 0 0
0 0 0 0 0 0 4 4 1 1 1 1 1 1 4 4 0 0 0 0 0 0
0 0 0 0 4 4 1 1 11 11 11 11 11 11 1 1 4 4 0 0 0 0
0 0 0 0 4 1 11 11 10 11 10 10 10 11 11 11 1 4 4 0 0 0
0 0 0 4 1 11 11 10 10 14 10 10 10 10 11 11 11 1 4 0 0 0
0 0 0 4 1 11 10 14 10 10 10 10 10 10 11 11 11 1 4 4 0 0
0 0 4 1 11 11 14 14 14 10 10 10 10 10 11 10 11 11 1 4 0 0
0 5 4 1 11 11 10 14 10 10 10 10 11 11 11 11 11 11 1 4 5 0
5 5 4 1 11 10 10 10 10 10 10 10 11 11 11 11 11 11 1 4 5 5
5 5 4 1 11 11 10 10 11 11 11 11 11 11 11 11 11 11 1 4 5 5
0 5 5 5 14 5 14 14 14 14 14 5 5 5 5 5 5 5 5 5 5 0
0 0 4 1 11 11 5 5 5 5 5 5 5 5 5 5 11 11 1 4 0 0
0 0 0 4 1 11 11 11 11 11 11 11 11 11 11 11 11 11 1 4 0 0
0 0 0 4 1 11 10 10 11 11 11 11 11 11 11 11 11 1 4 0 0 0
0 0 0 0 4 1 11 10 10 10 10 11 11 11 11 11 11 1 4 0 0 0
0 0 0 0 4 1 1 11 11 11 11 11 11 11 11 1 1 4 0 0 0 0
0 0 0 0 0 4 4 1 1 1 1 1 1 1 1 4 4 0 0 0 0 0
0 0 0 0 0 0 0 4 4 4 4 4 4 4 4 0 0 0 0 0 0 0
---
0 0 0 0 0 0 0 0 11 11 11 11 11 11 0 0 0 0 0 0 0 0
0 0 0 0 0 0 11 11 4 4 4 4 4 4 11 11 0 0 0 0 0 0
0 0 0 0 11 11 4 4 4 4 4 4 4 4 4 4 11 11 0 0 0 0
0 0 0 0 11 4 4 4 11 4 11 11 11 4 4 4 4 11 11 0 0 0
0 0 0 11 4 4 4 11 11 11 11 11 11 11 4 4 4 4 11 0 0 0
0 0 0 11 4 4 11 5 11 11 11 11 11 11 4 4 4 4 11 11 0 0
0 0 11 4 4 4 5 5 5 11 11 11 11 11 1 11 1 1 4 11 0 0
0 10 11 4 4 4 11 5 11 11 11 11 1 1 1 1 1 1 4 11 10 0
10 10 11 4 4 11 11 11 11 11 11 11 10 10 10 10 14 14 4 11 10 10
10 10 11 4 4 4 11 11 14 14 14 14 14 14 14 14 14 14 4 11 10 10
0 10 10 10 11 10 10 10 10 10 10 10 10 10 10 10 10 10 10 10 10 0
0 0 1 11 1 1 10 10 10 10 10 10 10 10 10 10 5 5 11 1 0 0
0 0 0 1 11 1 1 1 1 1 5 5 5 5 5 5 5 5 11 1 0 0
0 0 0 1 11 1 11 11 1 1 5 5 5 5 5 5 5 11 1 0 0 0
0 0 0 0 1 11 1 11 11 11 11 5 5 5 5 5 5 11 1 0 0 0
0 0 0 0 1 11 11 1 1 5 5 5 5 5 5 11 11 1 0 0 0 0
0 0 0 0 0 1 1 11 11 11 11 11 11 11 11 1 1 0 0 0 0 0
0 0 0 0 0 0 0 1 1 1 1 1 1 1 1 0 0 0 0 0 0 0
