0 0 17 17 17 0 0 0 17 17 17 0 0 0
0 0 0 17 5 17 0 17 6 6 17 0 0 0
0 0 0 0 17 5 17 6 5 17 0 0 0 0
0 0 17 17 17 5 5 6 5 17 17 17 17 0
0 17 17 6 6 17 5 6 17 6 6 17 0 0
0 0 0 17 5 6 5 17 5 5 17 0 0 0
0 0 0 17 5 5 6 17 5 5 17 0 0 0
0 0 0 0 17 5 6 5 17 17 0 0 0 0
0 0 0 16 2 2 2 2 15 2 16 0 0 0
0 0 16 16 15 15 15 15 9 15 15 16 0 0
0 16 9 15 15 15 15 19 9 15 15 15 16 0
0 16 15 9 15 19 9 9 15 9 15 19 16 0
16 15 15 15 9 9 9 15 15 15 9 9 19 16
16 15 15 19 9 9 15 15 15 15 19 9 19 16
16 15 19 9 15 15 9 15 15 19 9 15 9 16
16 15 9 15 15 15 15 9 19 9 15 19 19 16
16 9 19 15 15 15 15 19 9 15 9 9 19 16
0 16 9 19 15 15 19 9 15 15 15 19 16 0
0 16 19 9 19 19 9 19 15 19 19 9 16 0
0 0 16 19 9 9 19 9 19 19 9 16 0 0
0 0 0 16 16 16 16 16 16 16 16 0 0 0
---
0 0 15 15 15 0 0 0 15 15 15 0 0 0
0 0 0 15 9 15 0 15 9 9 15 0 0 0
0 0 0 0 15 9 15 9 9 15 0 0 0 0
0 0 15 15 15 9 9 9 9 15 15 15 15 0
0 15 15 9 9 15 9 9 15 9 9 15 0 0
0 0 0 15 9 9 9 15 9 9 15 0 0 0
0 0 0 15 9 9 9 15 9 9 15 0 0 0
0 0 0 0 15 9 9 9 15 15 0 0 0 0
0 0 0 17 9 9 9 9 16 17 17 0 0 0
0 0 17 17 5 5 16 16 9 16 16 17 0 0
0 17 2 5 5 16 16 6 9 16 16 16 17 0
0 17 5 2 5 6 19 19 16 19 16 6 17 0
17 5 5 5 2 19 19 16 16 16 19 19 6 17
17 5 5 6 19 19 16 16 16 16 15 19 6 17
17 5 6 19 16 16 19 16 16 15 19 6 19 17
17 5 19 16 16 16 16 19 15 19 6 15 15 17
17 19 15 16 16 16 16 15 19 6 19 19 15 17
0 17 19 15 16 16 15 19 5 5 5 15 17 0
0 17 2 19 15 15 19 15 5 15 15 6 17 0
0 0 17 2 19 19 15 19 15 15 6 17 0 0
0 0 0 17 17 17 17 17 17 17 17 0 0 0
