0 0 0 0 0 0 0 16 16 16 16 16 16 0 0 0 0 0 0 0
0 0 0 0 0 16 16 9 9 16 13 13 16 16 16 0 0 0 0 0
0 0 0 16 16 5 5 5 5 15 15 16 15 15 16 16 0 0 0 0
0 0 16 5 5 7 10 16 15 16 16 16 16 16 15 15 16 0 0 0
0 16 5 5 16 10 13 15 16 16 9 19 19 19 16 16 16 16 0 0
0 16 5 16 15 15 15 16 9 19 19 9 19 19 19 19 9 16 0 0
16 5 16 7 10 5 16 9 19 19 19 19 19 19 19 9 19 2 16 0
16 5 13 10 13 16 9 19 19 9 19 19 19 19 19 19 19 19 16 0
16 16 5 5 5 16 19 19 19 19 19 19 19 19 19 19 19 19 9 16
16 10 16 5 16 9 19 9 19 19 19 9 19 19 19 19 9 19 2 16
16 10 12 10 16 19 19 19 19 19 19 19 19 19 9 9 9 9 2 16
16 12 10 12 16 19 19 19 19 9 19 9 9 9 9 9 9 2 0 0
16 12 12 12 16 19 9 9 9 9 9 9 9 2 2 16 16 16 0 0
0 16 12 16 19 9 9 9 2 2 2 16 16 16 16 0 0 0 0 0
0 0 16 2 2 2 2 16 16 16 16 0 0 0 0 0 0 0 0 0
0 0 0 16 16 16 16 0 0 0 0 0 0 0 0 0 0 0 0 0
---
0 0 0 0 0 0 0 19 19 19 19 19 19 0 0 0 0 0 0 0
0 0 0 0 0 19 19 16 16 19 16 16 19 19 19 0 0 0 0 0
0 0 0 19 19 16 16 16 16 16 16 19 16 16 2 2 0 0 0 0
0 0 19 16 16 16 16 19 16 19 19 19 19 19 16 16 2 0 0 0
0 19 16 16 19 16 16 16 19 19 5 9 9 9 2 2 2 2 0 0
0 19 16 19 16 16 16 19 5 9 9 5 9 9 9 9 5 2 0 0
19 16 19 16 16 16 19 5 9 9 9 9 9 9 9 5 9 5 2 0
19 16 16 16 16 19 5 9 9 5 15 15 9 9 9 9 9 9 2 0
19 19 16 16 16 19 12 12 12 12 15 15 9 9 9 9 9 9 16 2
19 16 19 16 19 5 12 5 12 12 15 5 15 9 9 9 16 9 16 2
19 16 16 16 19 10 10 10 7 15 15 15 15 9 16 16 16 16 16 2
19 16 16 16 19 10 10 10 7 16 15 16 16 16 16 16 16 16 0 0
19 16 16 16 19 10 16 16 16 16 16 16 16 13 13 19 19 19 0 0
0 19 16 19 10 16 16 16 13 13 13 19 19 19 19 0 0 0 0 0
0 0 19 5 5 5 5 19 19 19 19 0 0 0 0 0 0 0 0 0
0 0 0 19 19 19 19 0 0 0 0 0 0 0 0 0 0 0 0 0
