0 0 0 0 0 18 18 0 0 0 0 0
0 0 0 18 18 5 5 18 18 0 0 0
0 18 18 18 5 5 5 5 18 18 18 0
18 5 5 18 5 5 5 5 18 5 5 18
18 5 5 5 18 5 5 18 5 5 5 18
0 18 5 5 18 6 6 18 5 5 18 0
0 0 18 6 6 6 6 6 6 18 0 0
0 0 0 18 14 6 6 14 18 0 0 0
0 0 0 18 18 14 14 18 18 0 0 0
0 0 0 18 14 18 18 14 18 0 0 0
0 0 0 18 14 14 14 14 18 0 0 0
0 0 0 0 18 18 18 18 0 0 0 0
---
0 0 0 0 0 14 6 0 0 0 0 0
0 0 0 14 14 18 18 6 6 0 0 0
0 14 14 14 18 18 18 18 6 6 6 0
14 18 18 14 18 18 18 18 6 18 18 6
5 18 18 18 14 18 18 6 18 18 18 5
0 5 18 18 14 18 18 6 18 18 5 0
0 0 5 18 18 18 18 18 18 5 0 0
0 0 0 5 18 18 18 18 5 0 0 0
0 0 0 5 5 18 18 5 5 0 0 0
0 0 0 5 18 5 5 18 5 0 0 0
0 0 0 5 5 5 5 5 5 0 0 0
0 0 0 0 5 5 5 5 0 0 0 0
