0 0 0 0 0 0 0 0 0 18 18 18 18 0 0 18 18 18 18 0 0 0 0 0 0 0 0 0 0 0 0
0 0 0 0 0 0 0 0 18 14 14 14 14 18 18 14 14 14 19 18 18 0 0 0 0 0 0 0 0 0 0
0 0 0 0 0 18 18 18 14 14 14 14 14 14 14 14 14 19 19 19 19 18 18 0 0 0 0 0 0 0 0
0 0 18 18 18 14 14 14 14 14 14 14 14 14 19 14 16 16 16 16 19 19 19 18 0 0 0 0 0 0 0
0 18 2 18 14 14 14 14 14 14 14 14 19 19 19 16 2 2 9 2 16 14 14 18 18 0 0 0 0 0 0
18 9 2 18 14 14 14 14 14 19 19 19 19 14 16 2 2 2 9 2 2 16 14 19 19 18 0 0 0 0 0
18 9 18 14 14 14 14 14 14 14 14 14 14 14 16 2 2 9 2 2 2 16 14 14 19 18 0 0 0 0 0
18 2 18 14 14 14 14 14 14 14 14 14 14 14 19 16 16 16 2 2 2 9 16 14 19 19 18 0 0 0 0
0 18 18 14 14 14 14 14 12 19 14 14 14 19 19 19 19 19 16 9 9 9 16 14 19 19 18 0 0 0 0
0 0 0 18 18 14 19 19 12 12 19 19 19 19 12 16 16 16 2 2 2 16 14 14 19 19 18 0 0 0 0
0 18 18 2 18 18 12 12 8 8 12 12 12 12 8 16 2 9 2 2 2 16 14 14 14 19 19 18 18 0 0
0 18 9 2 2 18 8 8 8 8 8 8 8 8 8 12 16 9 2 16 16 14 14 14 14 19 18 2 2 18 0
0 0 18 9 18 18 8 18 8 8 8 18 8 8 8 12 19 16 16 19 14 14 14 14 14 19 18 18 2 2 18
0 0 0 18 8 8 8 18 8 8 8 18 8 8 8 12 19 19 14 14 14 19 14 14 19 19 19 18 18 2 18
0 0 0 18 8 8 8 12 12 12 8 8 8 8 8 12 19 14 14 14 14 14 19 19 19 19 19 18 0 18 0
0 0 0 18 8 8 8 8 12 8 8 12 8 8 8 12 14 14 14 14 14 14 14 14 19 19 19 18 0 0 0
0 0 0 18 8 8 8 12 12 12 12 8 8 8 8 12 14 14 14 14 14 14 14 14 19 19 18 0 0 0 0
0 0 0 0 18 8 8 8 8 8 8 8 8 12 12 14 14 14 14 14 14 14 14 19 19 19 18 0 0 0 0
0 0 0 0 0 18 12 12 12 12 12 12 12 14 14 14 14 14 14 14 14 14 14 19 19 19 18 0 0 0 0
0 0 0 0 0 18 14 14 14 14 14 14 19 14 14 19 14 14 14 19 19 19 19 19 19 18 0 0 0 0 0
0 0 0 0 0 18 19 14 14 14 19 19 19 19 19 19 19 19 19 19 19 19 19 19 18 0 0 0 0 0 0
0 0 0 0 0 18 19 19 19 19 19 19 2 2 19 19 19 19 19 19 19 19 2 2 18 0 0 0 0 0 0
0 0 0 0 0 0 18 2 2 18 18 18 2 2 18 18 18 18 2 2 18 18 2 2 18 0 0 0 0 0 0
0 0 0 0 0 0 0 18 18 0 0 0 18 18 0 0 0 0 18 18 0 0 18 18 0 0 0 0 0 0 0
---
0 0 0 0 0 0 0 0 0 14 14 14 14 0 0 14 14 14 14 0 0 0 0 0 0 0 0 0 0 0 0
0 0 0 0 0 0 0 0 14 19 19 19 2 14 14 2 2 2 2 14 14 0 0 0 0 0 0 0 0 0 0
0 0 0 0 0 14 14 14 19 19 19 19 2 2 2 2 2 2 2 2 2 14 14 0 0 0 0 0 0 0 0
0 0 14 14 14 19 19 19 19 19 19 19 2 2 2 2 8 8 8 8 2 2 2 14 0 0 0 0 0 0 0
0 14 18 14 19 19 19 19 19 19 19 19 2 2 2 8 8 8 8 8 8 2 2 14 14 0 0 0 0 0 0
14 18 18 14 19 19 19 19 19 2 2 2 2 2 8 8 8 8 8 8 8 8 2 18 18 14 0 0 0 0 0
14 18 14 19 19 19 19 19 19 19 19 19 19 19 8 8 8 8 8 8 8 8 2 2 18 14 0 0 0 0 0
14 18 14 19 19 19 19 19 19 19 19 19 19 19 19 8 8 8 8 8 8 8 8 2 18 18 14 0 0 0 0
0 14 14 19 19 19 19 19 14 19 19 19 19 19 19 19 19 19 8 8 8 8 8 2 18 18 14 0 0 0 0
0 0 0 14 14 19 19 19 14 14 19 19 19 19 14 8 8 8 8 8 8 8 2 2 18 18 14 0 0 0 0
0 14 14 18 14 14 14 14 19 19 14 14 14 14 14 8 8 8 8 8 8 8 2 2 2 18 18 14 14 0 0
0 14 18 18 18 14 14 19 19 19 19 19 14 14 14 14 8 8 8 8 8 2 2 2 2 18 14 12 12 14 0
0 0 14 18 14 14 19 12 19 19 19 12 19 14 14 14 9 8 8 9 16 16 16 2 2 18 14 14 12 12 14
0 0 0 14 14 14 19 12 19 19 19 12 19 14 14 14 9 9 16 16 16 18 16 16 18 18 18 14 14 12 14
0 0 0 14 14 14 19 18 18 18 19 19 19 14 14 14 9 16 16 16 16 16 18 18 18 18 18 14 0 14 0
0 0 0 14 14 14 19 19 18 19 19 18 19 14 14 14 16 16 16 16 16 16 16 16 18 18 18 14 0 0 0
0 0 0 14 14 14 19 18 18 18 18 19 19 14 14 14 16 16 16 16 16 16 12 12 18 18 14 0 0 0 0
0 0 0 0 14 14 14 19 19 19 19 14 14 14 14 12 12 12 12 12 12 12 12 18 18 18 14 0 0 0 0
0 0 0 0 0 14 14 14 14 14 14 14 14 12 12 12 12 12 12 12 12 12 12 18 18 18 14 0 0 0 0
0 0 0 0 0 14 14 9 9 9 9 9 18 12 12 18 12 12 12 18 18 18 18 18 18 14 0 0 0 0 0
0 0 0 0 0 14 18 9 9 9 18 18 18 18 18 18 18 18 18 18 18 18 18 18 14 0 0 0 0 0 0
0 0 0 0 0 14 18 18 18 18 18 18 18 18 18 18 18 18 18 18 18 18 18 18 14 0 0 0 0 0 0
0 0 0 0 0 0 14 18 18 14 14 14 18 18 14 14 14 14 18 18 14 14 18 18 14 0 0 0 0 0 0
0 0 0 0 0 0 0 14 14 0 0 0 14 14 0 0 0 0 14 14 0 0 14 14 0 0 0 0 0 0 0
