0 0 0 0 0 0 0 0 4 4 4 4 4 4 4 4 0 0 0 0 0 0 0 0 0
0 0 0 0 0 0 4 4 7 7 7 7 7 7 7 7 4 4 0 0 10 10 10 10 0
0 0 0 0 4 4 8 7 8 8 8 8 8 8 8 8 7 8 4 4 0 10 10 10 10
0 0 0 4 7 7 8 8 8 8 8 8 8 8 8 8 8 8 7 7 4 0 10 10 10
0 0 4 9 9 9 7 8 8 7 7 7 7 7 7 8 8 7 9 9 9 4 10 10 10
0 4 7 7 9 9 9 9 9 9 9 9 9 9 9 9 9 9 9 9 7 10 10 10 0
0 4 3 3 7 7 7 7 9 9 9 9 9 9 9 9 7 7 7 7 10 10 10 0 0
0 4 3 3 3 3 3 3 7 7 7 7 7 7 7 7 3 3 3 10 10 10 4 0 0
4 8 7 3 3 3 3 3 3 3 3 3 3 3 3 3 3 3 10 10 10 7 8 4 0
4 8 8 7 7 7 3 3 3 3 3 3 3 3 3 3 3 10 10 10 7 8 8 4 0
4 8 8 8 8 8 7 7 7 7 7 7 7 7 7 7 10 10 10 8 8 8 8 4 0
4 9 8 8 8 8 8 8 8 8 8 8 8 8 8 10 10 10 8 8 8 8 9 4 0
4 3 9 8 8 8 8 8 8 8 8 8 8 8 10 10 10 8 8 8 8 9 3 4 0
4 3 7 9 9 9 9 9 9 9 9 9 9 10 10 10 9 9 9 9 9 7 3 4 0
4 3 3 7 3 7 7 3 9 9 9 9 10 10 10 9 3 7 7 3 7 3 3 4 0
4 8 3 3 3 3 3 3 3 3 3 14 10 10 3 3 3 3 3 3 3 3 8 4 0
0 4 8 3 3 3 3 3 3 3 14 10 10 3 3 3 3 3 3 3 3 8 4 0 0
0 4 3 8 8 8 8 8 3 14 10 10 3 3 3 3 8 8 8 8 8 3 4 0 0
0 4 3 3 3 3 3 3 14 10 10 8 8 8 8 8 3 3 3 3 3 3 4 0 0
0 10 4 9 9 9 3 14 10 10 3 3 3 3 3 3 3 3 9 9 9 4 0 0 0
10 14 0 4 8 14 14 10 10 9 9 9 9 9 9 9 9 9 8 8 4 0 0 0 0
10 14 14 14 14 10 10 10 8 9 9 9 9 9 9 8 8 8 4 4 0 0 0 0 0
10 10 10 10 10 10 4 4 8 8 8 8 8 8 8 8 4 4 0 0 0 0 0 0 0
0 10 10 10 10 0 0 0 4 4 4 4 4 4 4 4 0 0 0 0 0 0 0 0 0
---
0 0 0 0 0 0 0 0 3 3 3 3 3 3 3 3 0 0 0 0 0 0 0 0 0
0 0 0 0 0 0 3 3 10 10 10 10 10 10 10 10 3 3 0 0 8 8 8 8 0
0 0 0 0 3 3 7 10 7 7 7 7 7 7 7 7 10 7 3 3 0 8 8 8 8
0 0 0 3 8 8 7 7 7 7 7 7 7 7 7 7 7 7 14 14 3 0 8 8 8
0 0 3 3 3 3 8 7 7 9 9 9 9 9 9 7 7 14 3 3 3 3 8 8 8
0 3 8 8 3 3 3 3 3 3 3 3 3 3 3 3 3 3 3 3 8 8 8 8 0
0 3 9 9 8 8 8 8 3 3 3 3 3 3 3 3 8 8 8 8 8 8 8 0 0
0 3 9 9 9 9 9 9 8 8 8 8 8 8 8 8 9 9 9 8 8 8 9 0 0
3 3 4 9 9 9 9 9 9 9 9 9 9 9 9 9 9 9 8 8 8 7 7 9 0
3 3 3 4 4 4 9 9 9 9 9 9 9 9 9 9 9 8 8 8 7 7 7 9 0
3 3 3 3 3 3 4 4 4 4 4 4 4 4 4 4 8 8 8 7 7 7 7 9 0
3 4 3 3 3 3 3 3 3 3 3 3 3 3 3 8 8 8 7 7 7 7 10 9 0
3 4 4 3 3 3 3 3 3 3 3 3 3 3 8 8 8 7 7 7 7 10 7 9 0
3 4 7 4 4 4 4 4 4 4 4 4 4 8 8 8 10 10 10 10 10 10 7 9 0
3 4 4 8 4 3 3 4 4 4 4 4 8 8 8 10 7 14 14 7 10 7 7 9 0
3 14 4 4 4 4 4 4 4 4 4 8 8 8 7 7 7 7 7 7 7 7 9 9 0
0 3 14 4 4 4 4 4 4 4 8 8 8 10 7 7 7 7 7 7 7 3 9 0 0
0 3 4 14 14 14 14 14 4 8 8 8 10 10 10 10 3 3 3 3 3 10 9 0 0
0 3 4 4 4 4 4 4 8 8 8 3 3 3 3 3 10 10 10 10 10 10 9 0 0
0 8 9 4 4 4 4 8 8 8 10 10 10 10 10 10 10 10 10 10 10 9 0 0 0
8 8 0 9 9 8 8 8 8 10 10 10 10 10 10 10 10 10 10 10 9 0 0 0 0
8 8 8 8 8 8 8 8 10 10 10 10 10 10 10 10 10 10 9 9 0 0 0 0 0
8 8 8 8 8 8 9 9 10 10 10 10 10 10 10 10 9 9 0 0 0 0 0 0 0
0 8 8 8 8 0 0 0 9 9 9 9 9 9 9 9 0 0 0 0 0 0 0 0 0
