4 4 4 4 4 4 4 4 4 4 4 4 4 4 4 4 4
4 4 4 4 4 4 4 4 4 4 4 4 4 4 4 4 4
4 4 4 4 4 4 4 4 4 4 4 4 4 4 4 4 4
1 1 1 1 1 1 1 1 5 1 1 1 1 1 1 1 1
1 1 1 1 1 1 1 6 6 5 1 1 1 1 1 1 1
1 1 1 5 1 1 1 6 6 5 1 1 1 1 1 1 1
3 3 3 6 5 3 3 6 6 5 3 3 3 3 3 3 3
3 3 3 6 5 3 3 6 6 5 3 3 5 3 3 3 3
3 3 3 6 5 3 3 6 6 5 3 3 6 5 3 3 3
8 8 8 6 5 8 8 6 6 5 8 8 6 5 8 8 8
8 8 8 6 5 8 8 6 6 5 8 8 6 5 8 8 8
8 8 8 6 6 5 8 6 6 5 8 6 6 5 8 8 8
15 15 15 15 6 6 5 6 6 5 6 6 5 15 15 15 15
15 15 15 15 15 6 6 6 6 5 6 6 15 15 15 15 15
15 15 15 15 15 15 15 6 6 5 15 15 15 15 15 15 15
9 9 9 9 9 9 9 6 6 5 9 9 9 9 9 9 9
9 9 9 9 9 9 9 6 6 5 9 9 9 9 9 9 9
9 9 9 9 9 9 9 6 6 5 9 9 9 9 9 9 9
2 2 2 2 2 2 2 6 6 5 2 2 2 2 2 2 2
2 2 2 2 2 2 2 2 2 2 2 2 2 2 2 2 2
2 2 2 2 2 2 2 2 2 2 2 2 2 2 2 2 2
---
4 4 4 6 6 6 6 6 5 5 5 5 5 5 4 4 4
4 4 4 6 6 6 6 6 5 5 5 5 5 4 4 4 4
4 4 4 4 6 6 6 6 4 4 4 4 4 4 4 4 4
1 1 1 1 1 1 1 1 4 1 1 1 1 1 1 1 1
1 1 1 1 1 1 1 4 4 4 1 1 1 1 1 1 1
1 1 1 1 1 1 3 4 4 4 1 1 1 1 1 1 1
3 3 3 8 8 8 3 4 4 4 3 3 3 3 3 3 3
3 3 3 8 8 3 3 4 4 4 3 3 8 3 3 3 3
3 3 6 8 8 3 3 4 4 4 3 3 15 15 3 3 3
5 6 5 6 8 8 3 4 4 4 8 8 15 15 8 8 8
6 5 6 6 8 8 8 4 4 4 8 8 15 15 8 8 8
5 5 5 6 8 5 8 6 6 4 8 15 15 15 8 8 5
15 15 15 15 6 6 5 6 6 4 15 15 15 6 6 5 5
15 15 15 15 15 6 6 6 6 4 15 15 6 6 6 6 5
15 15 15 15 15 15 15 2 2 2 15 15 6 6 6 5 5
9 9 9 9 9 9 9 2 2 2 9 9 9 9 9 9 9
9 9 9 9 9 9 9 2 2 2 9 9 9 9 9 9 9
9 9 9 9 9 9 9 2 2 2 9 9 9 9 9 9 9
2 2 2 2 2 2 2 2 2 2 2 2 2 2 2 2 2
2 2 2 2 6 6 6 6 6 5 5 5 2 2 2 2 2
2 2 2 2 6 6 6 6 6 5 2 5 2 2 2 2 2
