8 8 19 19 8 8 8 8 8 8 8 8 8 8 8 19 19 8
19 19 19 8 8 8 19 19 19 19 19 8 19 19 19 19 19 8
8 19 19 8 8 19 19 4 4 4 4 4 4 4 4 4 8 19
19 19 8 19 19 4 4 14 14 14 14 14 14 14 14 4 19 19
19 8 8 19 4 14 14 3 3 3 3 3 3 3 1 4 19 19
19 8 19 4 14 3 3 3 1 1 1 1 1 1 4 2 19 19
19 19 19 4 3 3 3 1 4 4 4 4 1 4 2 19 19 19
8 8 4 3 3 3 1 4 14 3 1 1 4 2 19 19 19 19
8 19 4 1 3 1 4 3 4 4 14 1 1 4 19 19 8 8
8 19 4 1 3 1 4 1 4 3 4 3 1 4 19 19 8 19
8 19 4 1 3 14 3 4 14 1 4 14 1 4 19 8 8 19
19 19 2 4 1 3 14 3 4 4 14 3 1 4 8 8 19 19
19 19 19 4 1 3 3 14 14 3 3 1 1 4 8 19 19 8
19 19 8 2 4 1 1 3 3 3 1 1 4 2 8 19 8 8
19 8 8 19 2 4 4 1 1 1 1 4 2 8 19 19 8 19
8 8 19 19 8 2 2 4 4 4 4 2 8 19 19 19 8 8
8 19 19 19 19 19 19 2 2 2 2 19 19 19 19 8 8 8
19 19 19 19 19 8 8 8 8 8 8 19 19 19 19 8 8 19
---
8 8 8 8 19 19 19 19 19 19 19 19 19 19 19 8 8 19
8 8 8 19 19 19 8 8 8 8 8 19 8 8 8 8 8 19
19 8 8 19 19 8 8 1 1 1 1 1 1 1 1 1 19 8
8 8 19 8 8 1 1 4 4 4 4 4 4 4 4 1 8 8
8 19 19 8 1 4 4 19 19 19 19 19 19 19 3 1 8 8
8 19 8 1 4 19 19 19 3 3 3 3 3 3 1 4 8 8
8 8 8 1 19 19 19 3 1 1 1 1 3 1 4 8 8 8
19 19 1 19 19 19 3 1 4 19 3 3 1 4 8 8 8 8
19 4 1 3 19 3 1 19 4 4 4 3 3 1 8 8 19 19
19 4 1 3 19 3 1 4 4 19 1 19 3 1 8 8 19 14
19 4 2 3 19 4 19 1 4 4 1 4 3 2 8 19 19 14
4 4 4 2 3 19 4 19 1 1 4 19 3 2 19 19 14 14
4 4 4 2 3 19 19 4 4 19 19 3 3 2 19 14 14 19
4 4 19 4 2 3 3 19 19 19 3 3 2 4 19 14 19 19
4 19 19 8 4 2 2 3 3 3 3 2 4 19 14 14 19 4
19 19 8 8 4 4 4 2 2 2 2 4 19 14 14 14 19 19
19 8 8 8 8 8 8 4 4 4 4 14 14 14 14 19 19 19
8 8 8 8 8 19 19 19 19 19 19 14 14 14 14 19 19 4
