0 0 0 13 0 0 0 0 0 0 0 0
0 0 0 0 13 13 0 0 0 0 0 0
0 9 0 0 9 13 13 0 0 0 0 0
0 0 0 13 9 9 13 13 0 13 0 0
0 0 9 9 9 9 9 13 13 9 13 0
0 13 13 9 9 8 9 8 9 9 9 13
13 9 8 9 8 8 8 9 9 13 9 13
13 9 9 8 8 8 8 8 9 9 13 0
13 9 8 16 8 14 16 8 8 13 13 0
13 13 8 14 10 10 14 14 8 13 13 0
0 13 13 8 14 14 14 9 13 13 0 0
0 0 13 13 13 13 13 13 13 0 0 0
---
0 0 0 13 0 0 0 0 0 0 0 0
0 0 0 0 13 13 0 0 0 0 0 0
0 9 0 0 16 13 13 0 0 0 0 0
0 0 0 13 16 13 13 13 0 13 0 0
0 0 13 13 13 13 13 13 13 13 13 0
0 9 9 13 13 8 13 8 13 13 13 9
9 13 13 13 8 8 8 13 13 13 13 9
9 13 13 14 14 14 14 8 13 13 9 0
9 13 13 10 14 8 10 8 8 9 9 0
9 9 8 8 14 14 8 8 8 9 9 0
0 9 9 8 8 8 8 9 9 9 0 0
0 0 9 9 9 9 9 9 9 0 0 0
