0 0 0 0 0 0 0 0 0 0 17 0 0 0 0 0 0 0 0 0 0 0 0 0 0 0 0 0 0 0 0 0
0 0 0 0 0 0 0 0 0 17 17 17 0 0 0 0 0 0 0 0 0 0 0 0 0 0 0 0 0 0 0 0
0 0 0 0 0 0 0 0 0 17 6 17 0 0 0 0 0 0 0 0 0 0 0 0 0 0 0 0 0 0 0 0
0 0 0 0 0 0 0 0 17 17 6 17 17 0 0 0 0 0 0 0 0 0 0 0 0 0 0 0 0 0 0 0
0 0 0 0 0 0 0 17 5 5 5 6 6 17 0 0 0 0 0 0 0 0 0 0 0 0 0 0 0 0 0 0
0 0 0 0 0 0 0 17 17 17 5 17 17 17 0 0 0 0 0 0 0 0 0 0 0 0 0 0 0 0 0 0
0 0 0 0 0 0 17 5 5 17 5 17 6 6 17 0 0 0 0 0 0 0 0 0 0 0 0 0 0 0 0 0
0 0 4 4 1 1 17 5 5 5 17 5 5 6 6 17 0 0 0 0 0 0 0 0 0 0 0 0 0 0 0 0
0 4 14 14 14 14 4 5 5 5 5 5 5 6 6 17 0 0 0 0 0 0 0 0 0 0 0 0 0 0 0 0
0 4 14 4 4 14 14 4 5 5 5 5 5 5 6 6 17 17 0 0 0 0 0 0 0 0 0 0 0 0 0 0
0 0 4 16 12 4 14 14 4 5 5 5 5 6 6 6 6 6 17 0 0 0 0 0 0 0 0 0 0 0 0 0
0 0 0 16 12 12 4 14 4 5 5 5 5 5 6 17 17 17 0 0 0 0 0 0 0 0 0 0 0 0 0 0
0 0 0 16 12 12 4 14 14 4 5 17 17 5 5 17 6 0 0 0 0 0 0 0 0 0 0 0 0 0 0 0
0 0 0 16 12 13 12 4 14 4 17 5 5 17 17 5 6 17 0 0 0 0 0 0 0 0 0 0 0 0 0 0
0 0 0 16 12 13 13 4 14 4 4 4 4 5 5 6 17 6 17 0 0 0 1 1 1 1 1 0 0 0 0 0
0 0 0 16 12 13 13 4 14 14 14 14 14 4 5 17 5 17 17 17 0 0 1 14 14 14 14 1 0 0 0 0
0 0 0 16 12 13 13 13 4 4 4 4 14 14 4 5 5 17 0 0 0 4 14 14 4 4 14 1 0 0 0 0
0 0 0 16 12 13 13 13 12 12 12 12 4 14 4 5 5 5 17 0 0 4 14 4 12 16 4 0 0 0 0 0
0 0 0 16 12 12 13 13 14 13 13 13 4 14 14 4 4 4 4 4 4 4 14 4 13 16 0 0 0 0 0 0
0 0 0 0 16 14 12 14 13 14 13 14 12 4 14 14 14 14 14 14 14 14 14 4 13 16 0 0 0 0 0 0
0 0 0 0 16 12 12 13 14 13 13 13 13 12 4 4 4 4 4 4 4 4 4 13 13 16 0 0 0 0 0 0
0 0 0 0 16 12 12 12 13 13 13 13 13 13 13 13 13 13 13 13 13 13 13 13 13 16 0 0 0 0 0 0
0 0 0 0 0 16 12 12 14 12 13 13 13 13 13 13 13 13 13 13 13 13 13 13 13 16 0 16 16 0 0 0
0 0 0 0 0 16 16 12 12 12 12 12 12 12 12 12 12 12 12 12 13 13 13 12 16 0 16 15 15 16 0 0
0 0 0 0 0 0 0 16 12 12 12 12 16 16 16 16 16 16 16 12 12 12 12 16 0 16 9 9 15 15 16 0
0 0 0 0 0 0 0 16 9 9 15 15 16 0 0 0 0 0 16 9 9 15 15 16 0 16 9 16 9 15 16 0
0 0 0 16 16 16 16 9 9 15 15 16 16 16 16 16 16 16 16 16 9 9 15 15 16 16 16 16 9 15 16 0
0 16 16 9 9 9 15 15 15 15 15 15 15 15 15 15 15 15 15 15 15 15 15 15 15 15 15 15 15 16 15 16
16 9 9 9 9 9 9 9 9 9 9 9 9 9 9 9 9 9 9 9 9 9 9 9 9 9 9 9 9 9 9 16
0 16 16 16 16 16 16 16 16 16 16 16 16 16 16 16 16 16 16 16 16 16 16 16 16 16 16 16 16 16 16 0
---
0 0 0 0 0 0 0 0 0 0 12 0 0 0 0 0 0 0 0 0 0 0 0 0 0 0 0 0 0 0 0 0
0 0 0 0 0 0 0 0 0 12 12 12 0 0 0 0 0 0 0 0 0 0 0 0 0 0 0 0 0 0 0 0
0 0 0 0 0 0 0 0 0 12 4 12 0 0 0 0 0 0 0 0 0 0 0 0 0 0 0 0 0 0 0 0
0 0 0 0 0 0 0 0 12 12 4 12 15 0 0 0 0 0 0 0 0 0 0 0 0 0 0 0 0 0 0 0
0 0 0 0 0 0 0 4 4 4 4 4 4 15 0 0 0 0 0 0 0 0 0 0 0 0 0 0 0 0 0 0
0 0 0 0 0 0 0 4 4 15 4 15 15 15 0 0 0 0 0 0 0 0 0 0 0 0 0 0 0 0 0 0
0 0 0 0 0 0 4 4 4 15 4 15 5 5 15 0 0 0 0 0 0 0 0 0 0 0 0 0 0 0 0 0
0 0 16 16 5 5 4 4 4 4 15 4 4 5 5 15 0 0 0 0 0 0 0 0 0 0 0 0 0 0 0 0
0 16 12 12 12 12 5 4 4 4 4 4 4 5 5 15 0 0 0 0 0 0 0 0 0 0 0 0 0 0 0 0
0 16 12 16 16 12 12 5 4 4 4 4 4 4 5 5 15 15 0 0 0 0 0 0 0 0 0 0 0 0 0 0
0 0 16 14 14 16 12 12 5 4 4 4 4 5 5 5 5 5 15 0 0 0 0 0 0 0 0 0 0 0 0 0
0 0 0 14 14 14 16 12 5 4 4 4 4 4 5 15 15 15 0 0 0 0 0 0 0 0 0 0 0 0 0 0
0 0 0 14 14 14 16 12 12 5 4 15 15 4 4 15 15 0 0 0 0 0 0 0 0 0 0 0 0 0 0 0
0 0 0 14 14 16 14 16 12 5 15 4 4 15 15 4 15 15 0 0 0 0 0 0 0 0 0 0 0 0 0 0
0 0 0 14 14 16 16 16 12 5 5 5 5 4 4 15 15 15 15 0 0 0 5 5 5 5 5 0 0 0 0 0
0 0 0 9 14 16 16 16 12 12 12 12 12 5 4 15 4 15 15 15 0 0 5 12 12 12 12 5 0 0 0 0
0 0 0 9 14 16 16 16 16 16 16 16 12 12 5 4 4 15 0 0 0 5 12 12 16 16 12 5 0 0 0 0
0 0 0 9 14 16 16 16 1 1 1 1 16 12 5 4 4 4 15 0 0 5 12 16 15 13 16 0 0 0 0 0
0 0 0 9 14 14 16 16 1 16 16 16 16 12 12 5 5 5 5 5 5 5 12 16 16 13 0 0 0 0 0 0
0 0 0 0 9 5 14 1 16 1 16 16 1 16 12 12 12 12 12 12 12 12 12 16 16 13 0 0 0 0 0 0
0 0 0 0 9 14 14 16 1 16 16 16 16 1 16 16 16 16 16 16 16 16 16 16 16 13 0 0 0 0 0 0
0 0 0 0 9 14 14 14 16 16 16 16 16 16 16 16 16 16 16 16 16 16 16 16 16 13 0 0 0 0 0 0
0 0 0 0 0 9 14 14 5 14 16 16 16 16 16 16 16 16 16 16 16 16 16 16 16 13 0 13 13 0 0 0
0 0 0 0 0 9 9 14 14 14 14 14 14 14 14 14 14 14 14 14 16 16 16 14 13 0 13 17 17 13 0 0
0 0 0 0 0 0 0 9 14 14 14 14 6 6 6 6 6 6 6 14 14 14 14 13 0 13 17 17 17 17 13 0
0 0 0 0 0 0 0 9 6 6 17 17 6 0 0 0 0 0 6 17 17 17 17 13 0 13 17 13 17 17 13 0
0 0 0 9 9 9 9 6 6 17 17 6 6 6 6 6 6 6 6 6 17 17 17 17 13 13 13 13 17 17 13 0
0 9 9 13 13 13 17 17 17 17 17 17 17 17 17 17 17 17 17 17 17 17 17 17 17 17 17 17 17 13 17 13
9 13 13 13 13 13 13 13 13 13 13 13 13 13 13 13 13 13 13 13 13 13 13 13 13 13 13 13 13 13 13 13
0 9 9 9 9 9 9 9 9 9 9 9 9 9 9 9 9 9 9 9 9 9 9 9 9 9 9 9 13 13 13 0
