0 0 0 0 16 16 16 16 0 0 0 0
0 0 16 16 15 15 15 15 16 16 0 0
0 16 15 9 9 9 9 9 15 16 16 0
16 15 9 9 9 9 9 9 9 15 16 16
16 15 9 16 9 9 16 9 9 15 15 16
16 15 7 9 9 9 9 7 7 15 15 16
16 15 9 9 16 16 9 9 9 15 15 16
0 16 15 9 9 9 9 9 15 15 16 0
0 0 16 15 15 15 15 15 15 16 0 0
0 0 0 16 16 15 16 16 16 0 0 0
0 0 0 0 0 16 6 16 0 0 0 0
0 0 0 16 16 16 6 16 16 16 0 0
0 0 16 6 6 6 16 6 6 6 16 0
0 0 0 16 6 6 16 6 6 16 0 0
0 0 0 0 16 16 0 16 16 0 0 0
---
0 0 0 0 9 9 9 9 0 0 0 0
0 0 9 9 16 16 16 16 9 9 0 0
0 9 16 16 16 16 16 16 16 9 9 0
9 16 16 16 16 16 16 16 16 16 9 9
9 16 15 7 15 15 7 15 15 16 16 9
9 16 7 15 15 15 15 6 6 16 16 9
9 16 15 15 6 6 15 15 15 16 16 9
0 9 16 15 15 15 15 15 16 16 9 0
0 0 9 16 16 16 16 16 16 9 0 0
0 0 0 9 9 16 9 9 9 0 0 0
0 0 0 0 0 9 16 9 0 0 0 0
0 0 0 15 15 15 16 15 15 15 0 0
0 0 15 16 16 16 6 16 16 16 15 0
0 0 0 6 16 16 6 16 16 6 0 0
0 0 0 0 6 6 0 6 6 0 0 0
