0 0 0 0 16 16 16 0 0 0 0 0 0 0 0
0 0 16 16 9 9 9 16 0 16 16 16 16 16 0
0 16 9 9 16 16 2 9 16 6 6 6 6 6 16
16 9 16 16 16 0 16 16 16 6 6 6 5 16 0
16 9 16 9 16 0 16 6 6 16 5 5 5 5 16
16 2 2 2 16 16 16 6 6 6 16 5 5 5 16
0 16 16 16 16 10 16 6 5 5 6 6 5 5 16
0 0 16 10 10 11 16 5 5 16 5 5 5 5 16
0 0 16 11 11 16 16 16 16 16 16 16 16 16 16
0 16 16 16 16 14 10 10 16 14 10 10 10 16 0
16 14 10 10 16 10 10 11 16 10 10 10 11 16 0
16 10 10 11 16 11 11 11 16 16 16 11 11 16 0
16 11 11 11 16 16 16 16 10 10 10 16 16 0 0
0 16 16 16 14 10 16 10 14 10 11 16 0 0 0
0 0 16 10 10 11 16 10 10 10 11 16 0 0 0
0 0 16 11 11 11 16 16 11 11 11 16 0 0 0
0 0 0 16 16 16 10 11 16 16 16 0 0 0 0
0 0 0 0 16 10 14 11 16 0 0 0 0 0 0
0 0 0 0 16 11 11 11 16 0 0 0 0 0 0
0 0 0 0 0 16 16 16 0 0 0 0 0 0 0
---
0 0 0 0 5 5 5 0 0 0 0 0 0 0 0
0 0 5 5 16 16 16 5 0 11 11 11 11 11 0
0 5 16 16 5 5 16 16 11 16 16 16 16 16 11
5 16 5 5 5 0 11 11 11 16 16 16 16 11 0
5 16 5 16 5 0 11 16 16 11 16 16 16 16 11
2 16 16 16 5 5 11 16 16 16 11 16 16 16 11
0 2 9 9 9 16 11 16 16 16 16 16 16 16 11
0 0 2 16 16 16 11 16 16 11 16 16 16 16 11
0 0 2 16 16 14 14 14 14 11 11 11 11 11 11
0 10 10 10 10 9 16 16 14 9 16 16 16 6 0
10 9 16 16 10 16 16 16 14 16 16 16 16 6 0
10 16 16 16 10 16 16 16 6 6 6 16 16 6 0
10 16 16 16 10 10 10 10 16 16 16 6 6 0 0
0 10 10 10 9 16 10 16 9 16 16 6 0 0 0
0 0 10 16 16 16 10 16 16 16 16 6 0 0 0
0 0 10 16 16 16 10 10 16 16 16 6 0 0 0
0 0 0 10 10 10 16 16 6 6 6 0 0 0 0
0 0 0 0 10 16 9 16 6 0 0 0 0 0 0
0 0 0 0 10 16 16 16 6 0 0 0 0 0 0
0 0 0 0 0 10 10 10 0 0 0 0 0 0 0
