0 0 0 0 0 0 0 0 0 4 4 4 4 4 4 0 0 0 0 0 0 0 0 0
0 0 0 0 0 0 0 4 4 3 3 3 3 3 3 4 4 0 0 0 0 0 0 0
0 0 0 0 0 0 4 3 3 3 3 3 3 3 3 3 3 4 0 0 0 0 0 0
0 0 0 0 0 4 3 3 3 3 3 3 3 3 3 3 3 3 4 0 0 0 0 0
0 0 0 0 4 3 3 3 10 3 3 3 3 3 3 10 3 3 3 4 0 0 0 0
0 0 0 4 3 3 3 10 10 10 3 3 3 3 10 10 10 3 3 3 4 0 0 0
0 0 4 10 10 3 10 10 10 10 10 3 3 10 10 10 10 10 3 10 10 4 0 0
0 4 10 15 10 10 10 10 10 10 10 15 15 10 10 10 10 10 10 10 15 10 4 0
0 4 15 15 15 10 10 10 10 10 15 15 15 15 10 10 10 10 10 15 15 15 4 0
0 4 15 15 15 15 10 10 10 15 15 15 15 15 15 10 10 10 15 15 15 15 4 0
4 15 15 15 15 15 15 10 15 15 15 15 15 15 15 15 10 15 15 15 15 15 15 4
4 15 15 10 10 15 15 15 15 15 15 10 10 15 15 15 15 15 15 10 10 15 15 4
4 15 10 6 6 10 10 15 15 10 10 6 6 10 10 15 15 10 10 6 6 10 15 4
4 10 6 6 6 6 10 10 10 10 6 6 6 6 10 10 10 10 6 6 6 6 10 4
4 6 6 6 6 6 6 10 6 6 6 6 6 6 6 10 10 6 6 6 6 6 6 4
4 6 6 6 6 6 6 6 6 6 6 6 6 6 6 6 6 6 6 6 6 6 6 4
4 6 6 6 6 6 6 6 6 6 6 6 6 6 6 6 6 6 6 6 6 6 6 4
0 4 6 6 6 6 6 10 10 6 6 6 6 6 6 10 10 6 6 6 6 6 4 0
0 4 6 6 6 6 10 10 10 10 6 6 6 6 10 10 10 10 6 6 6 6 4 0
0 0 4 6 6 10 10 10 3 10 10 6 6 10 10 3 10 10 10 6 6 4 0 0
0 0 0 4 10 10 10 3 3 10 10 10 10 10 10 3 3 10 10 10 4 0 0 0
0 0 0 0 4 10 3 3 3 3 10 10 10 10 3 3 3 3 10 4 0 0 0 0
0 0 0 0 0 4 4 3 3 3 3 3 3 3 3 3 3 4 4 0 0 0 0 0
0 0 0 0 0 0 0 4 4 4 4 4 4 4 4 4 4 0 0 0 0 0 0 0
---
0 0 0 0 0 0 0 0 0 6 6 6 6 6 6 0 0 0 0 0 0 0 0 0
0 0 0 0 0 0 0 6 6 10 10 10 10 10 10 6 6 0 0 0 0 0 0 0
0 0 0 0 0 0 6 10 10 10 10 10 10 10 10 10 10 6 0 0 0 0 0 0
0 0 0 0 0 6 10 10 10 10 10 10 10 10 10 10 10 10 6 0 0 0 0 0
0 0 0 0 6 10 10 10 6 10 10 10 10 10 10 6 10 10 10 6 0 0 0 0
0 0 0 6 10 10 10 6 6 6 10 10 10 10 6 6 6 10 10 10 6 0 0 0
0 0 6 6 6 10 6 6 6 6 6 10 10 6 6 6 6 6 10 6 6 6 0 0
0 6 6 3 6 6 6 6 6 6 6 3 3 6 6 6 6 6 6 6 3 6 6 0
0 6 3 3 3 6 6 6 6 6 3 3 3 3 6 6 6 6 6 3 3 3 6 0
0 6 3 3 3 3 6 6 6 3 3 3 3 3 3 6 6 6 3 3 3 3 6 0
6 3 3 3 3 3 3 6 3 3 3 3 3 3 3 3 6 3 3 3 3 3 3 6
6 3 3 6 6 3 3 3 3 3 3 6 6 3 3 3 3 3 3 6 6 3 3 6
10 3 6 15 15 6 6 3 3 6 6 3 3 6 6 3 3 6 6 15 15 6 3 10
10 6 15 15 15 15 6 6 6 6 3 3 3 3 6 6 6 6 15 15 15 15 6 10
10 15 15 15 15 15 15 6 10 10 10 3 3 10 10 6 6 15 15 15 15 15 15 10
10 15 15 15 15 15 10 10 10 10 10 10 10 10 10 10 10 15 15 15 15 15 15 10
10 15 15 15 15 15 15 10 10 10 10 10 10 10 10 10 15 15 15 15 15 15 15 10
0 10 15 15 15 15 15 4 4 10 10 10 10 10 10 4 4 15 15 15 15 15 10 0
0 10 15 15 15 15 4 4 4 4 10 10 10 10 4 4 4 4 15 15 15 15 10 0
0 0 10 15 15 4 4 4 4 4 4 10 10 4 4 4 4 4 4 15 15 10 0 0
0 0 0 10 4 4 4 4 4 4 4 4 4 4 4 4 4 4 4 4 10 0 0 0
0 0 0 0 10 4 4 4 4 4 4 4 4 4 4 4 4 4 4 10 0 0 0 0
0 0 0 0 0 10 10 4 4 4 4 4 4 4 4 4 4 10 10 0 0 0 0 0
0 0 0 0 0 0 0 10 10 10 10 10 10 10 10 10 10 0 0 0 0 0 0 0
