8 8 1 1 1 1 1 1 1 1 1 1 1 1 1 1 1 1 1 1 1 1 1 1
8 8 8 1 1 1 1 8 8 8 8 1 1 1 1 1 1 1 8 8 8 1 1 1
1 1 1 1 1 1 8 8 8 8 8 8 8 8 1 1 1 1 1 1 1 1 1 1
1 2 2 1 1 1 1 1 8 8 8 8 8 8 8 1 1 1 1 1 1 1 1 1
2 15 15 2 1 2 2 1 1 1 1 1 1 1 1 1 1 1 1 1 1 1 1 1
15 15 15 9 2 15 15 2 1 1 16 16 16 16 16 16 1 1 1 1 1 1 1 1
15 15 9 15 15 15 15 15 16 16 14 14 14 14 14 16 16 1 1 1 1 1 1 1
15 2 2 2 15 9 15 16 16 14 14 14 14 14 14 14 16 16 1 1 1 1 1 1
2 9 9 15 2 15 15 16 14 14 14 14 14 14 14 14 14 14 16 16 16 1 1 1
9 15 9 9 9 16 16 14 14 14 14 14 14 14 14 14 14 14 14 14 14 16 1 1
9 9 9 15 9 16 14 14 2 14 14 14 14 14 2 14 14 14 14 14 14 16 16 1
2 9 9 15 2 16 14 2 2 2 14 14 14 2 14 14 14 14 14 14 14 16 16 1
15 2 2 2 15 16 14 2 2 2 14 14 14 14 14 14 14 14 14 14 14 16 1 1
15 15 9 15 15 16 14 2 2 2 2 14 14 14 14 14 14 14 14 14 16 16 1 1
15 15 2 15 15 16 14 14 2 2 14 14 14 14 14 14 14 7 7 7 16 1 1 1
2 2 6 2 2 16 16 7 7 7 16 7 7 14 7 7 16 16 16 16 1 1 1 1
1 17 6 17 1 1 16 16 16 16 1 16 16 14 14 16 1 1 1 1 1 8 8 1
1 17 6 17 17 1 1 1 1 1 1 16 7 14 14 14 16 1 1 1 1 8 8 8
1 1 17 6 17 1 1 1 1 1 1 16 7 14 14 14 16 16 1 1 1 1 1 1
17 6 17 6 17 6 17 17 17 6 6 16 7 14 14 14 14 16 6 6 17 17 17 17
6 6 17 6 17 6 6 6 6 16 16 7 14 14 14 14 14 16 16 6 6 6 6 6
6 6 6 6 6 17 17 17 6 16 7 14 16 16 16 7 14 14 14 16 6 6 6 17
6 6 17 6 17 17 17 17 6 6 16 16 16 17 17 16 16 16 16 6 17 17 17 6
6 6 6 6 6 6 17 17 17 17 17 17 17 17 17 17 17 17 17 17 17 6 6 6
---
8 8 1 1 1 1 1 1 1 1 1 1 1 1 1 1 1 1 1 1 1 1 1 1
8 8 8 1 1 1 1 16 16 16 16 1 1 1 1 1 1 1 8 8 8 1 1 1
1 1 1 1 1 1 16 16 16 16 16 16 16 16 1 1 1 1 1 1 1 1 1 1
1 2 2 1 1 1 1 1 16 16 16 16 16 16 16 1 1 1 1 1 1 1 1 1
2 14 14 2 1 2 2 1 1 1 1 1 1 1 1 1 1 1 1 1 1 1 1 1
14 14 14 14 2 14 14 2 1 1 8 8 8 8 8 8 1 1 1 1 1 1 1 1
14 14 14 14 14 14 14 14 8 8 2 2 2 2 2 8 8 1 1 1 1 1 1 1
14 2 2 2 14 14 14 8 8 2 2 2 2 2 2 2 8 8 1 1 1 1 1 1
2 9 9 14 2 14 14 8 15 15 15 15 15 2 2 2 14 14 8 8 8 1 1 1
9 15 9 9 9 16 8 15 15 15 15 15 15 15 15 14 14 14 14 14 14 16 1 1
9 9 9 14 9 17 9 15 14 15 15 15 15 15 14 7 14 14 14 14 14 16 16 1
2 9 9 14 2 17 9 14 14 14 15 15 15 14 7 7 7 14 14 14 14 17 17 1
14 2 2 2 14 17 9 14 14 14 15 15 15 7 7 7 7 14 14 14 14 17 1 1
14 14 14 14 14 17 9 14 14 14 14 15 15 7 7 7 7 14 14 14 17 17 1 1
14 14 2 14 14 17 15 15 14 14 15 15 15 7 7 7 7 14 14 14 17 1 1 1
2 2 16 2 2 17 17 14 14 14 17 14 14 14 14 14 17 17 17 17 1 1 1 1
1 6 16 6 1 1 17 17 17 17 1 17 17 14 14 17 1 1 1 1 1 8 8 1
1 6 16 6 6 1 1 1 1 1 1 17 14 14 14 14 17 1 1 1 1 8 8 8
1 1 6 16 6 1 1 1 1 1 1 17 14 14 14 14 17 17 1 1 1 1 1 1
6 16 6 16 6 16 6 6 6 16 16 17 14 14 14 14 14 17 16 16 6 6 6 6
16 16 6 16 6 16 16 16 16 17 17 14 14 14 14 14 14 17 17 16 16 16 16 16
16 16 16 16 16 6 6 6 16 17 14 14 17 17 17 14 14 14 14 17 16 16 16 6
16 16 6 16 6 6 6 6 16 16 17 17 17 6 6 17 17 17 17 16 6 6 6 16
16 16 16 16 16 16 6 6 6 6 6 6 6 6 6 6 6 6 6 6 6 16 16 16
