0 0 0 0 0 0 0 0 0 0 4 0 0 0 0 0 0 0 0 0 0
0 0 0 0 0 0 0 0 0 12 6 4 0 0 0 0 0 0 0 0 0
0 0 0 12 0 0 0 0 12 9 6 6 4 0 0 0 0 4 0 0 0
0 0 12 9 12 12 0 0 12 9 6 6 4 0 0 4 4 5 4 0 0
0 0 0 12 9 9 12 12 0 12 6 4 0 4 4 6 5 4 0 0 0
0 0 0 12 15 9 12 9 12 9 6 6 4 6 4 5 5 4 0 0 0
0 0 0 0 12 12 9 9 12 12 6 4 4 6 5 4 4 0 0 0 0
0 0 0 0 12 15 15 9 12 9 6 6 4 5 5 5 4 0 0 0 0
0 0 12 12 0 12 12 12 9 9 6 6 5 4 4 4 0 4 4 0 0
0 12 15 15 12 15 12 15 15 9 4 5 5 5 4 5 4 5 5 4 0
12 15 15 15 15 15 15 15 15 12 4 4 3 3 3 3 3 3 3 3 4
0 12 7 7 12 7 12 7 7 7 4 3 3 3 4 3 4 3 3 4 0
0 0 12 12 0 12 12 12 7 10 10 1 1 4 4 4 0 4 4 0 0
0 0 0 0 12 7 7 7 12 10 10 1 4 1 3 3 4 0 0 0 0
0 0 0 0 12 12 7 10 12 12 10 4 4 1 1 4 4 0 0 0 0
0 0 0 12 7 7 12 10 12 10 10 1 4 1 4 1 3 4 0 0 0
0 0 0 12 7 10 12 12 0 12 10 4 0 4 4 1 1 4 0 0 0
0 0 12 7 12 12 0 0 12 10 10 1 4 0 0 4 4 1 4 0 0
0 0 0 12 0 0 0 0 12 10 10 1 4 0 0 0 0 4 0 0 0
0 0 0 0 0 0 0 0 0 12 10 4 0 0 0 0 0 0 0 0 0
0 0 0 0 0 0 0 0 0 0 12 0 0 0 0 0 0 0 0 0 0
---
0 0 0 0 0 0 0 0 0 0 10 0 0 0 0 0 0 0 0 0 0
0 0 0 0 0 0 0 0 0 7 12 10 0 0 0 0 0 0 0 0 0
0 0 0 7 0 0 0 0 7 4 12 12 10 0 0 0 0 10 0 0 0
0 0 7 4 7 7 0 0 7 4 12 12 10 0 0 10 10 12 10 0 0
0 0 0 7 4 4 7 7 0 1 12 10 0 10 10 12 12 10 0 0 0
0 0 0 7 4 4 7 4 1 4 12 12 10 12 15 12 12 15 0 0 0
0 0 0 0 1 1 4 4 1 1 12 10 10 12 12 15 15 0 0 0 0
0 0 0 0 1 4 4 4 1 4 12 12 10 12 12 12 15 0 0 0 0
0 0 5 1 0 1 1 1 4 4 12 12 12 15 15 15 0 15 15 0 0
0 5 4 4 1 4 1 4 4 4 6 12 12 12 15 12 15 7 7 15 0
5 4 4 4 4 4 4 4 4 6 6 6 12 12 12 12 12 12 12 12 15
0 5 4 4 5 4 5 4 4 4 6 12 12 12 3 12 3 12 12 15 0
0 0 5 5 0 5 5 5 4 4 4 12 12 3 3 3 0 3 15 0 0
0 0 0 0 5 4 4 4 9 4 4 12 3 12 12 12 3 0 0 0 0
0 0 0 0 5 5 4 4 9 9 4 3 6 12 12 3 3 0 0 0 0
0 0 0 9 4 4 5 4 9 4 4 12 6 12 6 12 7 3 0 0 0
0 0 0 9 4 4 9 9 0 9 4 6 0 6 6 12 12 3 0 0 0
0 0 9 4 9 9 0 0 9 4 4 12 6 0 0 3 3 12 3 0 0
0 0 0 9 0 0 0 0 9 4 4 12 6 0 0 0 0 3 0 0 0
0 0 0 0 0 0 0 0 0 6 4 6 0 0 0 0 0 0 0 0 0
0 0 0 0 0 0 0 0 0 0 6 0 0 0 0 0 0 0 0 0 0
