0 0 0 0 0 0 16 16 0 0 0 0 0 0 0 0 0 0 0 0 0 0 0 0 0
0 0 0 0 0 16 2 2 16 0 0 0 0 0 0 0 0 0 0 0 0 0 0 0 0
16 16 0 0 16 2 2 2 2 16 0 0 0 0 0 0 0 0 0 0 0 0 0 0 0
16 2 16 16 16 2 16 16 2 2 16 0 0 0 0 0 0 0 0 0 0 0 0 0 0
0 16 2 2 2 16 0 16 2 2 16 0 0 0 0 0 0 0 0 0 0 0 0 0 0
0 16 16 16 16 0 0 16 2 2 2 16 0 0 0 0 0 0 0 0 0 0 0 0 0
0 0 16 0 16 0 0 0 16 2 2 16 0 0 0 0 0 0 0 0 0 0 0 0 0
0 0 0 0 0 0 0 0 16 2 2 16 0 0 0 0 0 0 0 0 0 0 0 0 0
0 0 0 0 0 0 0 0 16 9 15 15 16 0 0 0 0 0 0 0 0 0 0 0 0
0 0 0 0 0 0 0 0 0 16 9 15 16 0 0 0 0 0 0 0 0 0 0 0 0
0 0 0 0 0 0 0 0 0 16 9 16 2 16 0 16 16 0 0 0 0 0 0 0 0
0 0 0 0 0 0 0 0 0 16 9 15 15 16 16 9 15 16 16 16 0 0 0 0 0
0 0 0 0 0 0 0 0 0 0 16 9 15 15 16 9 2 2 14 14 16 16 0 0 0
0 0 0 0 0 0 0 0 0 0 16 9 15 16 2 16 9 15 2 2 15 14 16 0 0
0 0 0 0 0 0 0 0 0 0 0 16 9 15 15 16 9 15 15 15 2 2 15 16 0
0 0 0 0 0 0 0 0 0 0 0 16 9 15 15 16 9 15 15 14 15 15 16 0 0
0 0 0 0 0 0 0 0 0 0 0 16 9 15 16 2 16 9 15 15 15 14 16 0 0
0 0 0 0 0 0 0 0 0 0 0 0 16 9 15 15 16 16 9 15 15 14 15 16 0
0 0 0 0 0 0 0 0 0 0 0 0 16 9 15 15 15 16 9 15 15 14 15 16 0
0 0 0 0 0 0 0 0 0 0 0 0 0 16 9 15 15 16 9 15 15 14 15 9 16
0 0 0 0 0 0 0 0 0 0 0 0 0 16 9 15 15 15 15 15 15 14 15 9 16
0 0 0 0 0 0 0 0 0 0 0 0 0 16 9 9 15 15 15 15 14 15 15 9 16
0 0 0 0 0 0 0 0 0 0 0 0 0 0 16 9 15 15 15 15 15 15 9 16 0
0 0 0 0 0 0 0 0 0 0 0 0 0 0 16 9 9 9 15 15 9 9 9 16 0
0 0 0 0 0 0 0 0 0 0 0 0 0 0 0 16 9 9 9 9 9 9 16 0 0
0 0 0 0 0 0 0 0 0 0 0 0 0 0 0 0 16 16 16 16 16 16 0 0 0
---
0 0 0 0 0 0 2 2 0 0 0 0 0 0 0 0 0 0 0 0 0 0 0 0 0
0 0 0 0 0 2 15 15 2 0 0 0 0 0 0 0 0 0 0 0 0 0 0 0 0
2 2 0 0 2 15 15 15 15 2 0 0 0 0 0 0 0 0 0 0 0 0 0 0 0
2 15 2 2 2 15 2 2 15 15 2 0 0 0 0 0 0 0 0 0 0 0 0 0 0
0 2 15 15 15 2 0 2 15 15 2 0 0 0 0 0 0 0 0 0 0 0 0 0 0
0 2 2 2 2 0 0 2 15 15 15 2 0 0 0 0 0 0 0 0 0 0 0 0 0
0 0 2 0 2 0 0 0 2 15 15 2 0 0 0 0 0 0 0 0 0 0 0 0 0
0 0 0 0 0 0 0 0 2 15 15 2 0 0 0 0 0 0 0 0 0 0 0 0 0
0 0 0 0 0 0 0 0 16 15 16 16 9 0 0 0 0 0 0 0 0 0 0 0 0
0 0 0 0 0 0 0 0 0 16 15 16 9 0 0 0 0 0 0 0 0 0 0 0 0
0 0 0 0 0 0 0 0 0 16 15 9 16 9 0 9 9 0 0 0 0 0 0 0 0
0 0 0 0 0 0 0 0 0 16 15 16 16 9 9 14 14 9 9 9 0 0 0 0 0
0 0 0 0 0 0 0 0 0 0 16 15 16 16 9 14 16 16 15 15 9 9 0 0 0
0 0 0 0 0 0 0 0 0 0 16 15 16 9 16 9 14 16 16 16 16 15 9 0 0
0 0 0 0 0 0 0 0 0 0 0 16 15 16 16 9 14 16 16 16 16 16 16 9 0
0 0 0 0 0 0 0 0 0 0 0 16 15 16 16 9 14 16 16 15 16 16 9 0 0
0 0 0 0 0 0 0 0 0 0 0 16 15 16 9 16 9 14 16 16 16 15 9 0 0
0 0 0 0 0 0 0 0 0 0 0 0 16 15 16 16 9 9 14 16 16 15 16 9 0
0 0 0 0 0 0 0 0 0 0 0 0 16 15 16 16 16 9 14 16 16 15 16 9 0
0 0 0 0 0 0 0 0 0 0 0 0 0 16 15 16 16 9 14 16 16 15 16 15 9
0 0 0 0 0 0 0 0 0 0 0 0 0 16 15 16 16 16 16 16 16 15 16 15 9
0 0 0 0 0 0 0 0 0 0 0 0 0 16 15 15 16 16 16 16 15 16 16 15 9
0 0 0 0 0 0 0 0 0 0 0 0 0 0 16 15 16 16 16 16 16 16 15 9 0
0 0 0 0 0 0 0 0 0 0 0 0 0 0 16 15 15 15 16 16 15 15 15 9 0
0 0 0 0 0 0 0 0 0 0 0 0 0 0 0 16 15 15 15 15 15 15 9 0 0
0 0 0 0 0 0 0 0 0 0 0 0 0 0 0 0 16 9 9 9 9 9 0 0 0
