0 0 0 0 0 1 0 0 0 0 0 0 0 0 0 0 0 0 0 0
0 0 0 0 1 0 1 0 0 0 0 0 0 0 0 0 0 0 0 0
0 0 0 0 0 1 0 0 0 0 0 0 18 18 0 0 0 0 0 0
0 0 0 0 0 0 0 0 0 0 0 18 1 1 18 18 0 0 0 0
0 1 1 0 0 0 0 0 0 18 18 18 18 18 1 1 18 0 0 0
1 0 0 1 0 0 0 0 18 14 14 14 14 3 18 1 18 0 0 0
1 0 0 1 0 0 0 18 14 3 3 3 3 3 3 18 1 18 0 0
0 1 1 0 0 0 0 18 3 3 18 3 3 3 3 18 1 18 0 0
0 0 0 0 18 18 18 14 3 3 18 7 3 3 3 3 18 0 0 0
0 0 0 0 18 3 3 3 3 3 7 7 3 3 3 3 18 0 0 0
0 0 0 0 18 3 8 18 8 8 8 3 3 3 1 3 18 0 0 0
0 0 0 0 0 18 18 0 18 18 18 8 3 3 3 1 18 18 18 18
0 0 0 0 0 0 0 0 0 0 18 8 1 3 3 18 18 1 1 18
0 0 0 0 0 0 0 0 0 18 8 3 3 1 18 1 1 1 1 18
0 0 0 0 0 0 0 0 18 8 8 3 3 3 18 1 1 1 18 0
0 0 0 0 0 0 0 18 8 8 3 3 3 3 18 1 1 1 18 0
0 0 0 0 0 0 0 18 8 8 8 3 3 3 3 18 18 1 1 18
0 0 0 0 0 0 0 0 18 8 8 3 3 1 3 18 0 18 18 18
0 0 0 0 0 0 0 18 18 18 18 3 3 3 1 18 0 0 0 0
0 0 0 0 0 0 18 3 8 3 3 18 3 3 3 18 0 0 0 0
0 0 0 0 0 18 3 8 18 8 8 18 3 1 3 18 0 0 0 0
0 0 0 0 0 18 3 8 18 18 18 8 3 3 1 18 0 0 0 0
0 0 0 0 0 0 18 3 8 8 8 1 3 3 18 0 0 0 0 0
0 0 0 0 0 0 0 18 3 3 3 3 1 18 0 0 0 0 0 0
0 0 0 0 0 0 0 0 18 18 18 18 18 0 0 0 0 0 0 0
---
0 0 0 0 0 8 0 0 0 0 0 0 0 0 0 0 0 0 0 0
0 0 0 0 8 0 8 0 0 0 0 0 0 0 0 0 0 0 0 0
0 0 0 0 0 8 0 0 0 0 0 0 1 1 0 0 0 0 0 0
0 0 0 0 0 0 0 0 0 0 0 1 18 18 1 1 0 0 0 0
0 8 8 0 0 0 0 0 0 1 1 1 1 1 18 18 1 0 0 0
8 0 0 8 0 0 0 0 7 18 18 18 18 18 1 18 1 0 0 0
8 0 0 8 0 0 0 7 18 18 18 18 18 18 18 1 18 1 0 0
0 8 8 0 0 0 0 7 18 18 8 18 18 18 18 1 18 1 0 0
0 0 0 0 14 14 14 8 18 18 8 3 18 18 18 18 1 0 0 0
0 0 0 0 14 18 18 18 18 18 3 3 18 18 18 18 1 0 0 0
0 0 0 0 14 18 3 3 3 3 3 18 18 18 8 18 1 0 0 0
0 0 0 0 0 14 3 0 3 3 3 3 18 18 18 8 1 1 1 1
0 0 0 0 0 0 0 0 0 0 3 3 8 18 18 1 1 3 3 1
0 0 0 0 0 0 0 0 0 3 3 18 18 8 3 3 3 3 3 1
0 0 0 0 0 0 0 0 3 3 3 18 18 18 3 3 3 3 1 0
0 0 0 0 0 0 0 3 3 3 18 18 18 18 3 3 3 3 1 0
0 0 0 0 0 0 0 3 3 3 3 18 18 18 18 1 1 3 3 1
0 0 0 0 0 0 0 0 3 3 3 18 18 8 18 1 0 1 1 1
0 0 0 0 0 0 0 3 3 3 3 18 18 18 8 1 0 0 0 0
0 0 0 0 0 0 3 18 3 18 18 3 18 18 18 1 0 0 0 0
0 0 0 0 0 3 18 3 3 3 3 3 18 8 18 1 0 0 0 0
0 0 0 0 0 3 18 3 3 3 3 3 18 18 8 1 0 0 0 0
0 0 0 0 0 0 3 18 3 3 3 8 18 18 1 0 0 0 0 0
0 0 0 0 0 0 0 3 18 18 18 18 8 1 0 0 0 0 0 0
0 0 0 0 0 0 0 0 3 3 3 3 3 0 0 0 0 0 0 0
