0 0 16 16 16 16 0 0 0 0 0 16 16 16 16 0 0
0 16 15 15 15 15 16 16 16 16 16 15 15 15 15 16 0
16 15 15 9 9 9 15 15 15 15 15 9 9 9 15 15 16
16 15 14 14 9 15 15 15 15 15 15 15 9 14 14 15 16
16 15 14 14 15 15 15 15 15 15 15 15 15 14 14 15 16
16 15 14 14 9 15 15 15 15 15 15 15 9 14 14 15 16
0 16 15 9 15 15 15 15 15 15 15 15 15 9 15 16 0
0 0 16 15 15 12 15 15 12 15 15 12 15 15 16 0 0
0 0 0 16 15 15 15 12 7 12 15 15 15 16 0 0 0
16 16 16 16 9 15 15 15 12 15 15 15 9 16 16 16 16
16 14 14 14 12 9 15 15 15 15 15 9 12 14 14 14 16
0 16 14 14 14 12 12 9 9 9 12 12 14 14 14 16 0
16 14 14 14 14 14 12 15 15 15 12 14 14 14 14 14 16
16 16 14 14 14 12 12 15 15 15 12 12 14 14 14 16 16
0 0 16 16 16 16 12 15 15 15 12 16 16 16 16 0 0
0 0 0 0 0 16 12 15 12 15 12 16 0 0 0 0 0
0 0 0 0 16 9 12 9 12 9 12 9 16 0 0 0 0
0 0 0 0 16 16 16 16 16 16 16 16 16 0 0 0 0
---
0 0 15 15 15 15 0 0 0 0 0 15 15 15 15 0 0
0 15 16 16 16 16 15 15 15 15 15 16 16 16 16 15 0
15 16 16 12 9 9 16 16 16 16 16 12 12 12 16 16 15
15 16 12 12 12 16 16 16 16 16 16 16 12 9 9 16 15
15 16 12 12 16 16 16 16 16 16 16 16 16 9 9 16 15
15 16 12 12 15 16 16 16 16 16 16 16 15 9 9 16 15
0 15 16 15 16 16 16 16 16 16 16 16 16 15 16 15 0
0 0 15 16 16 9 16 16 9 16 16 9 16 16 15 0 0
0 0 0 15 16 16 16 9 7 9 14 14 14 15 0 0 0
15 15 15 15 14 14 14 14 9 14 14 14 14 15 15 15 15
15 12 12 12 9 14 14 14 14 14 14 14 14 15 15 15 15
0 15 12 12 12 9 9 15 15 15 14 14 15 15 15 15 0
15 12 12 12 12 12 9 14 14 14 14 15 15 15 15 15 15
15 15 12 12 12 9 9 14 14 14 14 14 15 15 15 15 15
0 0 15 15 15 15 9 14 14 14 14 15 15 15 15 0 0
0 0 0 0 0 15 9 14 15 14 14 15 0 0 0 0 0
0 0 0 0 15 15 9 14 15 14 14 15 15 0 0 0 0
0 0 0 0 15 15 15 15 15 15 15 15 15 0 0 0 0
