0 0 0 0 0 0 0 0 4 0 0 0 0 0 0 0 0
0 0 0 0 0 0 0 4 4 4 0 0 0 0 0 0 0
0 0 0 0 0 0 0 4 1 4 0 0 0 0 0 0 0
0 0 0 0 0 0 4 1 1 4 4 0 0 0 0 0 0
0 0 0 0 0 0 4 1 1 4 4 0 0 0 0 0 0
0 0 0 0 0 4 4 1 1 4 4 4 0 0 0 0 0
0 0 0 0 0 4 1 1 1 1 4 4 0 0 0 0 0
0 0 0 4 4 15 1 15 1 15 4 9 4 4 0 0 0
4 4 4 1 1 1 1 1 1 1 1 1 1 4 4 4 4
4 4 4 4 4 4 4 4 4 4 4 4 4 4 4 4 4
0 0 4 4 4 4 4 4 4 4 4 4 4 4 4 0 0
0 4 3 3 3 3 3 3 3 3 3 3 3 3 3 4 0
0 4 3 14 7 4 14 14 14 14 7 4 14 3 3 4 0
0 4 14 14 4 4 14 14 14 14 4 4 14 14 3 4 0
0 4 14 14 4 4 14 14 14 14 4 4 14 14 3 4 0
0 4 14 14 14 14 14 14 14 14 14 14 14 14 3 4 0
4 14 14 14 14 14 14 4 4 14 14 14 14 14 14 3 4
4 3 14 14 14 14 14 14 14 14 14 14 14 3 3 3 4
0 4 4 3 14 14 14 14 14 14 14 14 3 3 4 4 0
0 0 0 4 14 14 14 14 14 14 14 3 3 4 0 0 0
0 0 0 4 3 3 14 14 14 3 3 3 3 4 0 0 0
0 0 0 0 4 4 3 3 3 3 3 4 4 0 0 0 0
0 0 0 0 0 0 4 4 4 4 4 0 0 0 0 0 0
---
0 0 0 0 0 0 0 0 3 0 0 0 0 0 0 0 0
0 0 0 0 0 0 0 3 3 3 0 0 0 0 0 0 0
0 0 0 0 0 0 0 3 4 3 0 0 0 0 0 0 0
0 0 0 0 0 0 3 4 4 3 3 0 0 0 0 0 0
0 0 0 0 0 0 3 4 4 3 3 0 0 0 0 0 0
0 0 0 0 0 3 3 4 4 3 3 3 0 0 0 0 0
0 0 0 0 0 3 4 4 4 4 3 3 0 0 0 0 0
0 0 0 3 3 4 4 4 4 4 3 4 3 3 0 0 0
3 3 3 4 4 4 4 4 4 4 4 4 4 3 3 3 3
3 3 3 1 1 1 1 1 1 15 15 15 3 3 3 3 3
0 0 1 1 1 1 1 1 1 1 1 1 1 1 1 0 0
0 1 14 14 14 14 14 14 14 14 14 14 14 14 14 1 0
0 1 14 4 4 14 4 4 4 4 4 14 4 14 14 1 0
0 14 4 4 14 14 4 4 4 4 14 14 4 4 14 14 0
0 14 4 4 14 14 4 4 4 4 14 14 4 4 14 14 0
0 14 4 4 4 4 4 4 4 4 4 4 4 4 14 14 0
14 4 4 4 4 4 4 7 7 4 4 4 4 4 4 14 14
14 4 4 4 4 4 4 4 4 4 4 4 4 14 14 14 14
0 14 14 9 4 4 4 4 4 4 4 4 14 14 14 14 0
0 0 0 14 4 4 4 4 4 4 4 14 14 14 0 0 0
0 0 0 14 14 14 4 4 4 14 14 14 14 14 0 0 0
0 0 0 0 14 14 14 14 14 14 14 14 14 0 0 0 0
0 0 0 0 0 0 14 14 14 14 14 0 0 0 0 0 0
