0 0 0 0 0 0 0 0 0 0 0 0 0 0 0 0 0 0 0 0 0
0 0 0 0 0 0 0 0 0 0 0 0 0 0 0 0 0 0 0 0 0
0 0 0 0 0 0 16 16 16 0 0 0 16 16 16 0 0 0 0 0 0
0 0 0 0 0 16 14 13 13 16 0 16 13 13 14 16 0 0 0 0 0
0 0 0 0 0 16 13 13 13 13 16 13 13 13 13 16 0 0 0 0 0
0 0 0 0 16 16 13 13 13 16 16 16 13 13 13 16 16 0 0 0 0
0 16 16 16 5 5 16 16 16 13 16 13 16 16 16 5 5 16 16 16 0
16 1 1 16 5 16 13 13 13 13 16 13 13 13 13 16 5 16 1 1 16
16 1 14 16 5 16 13 13 13 16 0 16 13 13 13 16 5 16 14 1 16
0 16 16 5 5 5 16 16 16 0 0 0 16 16 16 5 5 5 16 16 0
0 16 5 5 17 5 16 0 0 0 0 0 0 0 16 5 17 5 5 16 0
0 16 5 17 15 17 16 0 0 0 0 0 0 0 16 17 15 17 5 16 0
0 16 5 5 17 5 16 0 0 0 0 0 0 0 16 5 17 5 5 16 0
0 16 16 5 5 5 16 0 0 0 0 0 0 0 16 5 5 5 16 16 0
16 13 13 16 5 5 5 16 0 0 0 0 0 16 5 5 5 16 13 13 16
16 13 14 16 5 5 5 5 16 16 16 16 16 5 5 5 5 16 14 13 16
0 16 16 16 5 5 5 5 5 5 5 5 5 5 5 5 5 16 16 16 0
0 0 0 0 16 16 5 5 5 16 16 5 5 5 5 16 16 0 0 0 0
0 0 0 0 0 0 16 16 16 1 1 16 5 16 16 0 0 0 0 0 0
0 0 0 0 0 0 0 0 16 1 14 16 16 0 0 0 0 0 0 0 0
0 0 0 0 0 0 0 0 0 16 16 0 0 0 0 0 0 0 0 0 0
---
0 0 0 0 0 0 0 0 0 0 0 0 0 0 0 0 0 0 0 0 0
0 0 0 0 0 0 0 0 0 0 0 0 0 0 0 0 0 0 0 0 0
0 0 0 0 0 0 5 5 5 0 0 0 5 5 5 0 0 0 0 0 0
0 0 0 0 0 5 17 16 16 5 0 5 16 16 16 5 0 0 0 0 0
0 0 0 0 0 5 16 16 16 16 5 16 16 16 16 5 0 0 0 0 0
0 0 0 0 5 5 16 16 16 5 5 5 16 16 16 5 5 0 0 0 0
0 5 5 5 16 16 5 5 5 16 5 16 5 5 5 16 16 5 5 5 0
5 17 17 5 16 5 16 16 16 16 5 16 16 16 16 5 16 5 17 17 5
5 17 15 5 16 5 16 16 16 5 0 5 16 16 16 5 16 5 14 17 5
0 5 5 16 16 16 5 5 5 0 0 0 5 5 5 16 16 16 5 5 0
0 5 16 16 16 16 5 0 0 0 0 0 0 0 5 16 16 16 16 5 0
0 5 16 16 16 16 5 0 0 0 0 0 0 0 5 16 17 16 16 5 0
0 5 16 16 16 16 5 0 0 0 0 0 0 0 5 16 16 16 16 13 0
0 13 13 16 16 16 1 0 0 0 0 0 0 0 1 16 16 16 13 13 0
13 14 14 13 16 16 16 1 0 0 0 0 0 1 16 16 16 13 14 14 13
13 14 16 13 16 16 16 16 1 1 1 1 1 16 16 16 16 13 15 14 13
0 13 13 13 16 16 16 16 16 16 16 16 16 16 16 16 16 13 13 13 0
0 0 0 0 13 13 16 16 16 13 13 16 16 16 16 13 13 0 0 0 0
0 0 0 0 0 0 13 13 13 13 13 13 16 13 13 0 0 0 0 0 0
0 0 0 0 0 0 0 0 13 13 13 13 13 0 0 0 0 0 0 0 0
0 0 0 0 0 0 0 0 0 13 13 0 0 0 0 0 0 0 0 0 0
