0 0 0 0 0 18 18 0 0 18 18 18 0 0 0 0 0 0
0 0 0 0 18 1 1 18 18 3 3 3 18 0 0 0 0 0
0 0 0 0 18 1 4 3 3 3 3 3 1 18 0 0 0 0
0 0 0 18 1 1 3 3 3 3 3 3 3 1 18 0 0 0
0 0 0 18 3 3 3 3 3 3 18 18 3 1 18 18 0 0
0 18 18 1 3 3 3 3 3 18 3 3 18 1 18 13 18 0
18 3 3 3 3 3 3 3 3 3 3 3 3 1 18 13 18 0
18 3 3 4 3 3 3 3 4 4 3 3 3 1 18 18 0 0
18 3 3 3 3 3 4 4 14 3 3 3 1 18 3 3 18 0
0 18 3 3 3 4 3 3 3 3 3 3 18 3 3 3 18 0
0 0 18 18 18 1 1 1 1 1 3 3 3 3 3 18 0 0
0 0 18 1 1 18 1 15 15 15 15 15 3 3 18 13 18 0
0 0 0 18 1 18 15 15 15 15 15 3 3 1 18 13 18 0
0 0 0 0 18 9 15 15 15 15 3 3 3 3 3 18 0 0
0 0 18 18 18 1 15 3 3 3 3 4 3 3 3 1 18 0
0 18 1 1 18 1 1 3 3 3 3 4 3 3 3 3 3 18
0 18 1 1 1 4 1 1 1 1 1 1 4 3 3 3 3 18
0 0 18 1 1 18 18 1 1 1 1 18 18 1 1 3 3 18
0 0 0 18 18 0 0 18 18 18 18 0 0 0 0 18 18 0
---
0 0 0 0 0 3 3 0 0 3 3 3 0 0 0 0 0 0
0 0 0 0 3 15 15 3 3 18 18 18 3 0 0 0 0 0
0 0 0 0 3 15 3 18 18 18 18 18 4 3 0 0 0 0
0 0 0 3 15 15 18 18 18 18 18 18 18 4 3 0 0 0
0 0 0 3 18 18 18 18 18 18 1 1 18 4 3 3 0 0
0 3 3 15 18 18 18 18 18 1 18 18 1 4 3 3 3 0
3 18 18 18 18 18 18 18 18 18 18 18 18 4 3 3 3 0
3 18 18 3 18 18 18 18 1 1 18 18 18 4 3 3 0 0
3 18 18 18 18 18 1 1 13 18 18 18 4 3 1 1 3 0
0 3 18 18 18 1 18 18 18 18 18 18 3 18 18 1 3 0
0 0 3 3 3 15 15 15 15 15 18 18 18 18 1 3 0 0
0 0 3 15 15 3 15 3 3 3 3 3 1 1 3 1 3 0
0 0 0 3 15 3 3 3 3 3 3 1 1 4 3 1 3 0
0 0 0 0 3 14 3 3 3 3 1 1 1 1 1 3 0 0
0 0 3 3 3 3 3 1 1 1 1 13 1 1 1 4 3 0
0 3 3 3 3 3 3 1 1 1 1 13 1 1 1 1 1 3
0 3 3 3 3 9 3 3 3 3 3 3 13 1 1 1 1 3
0 0 3 3 3 3 3 3 3 3 3 3 3 4 4 1 1 3
0 0 0 3 3 0 0 3 3 3 3 0 0 0 0 3 3 0
