0 0 0 0 0 0 0 0 0 0 0 0 0 0 0 0 0 0 0 0 0 0 0 0 16 16 0
0 0 0 0 0 0 0 0 0 0 0 0 0 0 0 0 0 0 0 0 0 0 0 16 9 9 16
0 0 0 0 0 0 0 0 0 0 0 0 0 0 0 0 0 0 0 0 0 0 16 19 19 9 16
0 16 16 0 0 0 0 0 0 0 0 0 0 0 0 0 0 0 0 0 0 16 19 19 9 16 0
16 9 19 16 0 0 0 0 0 0 0 0 0 0 0 0 0 0 0 0 16 19 19 9 16 0 0
16 9 19 19 16 0 0 0 0 0 0 0 0 0 0 0 0 0 0 16 19 19 9 16 0 0 0
0 16 9 19 19 16 0 0 0 0 0 0 0 0 0 0 0 16 16 9 9 9 16 0 0 0 0
0 0 16 9 19 19 16 0 16 16 16 16 16 16 16 16 16 10 10 10 12 16 0 0 0 0 0
0 0 0 16 9 19 19 16 8 8 8 8 8 8 8 8 16 10 10 10 12 16 0 0 0 0 0
0 0 0 0 16 9 19 9 16 16 16 8 8 8 8 8 16 12 12 12 12 16 16 0 0 0 0
0 0 16 16 8 16 9 12 10 10 10 16 14 14 14 14 14 16 16 16 16 8 8 16 0 0 0
0 16 16 8 8 8 16 12 10 10 10 16 14 14 14 14 14 14 8 8 8 8 8 8 16 0 0
0 16 16 8 8 8 16 12 12 12 10 16 14 14 14 14 14 14 14 14 8 8 8 8 16 16 0
0 16 16 8 8 8 16 12 12 12 16 14 14 14 14 14 14 14 14 8 8 8 8 8 16 16 0
0 16 9 16 8 8 8 16 16 16 14 14 14 14 14 14 14 8 8 8 8 8 8 16 16 16 0
0 16 9 9 16 16 8 8 8 8 8 8 8 8 8 8 8 8 8 8 8 16 16 9 9 16 0
0 16 9 9 19 19 16 16 8 8 8 8 8 8 8 8 8 8 8 16 16 19 19 9 9 16 0
0 0 16 16 9 19 19 9 16 16 16 16 16 16 16 16 16 16 16 9 19 19 9 16 16 0 0
0 0 16 2 16 16 16 9 19 19 19 19 19 19 19 19 19 19 19 9 16 16 16 2 16 0 0
0 0 16 2 2 9 16 16 19 19 19 19 19 19 19 19 19 19 19 16 16 9 2 2 16 0 0
0 0 16 2 9 9 16 2 16 16 16 16 16 16 16 16 16 16 16 2 16 9 9 2 16 0 0
0 0 16 2 2 9 16 2 9 9 9 9 9 9 9 9 9 9 9 2 16 9 2 2 16 0 0
0 16 16 2 9 9 16 2 2 9 9 9 9 9 9 9 9 9 2 2 16 9 9 2 16 16 0
0 16 9 16 2 9 16 2 9 9 9 9 9 9 9 9 9 9 9 2 16 9 2 16 9 16 0
0 16 9 9 16 16 16 2 2 9 9 9 9 9 9 9 9 9 2 2 16 16 16 9 9 16 0
0 0 16 9 19 19 16 16 9 9 9 9 9 9 9 9 9 9 9 16 16 19 19 9 16 0 0
0 0 0 16 16 19 19 9 16 16 16 16 16 16 16 16 16 16 16 9 19 19 16 16 0 0 0
0 0 0 0 0 16 16 9 19 19 19 19 19 19 19 19 19 19 19 9 16 16 0 0 0 0 0
0 0 0 0 0 0 0 16 16 16 16 16 16 16 16 16 16 16 16 16 0 0 0 0 0 0 0
---
0 0 0 0 0 0 0 0 0 0 0 0 0 0 0 0 0 0 0 0 0 0 0 0 19 19 0
0 0 0 0 0 0 0 0 0 0 0 0 0 0 0 0 0 0 0 0 0 0 0 19 8 8 19
0 0 0 0 0 0 0 0 0 0 0 0 0 0 0 0 0 0 0 0 0 0 19 8 8 8 19
0 19 19 0 0 0 0 0 0 0 0 0 0 0 0 0 0 0 0 0 0 19 8 8 8 19 0
19 8 8 19 0 0 0 0 0 0 0 0 0 0 0 0 0 0 0 0 19 8 8 8 19 0 0
19 8 8 8 19 0 0 0 0 0 0 0 0 0 0 0 0 0 0 19 8 8 8 19 0 0 0
0 19 8 8 8 19 0 0 0 0 0 0 0 0 0 0 0 19 19 8 8 8 19 0 0 0 0
0 0 19 8 8 8 19 0 19 19 19 19 19 19 19 19 19 16 16 16 16 19 0 0 0 0 0
0 0 0 19 8 8 8 19 9 9 9 9 9 9 9 9 19 16 16 16 16 19 0 0 0 0 0
0 0 0 0 19 8 8 8 19 19 19 9 9 9 9 9 19 16 16 16 16 19 19 0 0 0 0
0 0 2 2 9 19 8 16 16 16 16 19 9 9 9 9 9 19 19 19 19 9 9 19 0 0 0
0 2 2 9 9 9 19 16 16 16 16 19 9 9 9 9 9 9 9 9 9 9 9 9 19 0 0
0 2 2 9 9 9 19 16 16 16 16 19 9 9 9 9 9 9 9 9 9 9 9 9 19 19 0
0 2 2 9 9 9 19 16 16 16 19 9 9 9 9 9 9 9 9 9 9 9 9 9 19 19 0
0 2 16 2 9 9 9 19 19 19 9 9 9 9 9 9 9 9 9 9 9 9 9 12 12 12 0
0 2 16 16 2 2 9 9 9 9 9 9 9 9 9 9 9 9 9 9 9 2 12 16 16 12 0
0 2 16 16 16 16 2 2 9 9 9 9 9 9 9 9 9 9 9 2 2 16 16 16 16 12 0
0 0 14 14 16 16 16 16 2 2 2 2 2 2 2 2 2 2 2 16 16 16 16 12 12 0 0
0 0 14 16 14 14 14 16 16 16 16 16 16 16 16 16 16 16 16 16 14 12 12 16 12 0 0
0 0 14 16 16 16 14 14 16 16 16 16 16 16 16 16 16 16 16 14 14 16 16 16 12 0 0
0 0 14 16 16 16 14 16 14 14 14 14 14 14 14 14 14 14 14 16 14 16 16 16 12 0 0
0 0 14 16 16 16 14 16 16 16 16 16 16 16 16 16 16 16 16 16 14 16 16 16 12 0 0
0 8 8 16 16 16 14 16 16 16 16 16 16 16 16 16 16 16 16 16 14 16 16 16 8 8 0
0 8 16 8 16 16 14 16 16 16 16 16 16 16 16 16 16 16 16 16 14 16 16 8 16 8 0
0 8 16 16 8 8 14 16 16 16 16 16 16 16 16 16 16 16 16 16 8 8 8 16 16 8 0
0 0 8 16 16 16 8 8 16 16 16 16 16 16 16 16 16 16 16 8 8 16 16 16 8 0 0
0 0 0 8 8 16 16 16 8 8 8 8 8 8 8 8 8 8 8 16 16 16 8 8 0 0 0
0 0 0 0 0 8 8 16 16 16 16 16 16 16 16 16 16 16 16 16 8 8 0 0 0 0 0
0 0 0 0 0 0 0 10 10 10 10 10 10 10 10 10 10 10 10 10 0 0 0 0 0 0 0
