0 0 0 0 18 18 18 18 0 0 0 0
0 0 18 18 9 9 9 9 18 18 0 0
0 18 9 14 14 9 9 9 9 9 18 0
18 9 14 14 14 14 15 15 9 9 9 18
18 9 14 14 14 14 15 15 15 9 9 18
18 9 15 14 14 15 15 15 15 15 9 18
18 9 15 15 15 15 15 15 15 15 9 18
0 18 9 15 19 19 19 19 15 9 18 0
0 0 18 9 15 19 19 15 9 18 0 0
0 0 0 18 1 1 1 1 18 0 0 0
0 0 0 18 1 1 1 1 18 0 0 0
0 0 0 0 18 1 1 18 0 0 0 0
0 0 0 0 0 18 18 0 0 0 0 0
---
0 0 0 0 9 9 9 9 0 0 0 0
0 0 9 9 1 1 1 1 9 9 0 0
0 9 18 9 9 1 1 1 1 1 15 0
9 18 9 9 9 9 18 18 1 15 15 15
9 18 9 9 9 9 18 18 18 15 15 15
9 18 18 9 9 18 18 18 18 18 15 15
9 18 18 18 18 18 18 18 18 18 15 15
0 15 18 18 14 14 14 14 18 19 15 0
0 0 15 18 18 14 14 18 19 15 0 0
0 0 0 15 14 14 19 19 15 0 0 0
0 0 0 15 14 14 19 19 15 0 0 0
0 0 0 0 15 14 14 15 0 0 0 0
0 0 0 0 0 15 15 0 0 0 0 0
