0 0 0 0 0 16 16 16 16 16 16 16 16 0 0 0 0 0
0 0 0 0 16 9 9 9 9 9 9 9 9 16 0 0 0 0
0 0 0 16 9 2 2 2 2 2 2 2 2 9 16 0 0 0
0 16 16 9 2 16 16 16 16 16 16 16 16 2 9 16 16 0
16 9 9 2 16 2 2 2 2 2 2 2 2 16 2 9 9 16
16 16 2 16 2 9 9 16 16 16 16 9 9 2 16 2 16 16
0 16 16 2 9 9 16 8 8 8 8 16 9 9 2 16 16 0
0 0 16 2 9 16 8 8 16 8 8 8 16 9 2 16 0 0
0 0 16 2 9 16 8 8 16 8 8 8 16 9 2 16 0 0
0 0 16 2 9 16 8 8 16 16 16 8 16 9 2 16 0 0
0 0 16 2 9 16 8 8 8 8 8 8 16 9 2 16 0 0
0 0 16 2 9 9 16 8 8 8 8 16 9 9 2 16 0 0
0 16 19 19 19 19 9 16 16 16 16 9 19 19 19 19 16 0
0 16 9 9 2 9 9 9 9 9 9 9 9 2 2 9 16 0
0 0 16 9 2 9 2 2 2 2 2 9 9 2 2 16 0 0
0 0 16 9 2 2 2 16 16 16 16 2 2 2 2 16 0 0
0 0 16 2 2 16 16 0 0 16 0 16 16 2 2 16 0 0
0 0 0 16 16 0 0 0 0 16 0 0 0 16 16 0 0 0
0 0 0 0 0 0 0 0 16 19 16 0 0 0 0 0 0 0
0 0 0 0 0 0 0 16 19 19 16 16 0 0 0 0 0 0
0 0 0 0 0 0 0 0 16 16 16 0 0 0 0 0 0 0
---
0 0 0 0 0 8 8 8 8 8 8 8 8 0 0 0 0 0
0 0 0 0 8 16 16 16 16 16 16 16 16 8 0 0 0 0
0 0 0 8 16 16 16 16 16 16 16 16 16 16 8 0 0 0
0 8 8 16 16 2 2 2 2 2 2 2 2 16 16 8 8 0
8 16 16 16 2 16 16 16 16 16 16 16 16 8 16 16 16 8
8 8 16 2 16 16 16 9 9 9 9 16 16 16 8 16 8 8
0 8 2 16 16 16 9 9 9 9 9 9 16 16 16 8 8 0
0 0 2 16 16 9 9 9 19 9 9 9 9 16 16 2 0 0
0 0 2 16 16 9 9 9 19 9 9 9 9 16 16 2 0 0
0 0 2 16 16 9 9 9 19 19 19 9 9 16 16 2 0 0
0 0 2 16 16 9 9 9 9 9 9 9 9 16 16 2 0 0
0 0 2 16 16 16 9 9 9 9 9 9 16 16 16 2 0 0
0 2 16 16 16 16 16 9 9 9 9 16 16 16 16 16 2 0
0 2 16 16 9 16 16 16 16 16 16 16 16 16 16 16 2 0
0 0 2 16 9 16 19 19 19 19 19 16 16 16 16 2 0 0
0 0 2 16 9 9 9 2 2 2 2 19 2 2 2 2 0 0
0 0 2 9 9 2 2 0 0 2 0 2 2 2 2 2 0 0
0 0 0 2 2 0 0 0 0 2 0 0 0 2 2 0 0 0
0 0 0 0 0 0 0 0 2 16 2 0 0 0 0 0 0 0
0 0 0 0 0 0 0 2 16 16 2 2 0 0 0 0 0 0
0 0 0 0 0 0 0 0 2 2 2 0 0 0 0 0 0 0
