15 15 15 15 15 15 9 9 9 9 9 9 15 15 15 15 15 15 9 9 9 9 9 9
15 15 15 15 15 15 9 9 9 9 9 18 18 18 18 18 18 15 9 9 9 9 9 9
15 15 15 15 15 15 9 9 9 18 18 1 1 14 14 14 14 18 9 9 9 9 9 9
15 15 15 15 15 15 9 9 18 1 1 1 14 14 18 14 18 14 18 9 9 9 9 9
15 15 15 15 15 15 9 18 3 1 1 14 14 14 14 14 14 14 18 9 9 9 9 9
15 15 15 15 15 15 18 3 1 1 14 18 14 14 14 14 14 14 14 18 9 9 9 9
9 9 9 9 9 9 18 3 1 1 14 18 14 14 18 18 18 14 14 18 15 15 15 15
9 9 9 18 18 18 3 1 1 14 14 14 14 18 14 14 14 18 14 14 18 15 15 15
9 9 18 3 3 1 1 1 14 14 14 14 18 14 14 16 16 14 18 14 18 15 15 15
9 9 18 1 1 1 1 1 14 14 14 14 18 14 16 16 16 16 18 14 18 15 15 15
9 9 9 18 1 1 1 1 18 14 14 14 18 13 13 16 16 16 18 14 14 18 15 15
9 9 9 18 1 1 1 1 1 18 14 14 18 18 13 13 13 18 18 14 14 18 15 15
15 15 15 15 18 1 1 1 1 1 18 14 14 18 18 18 18 18 14 3 14 14 18 9
15 18 18 18 3 1 1 1 1 1 18 14 14 14 14 14 14 14 14 3 3 14 18 9
18 3 3 3 1 1 1 18 1 1 18 14 14 14 14 14 14 14 14 3 18 3 18 9
18 1 1 1 1 1 1 1 18 18 14 14 14 14 14 14 14 14 14 3 18 18 9 9
15 18 18 1 1 1 1 1 14 14 14 14 14 14 14 14 14 14 14 3 18 9 9 9
15 15 15 18 1 1 1 1 14 14 14 14 14 14 14 14 14 14 14 3 18 9 9 9
9 9 18 1 1 1 1 14 14 14 14 14 14 14 14 14 14 14 3 18 15 15 15 15
9 9 18 1 1 18 1 1 14 14 14 14 3 3 3 3 3 3 3 18 15 15 15 15
9 9 9 18 18 9 18 18 14 14 14 18 18 18 18 18 18 3 18 18 15 15 15 15
9 9 9 9 9 9 15 18 14 14 18 15 9 9 9 18 3 3 18 15 15 15 15 15
9 9 9 9 9 9 15 15 18 18 15 15 9 9 9 9 18 18 15 15 15 15 15 15
9 9 9 9 9 9 15 15 15 15 15 15 9 9 9 9 9 9 15 15 15 15 15 15
---
1 1 1 1 1 1 3 3 3 3 3 3 14 14 14 14 14 14 15 15 15 15 15 15
1 1 1 1 1 1 3 3 3 3 3 14 14 14 14 14 14 14 15 15 15 15 15 15
1 1 1 1 1 1 3 3 3 14 14 18 18 9 15 15 15 14 15 15 15 15 15 15
1 1 1 1 1 1 3 3 14 18 18 18 9 9 15 15 14 15 14 15 15 15 15 15
1 1 1 1 1 1 3 14 16 18 18 9 9 9 15 15 15 15 14 15 15 15 15 15
1 1 1 1 1 1 14 16 18 18 9 13 9 9 9 15 15 15 15 14 15 15 15 15
1 1 1 1 1 1 14 16 18 18 9 16 9 9 15 15 15 15 15 14 14 14 14 14
1 1 1 14 14 14 16 18 18 9 9 9 9 15 9 9 9 15 9 9 14 14 14 14
1 1 14 18 18 18 18 18 9 9 9 9 15 9 9 1 1 9 15 9 14 14 14 14
1 1 14 18 18 18 18 18 9 9 9 9 15 9 1 1 1 1 15 9 14 14 14 14
1 1 1 14 18 18 18 18 14 9 9 9 15 15 15 1 1 1 15 9 9 14 14 14
1 1 1 14 18 18 18 18 18 14 9 9 15 15 15 15 15 15 15 9 9 14 14 14
1 1 1 1 14 18 18 18 18 18 14 9 9 15 15 15 15 15 9 18 9 9 14 15
1 14 14 14 16 18 18 18 18 18 14 9 9 9 9 9 9 9 9 18 18 9 14 15
14 16 16 16 18 18 18 14 18 18 14 9 9 9 9 9 9 9 9 18 14 18 14 15
14 18 18 18 18 18 18 18 14 14 9 9 9 9 9 9 9 9 9 18 14 14 15 15
13 14 14 18 18 18 18 18 9 9 9 9 9 9 9 9 9 9 9 18 14 15 15 15
13 13 13 14 18 18 18 18 9 9 9 9 9 9 9 9 9 9 9 18 14 15 15 15
15 15 14 18 18 18 18 9 9 9 9 9 9 9 9 9 9 9 18 14 14 14 14 14
15 15 14 18 18 14 18 18 9 9 9 9 18 18 18 18 18 18 18 14 14 14 14 14
15 15 15 14 14 15 14 14 9 9 9 14 14 14 14 14 14 18 14 14 14 14 14 14
15 15 15 15 15 15 3 14 9 9 14 3 18 18 18 14 18 18 14 14 14 14 14 14
15 15 15 15 15 15 3 3 14 14 3 3 18 18 18 18 14 14 14 14 14 14 14 14
15 15 15 15 15 15 3 3 3 3 3 3 18 18 18 18 18 18 14 14 14 14 14 14
