18 18 18 18 18 18 18 18 18 18 18 18 18 18 18 18 18 18 18 18 18 18 18 18
18 13 13 13 13 13 13 13 13 13 13 13 13 18 5 5 5 5 5 5 5 5 5 18
18 13 13 13 13 13 13 13 13 13 13 13 13 18 5 5 5 5 5 5 5 5 5 18
18 13 13 13 13 13 13 13 13 13 18 18 18 5 5 5 5 5 5 5 5 5 5 18
18 13 13 13 13 13 13 13 13 18 5 5 5 5 5 5 5 5 5 5 5 5 5 18
18 13 13 13 13 13 13 13 13 18 5 5 5 5 5 5 5 5 5 5 5 5 5 18
18 13 13 13 13 13 13 13 13 18 5 5 5 5 5 5 5 5 5 5 5 5 5 18
18 13 13 13 13 13 13 13 13 18 5 5 18 5 5 5 5 5 5 5 5 5 5 18
18 13 13 13 13 13 13 13 13 13 18 18 13 18 5 5 5 5 5 5 5 5 5 18
18 13 13 13 13 13 13 13 13 13 13 13 13 18 5 5 5 5 5 5 5 5 5 18
18 13 13 13 13 13 13 13 13 13 13 13 13 18 18 18 18 5 5 5 18 18 18 18
18 13 13 13 13 13 13 13 13 13 13 13 13 18 1 1 18 5 5 5 18 1 1 18
18 18 18 18 18 13 13 13 13 18 18 18 18 18 1 18 5 5 5 5 5 18 1 18
18 15 15 15 18 13 13 13 18 15 15 18 1 1 1 18 5 5 5 5 5 18 1 18
18 15 15 18 13 13 13 13 18 15 15 18 1 1 1 1 18 18 18 18 18 1 1 18
18 15 15 18 13 13 13 13 18 15 15 18 1 1 1 1 1 1 1 1 1 1 1 18
18 15 15 15 18 18 18 18 15 15 15 18 18 18 1 1 1 1 1 1 1 1 1 18
18 15 15 15 15 15 15 15 15 15 15 15 15 15 18 1 1 1 1 1 1 1 1 18
18 15 15 15 15 15 15 15 15 15 15 15 15 15 15 18 1 1 1 1 1 1 1 18
18 15 15 15 15 15 15 15 15 18 18 18 15 15 15 18 1 1 1 1 1 1 1 18
18 15 15 15 15 15 15 15 15 18 1 1 18 18 18 1 1 1 1 1 1 1 1 18
18 15 15 15 15 15 15 15 15 18 1 1 1 1 1 1 1 1 1 1 1 1 1 18
18 15 15 15 15 15 15 15 15 18 1 1 1 1 1 1 1 1 1 1 1 1 1 18
18 18 18 18 18 18 18 18 18 18 18 18 18 18 18 18 18 18 18 18 18 18 18 18
---
1 1 1 1 1 1 1 1 1 1 1 1 1 5 5 5 5 5 5 5 5 5 5 5
1 18 18 18 18 18 18 18 18 18 18 18 18 5 13 13 13 13 13 13 13 13 13 5
1 18 18 18 18 18 18 18 18 18 18 18 18 5 13 13 13 13 13 13 13 13 13 5
1 18 18 18 18 18 18 18 18 18 5 5 5 13 13 13 13 13 13 13 13 13 13 5
1 18 18 18 18 18 18 18 18 5 13 13 13 13 13 13 13 13 13 13 13 13 13 5
1 18 18 18 18 18 18 18 18 5 13 13 13 13 13 13 13 13 13 13 13 13 13 5
1 18 18 18 18 18 18 18 18 5 13 13 13 13 13 13 13 13 13 13 13 13 13 5
1 18 18 18 18 18 18 18 18 5 13 13 5 13 13 13 13 13 13 13 13 13 13 5
1 18 18 18 18 18 18 18 18 18 5 5 18 5 13 13 13 13 13 13 13 13 13 5
1 18 18 18 18 18 18 18 18 18 18 18 18 5 13 13 13 13 13 13 13 13 13 5
1 18 18 18 18 18 18 18 18 18 18 18 18 5 5 5 5 13 13 13 5 5 5 5
1 18 18 18 18 18 18 18 18 18 18 18 18 5 13 13 5 13 13 13 5 15 15 5
1 1 1 1 1 18 18 18 18 5 5 5 5 5 13 5 13 13 13 13 13 5 15 5
1 18 18 18 1 18 18 18 5 1 1 5 13 13 13 5 13 13 13 13 13 5 15 5
1 18 18 1 18 18 18 18 5 1 1 5 13 13 13 13 5 5 5 5 5 15 15 5
1 18 18 1 18 18 18 18 5 1 1 5 13 13 13 15 15 15 15 15 15 15 15 5
1 18 18 18 1 5 5 5 1 1 1 5 5 5 15 15 15 15 15 15 15 15 15 5
1 18 18 18 18 1 1 1 1 1 1 1 1 1 5 15 15 15 15 15 15 15 15 5
1 18 18 18 18 1 1 1 1 1 1 1 1 1 1 5 15 15 15 15 15 15 15 5
1 18 18 18 18 1 1 1 1 5 5 5 1 1 1 5 15 15 15 15 15 15 15 5
1 18 18 18 18 1 1 1 1 5 15 15 5 5 5 15 15 15 15 15 15 15 15 5
1 18 18 18 18 18 1 1 1 5 15 15 15 15 15 15 15 15 15 15 15 15 15 5
1 18 18 18 18 18 1 1 1 5 15 15 15 15 15 15 15 15 15 15 15 15 15 5
1 1 1 1 1 1 5 5 5 5 5 5 5 5 5 5 5 5 5 5 5 5 5 5
