0 0 0 0 0 0 0 0 16 16 16 16 16 16 16 16 0 0 0 0 0 0 0 0
0 0 0 0 0 0 16 16 9 9 9 19 19 19 19 19 16 16 0 0 0 0 0 0
0 0 0 0 16 16 2 2 9 9 9 9 9 9 9 9 9 9 16 16 0 0 0 0
0 0 0 16 2 2 2 19 8 8 8 8 8 8 8 8 8 9 9 9 16 0 0 0
0 0 16 2 2 2 19 8 8 9 9 19 19 19 9 9 8 8 8 8 9 16 0 0
0 16 2 2 15 2 8 8 9 19 19 9 9 9 9 19 19 19 19 8 8 8 16 0
0 16 2 2 9 9 9 9 19 19 19 9 9 9 9 19 19 19 19 19 19 9 16 0
0 16 2 2 9 19 19 19 9 9 9 9 9 9 9 9 9 9 9 9 9 9 16 0
16 2 2 9 9 9 9 9 9 9 9 9 8 8 8 8 8 9 9 9 9 9 9 16
16 2 2 9 9 9 9 9 9 8 8 8 8 8 8 8 8 8 9 9 9 9 9 16
16 2 2 8 8 8 8 8 8 8 9 9 19 19 19 19 19 8 8 9 9 8 8 16
16 2 15 8 8 8 8 8 8 8 8 19 19 9 9 9 9 9 8 8 8 9 9 16
16 15 2 9 9 19 19 19 19 19 19 19 9 9 9 9 19 19 19 9 9 9 9 16
16 2 2 9 19 19 19 19 9 9 9 9 9 9 9 9 9 19 19 19 19 8 8 16
16 2 2 9 9 8 8 9 9 9 9 9 9 9 9 9 9 9 9 8 8 8 9 16
16 2 2 9 9 9 9 9 8 8 8 8 8 8 8 8 8 8 8 9 9 9 9 16
0 16 15 2 8 8 8 9 19 19 19 19 19 19 9 9 9 9 9 19 9 9 16 0
0 16 2 15 2 9 8 8 8 8 8 9 9 9 19 19 19 19 9 9 8 2 16 0
0 16 2 2 2 2 9 9 9 8 8 8 8 9 9 9 9 8 8 8 2 2 16 0
0 0 16 2 2 2 2 9 9 9 9 8 8 8 8 8 8 8 9 2 2 16 0 0
0 0 0 16 2 2 2 2 2 9 9 9 9 9 9 9 9 2 2 2 16 0 0 0
0 0 0 0 16 16 2 2 2 2 2 2 2 2 2 2 2 2 16 16 0 0 0 0
0 0 0 0 0 0 16 16 2 2 2 2 2 2 2 2 16 16 0 0 0 0 0 0
0 0 0 0 0 0 0 0 16 16 16 16 16 16 16 16 0 0 0 0 0 0 0 0
---
0 0 0 0 0 0 0 0 9 9 9 9 9 9 9 9 0 0 0 0 0 0 0 0
0 0 0 0 0 0 9 9 8 8 8 9 9 9 9 9 9 9 0 0 0 0 0 0
0 0 0 0 9 9 9 9 8 8 8 8 8 8 8 8 8 8 9 9 0 0 0 0
0 0 0 9 9 9 9 8 19 19 19 19 19 19 19 19 19 8 8 8 9 0 0 0
0 0 9 9 9 9 8 19 19 2 2 9 9 9 2 2 19 19 19 19 8 9 0 0
0 9 9 9 9 9 19 19 2 9 9 2 2 2 2 8 8 8 8 19 19 19 9 0
0 9 9 9 2 2 2 2 9 9 9 2 2 2 2 8 8 8 8 8 8 2 9 0
0 9 9 9 2 9 9 9 2 2 2 2 2 2 2 2 2 2 2 2 2 2 9 0
9 9 9 2 2 2 2 2 2 2 2 2 16 16 16 16 16 2 2 2 2 2 2 9
9 9 9 2 2 2 2 2 2 16 16 16 16 16 16 16 16 16 2 2 2 2 2 9
9 9 9 16 16 16 16 16 16 16 15 15 15 16 16 16 16 16 16 2 2 16 16 9
9 9 9 16 16 16 16 16 16 16 16 15 15 8 8 8 8 8 16 16 16 2 2 9
9 9 9 19 19 16 16 2 2 2 2 2 8 8 8 8 16 16 16 2 2 2 2 9
9 9 9 19 16 16 16 2 8 8 8 8 8 8 8 8 8 16 16 16 16 16 16 9
9 9 9 19 8 9 9 8 8 8 8 8 8 8 8 8 8 8 8 16 16 16 8 9
9 9 9 19 8 8 8 8 16 16 16 16 16 16 16 16 16 16 16 8 8 8 8 9
0 9 9 9 19 19 19 8 8 8 8 8 8 8 8 8 8 8 8 9 8 8 9 0
0 9 9 9 9 19 19 19 19 19 19 8 8 8 8 8 8 8 8 8 19 9 9 0
0 9 9 9 9 9 19 19 19 19 19 19 19 8 8 8 8 19 19 19 9 9 9 0
0 0 9 9 9 9 9 19 19 19 19 19 19 19 19 19 19 19 8 9 9 9 0 0
0 0 0 9 9 9 9 9 9 19 19 19 19 19 19 19 19 9 9 9 9 0 0 0
0 0 0 0 9 9 9 9 9 9 9 9 9 9 9 9 9 9 9 9 0 0 0 0
0 0 0 0 0 0 9 9 9 9 9 9 9 9 9 9 9 9 0 0 0 0 0 0
0 0 0 0 0 0 0 0 9 9 9 9 9 9 9 9 0 0 0 0 0 0 0 0
