0 0 0 0 0 0 16 16 16 16 16 16 0 0 0 0 0 0
0 0 0 0 16 16 8 8 8 8 8 8 16 16 0 0 0 0
0 0 16 16 8 8 8 8 8 8 8 8 8 8 16 16 0 0
0 0 16 15 15 15 15 15 15 15 15 15 15 15 15 15 16 0
0 16 15 15 15 15 15 15 15 15 15 15 15 15 15 15 16 0
0 16 15 15 16 15 15 15 15 15 15 15 15 16 15 15 15 16
16 19 19 19 19 16 19 16 19 19 16 19 16 19 19 19 19 16
16 19 19 16 16 16 16 16 19 19 16 16 16 16 16 19 19 16
16 19 16 14 16 16 16 16 19 19 16 16 16 16 14 16 19 16
16 19 16 14 16 16 16 19 19 19 19 16 16 16 14 16 19 16
16 9 16 14 14 14 16 9 9 9 9 16 14 14 14 16 9 16
16 9 9 16 16 16 9 9 9 9 9 9 16 16 16 9 9 16
0 16 9 9 9 9 9 9 16 16 9 9 9 9 9 9 9 16
0 16 9 9 9 9 9 16 9 9 16 9 9 9 9 9 16 0
0 0 16 13 13 13 16 13 13 13 13 16 13 13 13 13 16 0
0 0 16 13 13 13 13 13 13 13 13 13 13 13 13 16 0 0
0 0 0 16 16 12 12 12 12 12 12 12 12 16 16 0 0 0
0 0 0 0 0 16 16 16 16 16 16 16 16 0 0 0 0 0
---
0 0 0 0 0 0 15 15 15 15 15 15 0 0 0 0 0 0
0 0 0 0 15 15 15 15 15 15 15 15 15 15 0 0 0 0
0 0 15 15 15 15 15 15 15 15 15 15 15 15 15 15 0 0
0 0 15 9 9 9 9 9 9 9 9 9 9 9 9 9 15 0
0 15 9 9 9 9 9 9 9 9 9 9 9 9 9 9 15 0
0 15 9 9 19 9 9 9 9 9 9 9 9 13 9 9 9 15
15 16 16 16 16 19 15 19 16 16 13 13 13 16 16 16 16 15
8 16 16 19 19 19 19 19 16 16 13 13 13 13 13 16 16 15
8 16 19 16 19 19 19 19 16 16 13 13 13 13 8 13 16 14
8 16 19 16 19 19 19 16 16 16 16 13 13 13 8 13 16 14
8 16 19 16 16 16 19 16 16 16 16 13 8 8 8 13 16 14
8 16 16 19 19 19 16 16 16 16 16 16 13 13 13 16 16 14
0 8 16 16 16 16 16 16 19 19 16 16 16 16 16 16 16 14
0 8 16 16 16 16 16 19 16 16 19 16 16 16 16 9 14 0
0 0 8 16 16 16 19 16 16 16 16 19 16 16 16 16 14 0
0 0 8 16 16 16 16 16 16 16 16 16 16 16 16 14 0 0
0 0 0 8 8 16 16 16 16 16 16 16 16 14 14 0 0 0
0 0 0 0 0 12 12 12 12 12 12 12 12 0 0 0 0 0
