0 0 0 0 0 0 0 0 0 0 0 0 12 0 0 0 0 9 0 0 0
0 0 0 0 0 0 0 0 0 0 12 12 14 12 0 0 0 9 0 0 0
0 0 0 0 0 0 0 0 12 12 14 14 7 12 0 0 9 8 9 0 0
0 0 0 0 0 0 0 12 14 14 7 7 7 14 12 0 0 9 0 0 0
0 0 0 0 0 12 12 14 14 7 7 14 14 7 7 12 0 9 0 0 0
0 0 0 12 12 14 14 7 13 7 7 7 7 13 7 12 0 0 0 0 0
0 12 12 14 14 7 13 13 7 7 7 13 13 7 7 7 12 0 0 0 0
12 14 14 7 13 13 7 7 7 7 13 7 7 7 13 7 10 12 0 0 0
0 12 7 13 7 7 7 7 13 13 7 7 13 13 7 7 7 12 0 0 0
0 12 14 7 7 7 13 13 7 7 7 13 7 7 7 13 7 10 12 0 0
0 0 12 7 7 13 7 7 7 13 13 7 7 13 13 7 7 7 7 12 0
0 0 0 12 7 7 7 13 13 7 7 7 13 7 7 7 13 7 7 12 0
0 0 0 12 14 7 13 7 7 7 13 13 7 7 13 13 7 7 10 10 12
0 0 0 0 12 7 7 7 13 13 7 7 7 13 7 7 10 10 12 12 0
0 0 9 0 0 12 7 13 7 7 7 13 7 7 7 10 12 12 0 0 0
0 0 9 0 0 12 14 7 7 7 13 13 7 10 10 12 0 0 0 0 0
0 9 8 9 0 0 12 7 7 7 7 7 10 12 12 0 0 0 9 0 0
0 0 9 0 0 0 0 12 7 7 10 12 12 0 0 0 0 9 8 9 0
0 0 0 0 0 0 0 12 7 12 12 0 0 0 0 0 0 0 9 0 0
0 0 0 0 0 0 0 0 12 0 0 0 0 0 0 0 0 0 0 0 0
---
0 0 0 0 0 0 0 0 0 0 0 0 7 0 0 0 0 14 0 0 0
0 0 0 0 0 0 0 0 0 0 7 7 7 7 0 0 0 14 0 0 0
0 0 0 0 0 0 0 0 7 7 7 7 12 7 0 0 14 14 14 0 0
0 0 0 0 0 0 0 7 7 7 12 12 12 7 7 0 0 14 0 0 0
0 0 0 0 0 7 7 7 7 12 12 7 7 12 12 7 0 14 0 0 0
0 0 0 7 7 7 7 12 7 12 12 12 12 7 12 7 0 0 0 0 0
0 7 7 7 7 12 7 7 12 12 12 7 7 12 13 13 7 0 0 0 0
7 7 7 12 7 7 12 12 12 12 7 12 12 12 7 13 9 7 0 0 0
0 7 12 7 12 12 12 12 7 7 12 12 7 7 13 13 13 7 0 0 0
0 7 7 12 12 12 7 7 12 12 12 7 13 13 13 7 13 9 7 0 0
0 0 7 12 12 7 12 12 12 7 7 13 13 7 7 13 13 9 9 7 0
0 0 0 7 12 12 12 7 7 13 13 13 7 13 13 13 7 9 9 7 0
0 0 0 7 7 13 7 13 13 13 7 7 13 13 7 7 8 9 9 9 7
0 0 0 0 7 13 13 13 7 7 13 13 13 7 8 8 9 9 7 7 0
0 0 14 0 0 7 13 7 13 13 13 7 10 10 10 9 7 7 0 0 0
0 0 14 0 0 7 7 13 13 13 7 7 10 9 9 7 0 0 0 0 0
0 14 14 14 0 0 7 13 10 10 10 10 9 7 7 0 0 0 14 0 0
0 0 14 0 0 0 0 7 10 10 14 7 7 0 0 0 0 14 14 14 0
0 0 0 0 0 0 0 7 10 7 7 0 0 0 0 0 0 0 14 0 0
0 0 0 0 0 0 0 0 7 0 0 0 0 0 0 0 0 0 0 0 0
