0 0 0 0 0 18 2 18 0 0 0 0
0 0 0 0 0 18 2 2 18 0 0 0
0 0 0 18 18 15 15 15 15 18 0 0
0 0 18 18 9 9 9 9 15 15 18 0
0 0 18 9 9 9 9 9 9 15 18 0
0 0 18 16 14 14 16 9 9 15 18 0
0 18 18 14 12 12 14 9 15 15 18 0
0 18 9 9 15 15 15 15 15 9 9 18
0 18 14 14 15 15 15 15 15 15 14 18
0 0 18 15 15 15 15 15 15 18 18 18
0 18 15 16 15 15 15 9 18 0 0 0
0 0 18 15 15 18 18 9 14 18 0 0
---
0 0 0 0 0 15 14 15 0 0 0 0
0 0 0 0 0 15 14 14 15 0 0 0
0 0 0 15 15 18 18 18 18 15 0 0
0 0 15 15 15 15 15 15 18 18 15 0
0 0 9 15 15 15 15 15 15 18 15 0
0 0 9 14 9 9 14 15 15 18 15 0
0 9 9 9 9 9 9 15 18 18 15 0
0 9 2 2 18 18 18 18 18 16 16 15
0 9 16 14 18 18 18 18 18 18 12 15
0 0 9 9 18 18 18 18 18 15 15 15
0 9 9 2 18 18 18 14 15 0 0 0
0 0 9 18 18 9 9 14 12 15 0 0
