0 0 0 0 0 0 0 0 16 16 16 16 0 0 0 0
0 0 0 0 0 0 0 0 16 13 13 13 16 0 0 0
0 0 0 0 0 0 0 0 0 16 16 13 13 16 0 0
0 0 0 0 0 0 0 0 16 7 14 14 14 7 16 0
0 16 16 0 0 0 0 0 16 14 14 16 14 14 16 0
16 7 7 16 16 0 0 0 16 14 14 16 14 9 9 16
16 7 14 14 14 16 16 16 14 14 14 16 14 14 16 0
16 7 14 14 14 14 14 14 14 14 14 14 14 14 16 0
0 16 7 7 14 14 14 14 14 14 14 14 14 14 7 16
16 7 7 7 16 16 14 14 14 14 14 14 14 14 14 16
16 7 7 7 16 14 14 14 14 14 14 14 14 14 14 16
0 16 7 7 7 16 16 16 16 14 14 14 14 14 7 16
0 0 16 7 7 7 7 7 14 14 14 14 7 7 16 0
0 0 0 16 16 7 16 7 7 7 7 7 16 16 0 0
0 0 0 0 0 16 2 16 16 16 16 16 0 0 0 0
0 0 0 0 0 16 2 9 9 16 9 16 0 0 0 0
---
0 0 0 0 0 0 0 0 7 7 7 7 0 0 0 0
0 0 0 0 0 0 0 0 7 7 7 7 7 0 0 0
0 0 0 0 0 0 0 0 0 7 7 7 7 7 0 0
0 0 0 0 0 0 0 0 7 9 7 7 7 9 7 0
0 14 14 0 0 0 0 0 14 7 16 9 16 7 14 0
14 14 14 14 14 0 0 0 14 7 16 9 7 2 2 14
14 14 16 16 16 14 14 14 16 16 16 9 16 7 14 0
14 14 16 16 16 16 16 16 16 16 16 16 16 16 14 0
0 14 14 14 16 16 16 16 16 16 16 16 16 16 7 14
14 14 14 14 7 7 16 16 16 16 16 16 16 16 16 14
14 14 14 14 7 16 16 16 16 16 16 16 16 16 16 14
0 14 14 14 14 7 7 7 7 16 16 16 16 16 16 14
0 0 14 14 14 14 14 14 16 16 16 16 14 14 14 0
0 0 0 14 14 14 14 14 14 14 14 14 14 14 0 0
0 0 0 0 0 14 13 14 14 14 14 14 0 0 0 0
0 0 0 0 0 14 13 13 13 14 13 14 0 0 0 0
