16 10 9 16 0 0 0 16 9 10 16 0
16 10 10 9 16 16 16 16 16 10 16 0
16 16 10 9 9 15 14 14 15 9 9 16
16 16 9 18 18 14 10 10 14 18 9 16
16 9 9 15 14 16 16 16 16 14 14 16
16 9 15 14 16 12 12 12 12 16 15 16
16 9 9 15 16 12 12 12 12 12 15 16
16 16 9 14 12 10 12 12 10 10 14 16
0 16 16 14 14 12 10 10 12 14 16 0
16 16 9 14 14 14 14 14 14 14 16 0
16 9 14 14 14 14 14 14 14 16 16 0
15 14 14 14 14 14 14 14 14 14 16 0
---
14 14 16 10 0 0 0 10 16 16 14 0
14 14 14 16 10 10 10 10 10 16 14 0
14 14 14 16 16 16 10 10 16 16 16 14
14 14 16 18 18 10 16 16 10 18 16 14
14 16 16 16 10 15 15 15 15 15 14 14
14 16 16 10 15 16 16 16 16 15 14 14
14 16 16 16 15 16 16 16 16 16 14 14
14 14 16 12 16 16 16 16 16 16 9 14
0 14 14 12 12 16 16 16 16 9 14 0
14 14 12 12 12 9 9 9 9 9 14 0
14 12 12 12 12 9 9 9 9 14 14 0
12 12 12 12 9 9 9 9 9 9 14 0
