0 0 0 0 18 18 18 18 18 18 0 0 0 0
0 0 18 18 1 3 3 3 3 3 18 18 0 0
0 18 1 1 3 3 14 3 14 14 3 3 18 0
0 18 1 1 3 3 3 3 14 14 14 3 18 0
18 1 1 3 3 3 1 3 3 3 14 3 3 18
18 1 1 3 3 1 3 3 3 3 3 3 3 18
18 1 1 3 3 1 3 3 3 3 3 3 3 18
18 1 1 3 3 1 3 3 14 3 3 1 3 18
18 1 1 3 3 1 3 3 3 3 3 1 3 18
0 18 1 1 3 1 3 3 3 3 3 1 18 0
0 18 1 1 1 3 1 1 3 3 1 1 18 0
0 0 18 18 1 1 1 1 1 1 18 18 0 0
0 0 0 0 18 18 18 18 18 18 0 0 0 0
---
0 0 0 0 1 1 1 1 1 1 0 0 0 0
0 0 1 1 3 14 14 14 14 14 1 1 0 0
0 1 3 3 14 14 3 1 3 3 1 1 1 0
0 1 3 3 18 18 14 1 3 3 3 1 1 0
1 3 3 18 18 18 3 1 1 1 3 1 1 1
1 3 3 18 18 3 1 1 1 1 1 1 1 1
3 3 3 18 18 3 18 1 1 18 18 18 18 1
3 3 3 18 18 3 18 18 1 18 18 3 18 3
3 3 3 18 18 3 18 18 18 18 18 3 18 3
0 3 3 3 18 3 18 18 18 18 18 3 3 0
0 3 3 3 3 18 3 3 18 18 3 3 3 0
0 0 3 3 3 3 3 3 3 3 3 3 0 0
0 0 0 0 3 3 3 3 3 3 0 0 0 0
