0 0 0 0 0 0 0 0 0 5 17 0 0
0 0 0 0 0 0 0 0 13 8 5 17 0
0 0 0 0 0 0 0 13 13 8 8 5 17
0 0 0 0 0 0 13 13 18 13 8 5 17
0 0 0 0 0 13 13 13 13 13 8 5 17
0 0 0 0 13 13 13 18 13 13 8 5 17
0 0 0 13 13 13 13 13 13 13 8 5 17
0 0 13 13 13 18 13 13 13 8 8 5 17
0 13 13 18 13 13 13 13 13 8 5 17 0
5 8 8 13 13 13 13 8 8 5 17 17 0
17 5 8 8 8 8 8 8 5 17 17 0 0
0 17 5 5 5 5 5 5 17 17 0 0 0
0 0 0 17 17 17 17 17 0 0 0 0 0
---
0 0 0 0 0 0 0 0 0 8 13 0 0
0 0 0 0 0 0 0 0 17 13 8 13 0
0 0 0 0 0 0 0 17 17 13 13 8 13
0 0 0 0 0 0 17 17 5 5 13 8 13
0 0 0 0 0 17 17 17 5 5 13 8 13
0 0 0 0 17 17 17 5 5 5 13 8 13
0 0 0 17 17 17 17 5 5 5 13 8 13
0 0 17 17 17 5 5 5 5 13 13 8 13
0 17 17 5 5 17 5 5 5 13 8 13 0
18 13 13 8 8 8 17 13 13 8 13 13 0
18 18 13 13 13 13 13 13 8 13 13 0 0
0 18 8 8 8 8 8 8 13 13 0 0 0
0 0 0 13 13 13 13 13 0 0 0 0 0
