0 0 0 0 0 0 18 0 18 0 0 18 0 0 18 0 0 18 0 18 0 0 0 0 0 0 0
0 0 0 0 0 18 10 10 10 0 18 13 18 18 13 18 0 10 10 10 18 0 0 0 0 0 0
0 0 0 0 0 0 18 10 18 0 18 13 13 13 13 18 0 18 10 18 0 0 0 0 0 0 0
0 0 0 0 0 0 0 18 0 0 0 18 13 13 18 0 0 0 18 0 0 0 0 0 0 0 0
0 0 0 0 0 0 0 0 0 0 0 0 18 18 0 0 0 0 0 0 0 0 0 0 0 0 0
0 0 0 0 18 18 18 0 0 0 0 0 0 0 0 0 0 0 0 0 18 18 18 0 0 0 0
0 0 0 18 14 14 14 18 18 18 18 0 0 0 0 0 18 18 18 18 14 14 14 18 0 0 0
0 0 0 18 1 14 14 14 14 14 14 18 18 0 18 18 14 14 14 14 14 14 1 18 0 0 0
0 0 18 14 14 1 1 1 1 1 1 14 14 18 14 14 1 1 1 1 1 1 14 14 18 0 0
0 0 18 14 14 1 1 1 1 1 7 1 1 18 1 1 7 1 1 1 1 1 14 14 18 0 0
0 0 18 14 1 1 1 1 18 13 7 13 18 0 18 13 7 13 18 1 1 1 1 14 18 0 0
0 0 18 10 13 13 13 13 13 7 7 13 18 0 18 13 7 7 13 13 13 13 13 10 18 0 0
0 0 18 10 13 13 13 13 7 7 13 18 0 0 0 18 13 7 7 13 13 13 13 10 18 0 0
0 0 0 18 10 13 13 13 13 13 13 18 0 0 0 18 13 13 13 13 13 13 10 18 0 0 0
0 0 0 0 18 10 10 10 13 13 18 0 0 0 0 0 18 13 13 10 10 10 18 0 0 0 0
0 0 0 0 0 18 18 18 18 18 0 0 0 0 0 0 0 18 18 18 18 18 0 0 0 0 0
0 0 0 0 0 18 14 18 0 0 0 0 0 0 0 0 0 0 0 18 14 18 0 0 0 0 0
0 0 0 0 0 18 1 18 0 0 0 0 0 0 0 0 0 0 0 18 1 18 0 0 0 0 0
0 0 0 0 18 14 18 0 0 0 0 0 0 0 0 0 0 0 0 0 18 14 18 0 0 0 0
0 0 0 0 18 1 18 0 0 0 0 0 0 0 0 0 0 0 0 0 18 1 18 0 0 0 0
0 18 18 18 14 1 18 0 0 0 0 0 0 0 0 0 0 0 0 0 18 1 14 18 18 18 0
18 14 14 14 14 1 1 18 18 0 0 0 0 0 0 0 0 0 18 18 1 1 14 14 14 14 18
18 18 1 1 1 1 1 1 14 18 0 0 0 0 0 0 0 18 14 1 1 1 1 1 1 18 18
0 0 18 18 18 18 18 18 18 18 0 0 0 0 0 0 0 18 18 18 18 18 18 18 18 0 0
---
0 0 0 0 0 0 1 0 1 0 0 13 0 0 13 0 0 1 0 1 0 0 0 0 0 0 0
0 0 0 0 0 1 1 1 1 0 13 1 13 13 1 13 0 1 1 1 1 0 0 0 0 0 0
0 0 0 0 0 0 1 1 1 0 13 1 1 1 1 13 0 1 1 1 0 0 0 0 0 0 0
0 0 0 0 0 0 0 1 0 0 0 13 1 1 13 0 0 0 1 0 0 0 0 0 0 0 0
0 0 0 0 0 0 0 0 0 0 0 0 13 13 0 0 0 0 0 0 0 0 0 0 0 0 0
0 0 0 0 10 10 10 0 0 0 0 0 0 0 0 0 0 0 0 0 1 1 1 0 0 0 0
0 0 0 10 18 18 18 10 10 10 10 0 0 0 0 0 1 1 1 1 18 18 18 1 0 0 0
0 0 0 10 18 18 18 18 18 18 18 10 10 0 1 1 18 18 18 18 18 18 18 1 0 0 0
0 0 10 18 18 18 18 18 18 18 18 18 18 1 18 18 18 18 18 18 18 18 18 18 1 0 0
0 0 10 18 18 18 18 18 18 18 18 18 18 1 18 18 18 18 18 18 18 18 18 18 1 0 0
0 0 10 18 18 18 18 18 18 18 18 18 7 0 1 18 18 18 18 18 18 18 18 18 1 0 0
0 0 10 18 18 18 18 18 18 18 18 18 7 0 1 18 18 18 18 18 18 18 18 18 1 0 0
0 0 10 18 18 18 18 18 18 18 18 7 0 0 0 1 18 18 18 18 18 18 18 18 1 0 0
0 0 0 10 18 18 18 18 18 18 18 7 0 0 0 1 18 18 18 18 18 18 18 1 0 0 0
0 0 0 0 10 18 18 18 18 18 7 0 0 0 0 0 1 18 18 18 18 18 1 0 0 0 0
0 0 0 0 0 10 10 7 7 7 0 0 0 0 0 0 0 1 1 1 1 1 0 0 0 0 0
0 0 0 0 0 14 13 7 0 0 0 0 0 0 0 0 0 0 0 14 13 14 0 0 0 0 0
0 0 0 0 0 14 13 7 0 0 0 0 0 0 0 0 0 0 0 14 13 14 0 0 0 0 0
0 0 0 0 14 13 7 0 0 0 0 0 0 0 0 0 0 0 0 0 14 13 14 0 0 0 0
0 0 0 0 14 13 7 0 0 0 0 0 0 0 0 0 0 0 0 0 14 13 14 0 0 0 0
0 14 14 14 13 13 14 0 0 0 0 0 0 0 0 0 0 0 0 0 14 13 13 14 14 14 0
14 13 13 13 13 13 13 14 14 0 0 0 0 0 0 0 0 0 14 14 13 13 13 13 13 13 14
14 14 13 13 13 13 13 13 13 14 0 0 0 0 0 0 0 14 13 13 13 13 13 13 13 14 14
0 0 14 14 14 14 14 14 14 14 0 0 0 0 0 0 0 14 14 14 14 14 14 14 14 0 0
