0 0 0 0 0 0 0 0 18 0 0 0
0 0 0 0 18 0 0 18 0 0 0 0
0 0 0 0 0 18 18 0 0 0 0 0
0 18 18 18 18 18 18 18 18 18 18 0
18 18 14 8 3 5 10 13 1 18 18 18
18 18 14 8 3 5 10 13 1 18 14 18
18 18 14 8 3 5 10 13 1 18 18 18
18 18 14 8 3 5 10 13 1 18 18 18
18 18 14 8 3 5 10 13 1 18 14 18
18 18 14 8 3 5 10 13 1 18 18 18
18 18 14 8 3 5 10 13 1 18 18 18
0 18 18 18 18 18 18 18 18 18 18 0
---
0 0 0 0 0 0 0 0 13 0 0 0
0 0 0 0 8 0 0 13 0 0 0 0
0 0 0 0 0 8 13 0 0 0 0 0
0 8 8 8 8 8 13 13 13 13 1 0
14 14 18 18 18 18 18 18 18 1 1 1
14 14 18 18 18 18 18 18 18 1 14 1
14 14 18 18 18 18 18 18 18 10 1 10
14 3 18 18 18 18 18 18 18 10 10 10
3 3 18 18 18 18 18 18 18 10 14 10
3 3 18 18 18 18 18 18 18 5 5 5
3 3 18 18 18 18 18 18 18 5 5 5
0 18 18 18 18 18 18 18 18 18 5 0
