0 0 0 0 0 0 16 0 0 0 0 0 0 0 0 0 16 0 0 0 0 0 0 0
0 0 0 0 0 16 9 16 0 0 0 0 0 0 0 16 9 16 0 0 0 0 0 0
0 10 0 10 0 16 9 9 16 0 0 0 0 0 16 9 9 16 0 0 10 0 10 0
0 0 10 0 0 16 9 9 9 16 0 0 0 16 9 9 9 16 0 10 10 10 10 10
0 0 0 0 0 16 9 9 9 16 16 16 16 16 9 9 9 16 0 0 10 10 10 0
0 0 0 0 0 16 16 9 9 9 9 8 9 9 9 9 16 16 0 0 0 10 0 0
0 0 0 0 0 16 8 8 9 9 8 8 8 9 9 9 9 16 0 0 0 0 0 0
0 0 0 0 16 8 8 8 8 8 8 8 8 9 9 9 9 8 16 0 0 0 0 0
0 0 0 0 16 8 8 8 16 16 16 8 16 16 16 9 8 8 16 0 0 0 0 0
0 0 0 0 16 8 16 16 16 9 9 8 9 9 16 16 16 8 16 0 10 0 10 0
0 0 0 0 0 16 16 9 9 9 9 9 9 9 9 9 16 16 0 0 0 10 0 0
0 0 0 0 16 16 9 9 9 9 9 9 9 9 9 9 9 16 16 0 0 0 0 0
0 0 0 16 16 9 9 15 15 16 16 9 16 16 15 15 9 9 16 16 0 0 0 0
0 0 0 16 9 9 15 15 15 8 16 16 16 8 15 15 15 9 9 16 0 0 0 0
0 0 0 16 9 15 15 8 8 8 8 16 8 8 8 8 15 15 9 16 0 0 0 0
0 0 0 16 15 8 8 8 8 8 8 8 8 8 8 8 8 8 15 16 0 0 0 0
0 0 0 16 15 8 8 8 8 8 8 10 8 8 8 8 8 8 15 16 0 0 0 0
0 0 0 16 15 15 8 8 8 8 8 8 8 8 8 8 8 15 15 16 0 0 0 0
0 0 0 16 9 15 8 8 8 8 8 16 8 8 8 8 8 15 9 16 0 0 0 0
0 0 0 0 16 9 9 8 8 8 8 16 8 8 8 8 9 9 16 0 0 0 0 0
0 0 0 0 0 16 9 9 9 8 16 16 16 8 9 9 9 16 0 0 0 0 0 0
0 0 0 0 0 0 16 8 9 16 16 0 16 16 9 8 16 0 0 0 0 0 0 0
0 0 0 0 0 0 16 8 8 16 0 0 0 16 8 8 16 0 0 0 0 0 0 0
0 0 0 0 0 0 0 16 16 0 0 0 0 0 16 16 0 0 0 0 0 0 0 0
---
0 0 0 0 0 0 8 0 0 0 0 0 0 0 0 0 8 0 0 0 0 0 0 0
0 0 0 0 0 8 15 8 0 0 0 0 0 0 0 8 16 8 0 0 0 0 0 0
0 15 0 15 0 8 15 15 8 0 0 0 0 0 8 16 16 8 0 0 15 0 15 0
0 0 9 0 0 8 15 15 15 8 0 0 0 8 16 16 16 8 0 15 15 15 15 15
0 0 0 0 0 8 15 15 15 8 8 8 8 8 16 16 16 8 0 0 16 16 16 0
0 0 0 0 0 8 8 15 15 15 15 9 16 16 16 16 8 8 0 0 0 16 0 0
0 0 0 0 0 8 9 9 15 15 9 9 9 16 16 16 16 8 0 0 0 0 0 0
0 0 0 0 8 9 9 9 9 9 9 9 9 16 16 16 16 9 8 0 0 0 0 0
0 0 0 0 8 9 9 9 8 8 8 9 8 8 8 16 9 9 8 0 0 0 0 0
0 0 0 0 8 9 8 8 8 8 8 9 8 8 8 8 8 9 8 0 8 0 8 0
0 0 0 0 0 8 8 8 8 8 8 8 8 8 8 8 8 8 0 0 0 8 0 0
0 0 0 0 8 8 8 8 8 8 8 8 8 8 8 8 8 8 8 0 0 0 0 0
0 0 0 8 8 8 8 9 9 10 10 8 10 10 9 9 8 8 8 8 0 0 0 0
0 0 0 9 8 8 9 9 9 16 10 10 10 16 9 9 9 8 8 8 0 0 0 0
0 0 0 9 8 9 9 16 16 16 16 10 16 16 16 16 9 9 8 9 0 0 0 0
0 0 0 9 9 16 16 16 16 16 16 16 16 16 16 16 16 16 9 9 0 0 0 0
0 0 0 9 9 16 16 16 16 16 16 16 16 16 16 16 16 16 9 9 0 0 0 0
0 0 0 9 9 9 16 16 16 16 16 16 16 16 16 16 16 9 9 9 0 0 0 0
0 0 0 9 16 9 16 16 16 16 16 9 16 16 16 16 16 9 10 9 0 0 0 0
0 0 0 0 9 16 16 16 16 16 16 9 16 16 16 16 10 10 9 0 0 0 0 0
0 0 0 0 0 9 16 16 16 16 9 9 9 16 10 10 10 9 0 0 0 0 0 0
0 0 0 0 0 0 9 9 16 9 9 0 9 9 10 10 9 0 0 0 0 0 0 0
0 0 0 0 0 0 9 9 9 9 0 0 0 9 10 10 9 0 0 0 0 0 0 0
0 0 0 0 0 0 0 9 9 0 0 0 0 0 9 9 0 0 0 0 0 0 0 0
