0 0 0 0 0 18 18 18 18 0 0 0 0
0 0 0 0 18 15 15 15 15 18 18 0 0
0 0 0 18 18 18 18 15 15 9 15 18 0
0 0 18 1 1 1 1 18 15 19 9 15 18
0 18 1 1 1 1 1 4 18 9 15 15 18
0 18 18 18 18 18 1 1 4 18 19 15 18
18 8 8 8 8 8 18 4 4 18 19 15 18
18 14 14 14 14 8 18 18 4 18 19 15 18
18 18 14 14 18 14 14 8 18 19 19 15 18
18 14 14 14 14 14 18 18 19 19 15 15 18
18 14 14 14 14 18 14 7 18 15 15 1 18
0 18 14 14 14 18 7 10 18 15 18 1 18
0 0 18 18 18 8 18 18 18 15 18 1 18
0 0 0 18 18 18 19 6 18 1 18 18 0
0 0 18 8 8 8 19 16 18 1 18 0 0
0 18 8 19 19 16 16 6 18 18 18 0 0
18 8 19 16 16 15 19 6 6 6 6 18 0
18 19 16 15 15 15 15 19 19 19 6 18 0
18 18 18 18 18 18 18 18 18 18 18 18 0
---
0 0 0 0 0 15 14 14 14 0 0 0 0
0 0 0 0 15 18 18 18 18 14 14 0 0
0 0 0 9 9 15 15 18 18 18 18 14 0
0 0 9 18 18 18 18 15 18 18 18 18 14
0 16 18 18 18 18 18 18 4 18 18 18 14
0 16 6 6 6 6 18 18 18 4 18 18 14
16 18 18 18 18 18 6 18 18 4 18 18 14
16 15 15 15 15 18 6 6 18 4 18 18 14
16 16 15 15 10 15 15 7 4 18 18 18 14
1 15 15 15 15 15 8 8 18 18 18 18 14
1 15 15 15 15 8 15 18 8 18 18 18 14
0 1 15 15 15 8 18 7 8 18 14 18 14
0 0 1 1 1 18 8 8 8 18 14 18 14
0 0 0 1 1 1 18 18 8 18 14 14 0
0 0 1 18 18 18 18 1 8 18 14 0 0
0 19 18 18 18 1 1 18 8 8 19 0 0
19 18 18 1 1 18 18 18 18 18 18 19 0
19 18 1 18 18 18 18 18 18 18 18 19 0
19 19 19 19 19 19 19 19 19 19 19 19 0
