0 18 18 18 18 18 18 18 18 18 18 18 0 0 0
18 14 14 14 14 14 14 14 14 18 8 8 18 0 0
18 14 14 13 13 13 14 14 14 18 8 8 8 18 0
18 14 13 14 14 14 13 14 14 18 8 8 8 18 0
18 14 13 14 14 14 13 14 14 18 8 8 8 8 18
18 14 13 13 13 13 13 14 14 14 18 18 18 18 18
18 14 13 14 14 14 13 14 14 14 14 14 14 14 18
18 14 13 14 14 14 13 14 1 1 1 1 1 14 18
18 14 14 14 14 14 14 14 14 14 14 14 14 14 18
18 14 1 1 1 1 1 1 1 1 1 1 1 14 18
18 14 14 14 14 14 14 14 14 14 14 14 14 14 18
18 14 1 1 1 1 1 1 1 1 1 1 1 14 18
18 14 14 14 14 14 14 14 14 14 14 14 14 14 18
18 14 1 1 1 1 1 1 1 1 1 1 1 14 18
18 14 14 14 14 14 14 14 14 14 14 14 14 14 18
18 14 14 14 14 14 14 1 1 1 1 1 14 14 18
18 14 14 14 14 14 14 14 14 14 14 14 14 14 18
0 18 18 18 18 18 18 18 18 18 18 18 18 18 0
---
0 14 14 14 14 14 14 14 14 14 14 14 0 0 0
14 18 18 18 18 18 18 18 18 14 14 14 14 0 0
14 18 18 18 18 18 18 18 18 14 14 14 14 14 0
14 18 18 18 18 18 18 18 18 14 14 14 14 14 0
14 18 18 18 18 18 18 18 18 14 14 14 14 14 14
14 18 18 18 18 18 18 18 18 18 14 14 14 14 14
14 18 18 18 18 18 18 18 18 18 1 1 1 1 14
14 18 18 18 18 18 18 18 14 14 14 14 14 1 14
14 18 18 18 18 18 18 18 1 1 1 1 1 1 14
14 1 14 14 14 14 14 14 14 14 14 14 14 1 14
14 1 1 1 1 1 1 1 1 1 1 1 1 1 14
14 1 14 14 14 14 14 14 14 14 14 14 14 1 14
14 1 1 1 1 1 1 1 1 1 1 1 1 1 14
14 13 14 14 14 14 14 14 14 14 14 14 14 1 14
14 13 13 13 13 13 13 13 13 13 13 13 13 1 14
14 13 13 13 8 8 8 14 14 14 14 14 14 14 14
14 8 8 8 8 8 8 8 8 8 14 14 14 14 14
0 14 14 14 14 14 14 14 14 14 14 14 14 14 0
