0 0 0 0 0 0 0 0 18 18 18 0 0 0 0 0 0 0 0 0 0 0 0 0 0 0
0 0 0 0 0 0 18 18 10 10 10 18 0 0 0 0 0 0 0 0 0 0 0 0 0 0
0 0 0 0 18 18 10 10 10 10 10 10 18 18 18 0 0 0 0 0 0 0 0 0 0 0
0 0 0 18 10 10 10 10 10 10 10 18 14 14 14 18 0 0 0 0 0 0 0 0 0 0
0 0 0 18 10 10 10 18 18 18 18 14 14 7 7 18 18 0 0 0 0 0 0 0 0 0
18 18 18 18 10 10 18 7 7 7 14 14 7 7 18 15 15 18 0 0 0 0 0 0 0 0
18 9 9 18 18 18 7 14 14 14 14 14 14 18 15 15 15 18 0 0 0 0 0 0 0 0
0 18 9 9 9 18 14 14 14 14 14 14 14 7 18 15 15 18 0 0 0 0 0 0 0 0
0 0 18 9 9 18 14 14 18 14 14 14 14 7 18 15 18 0 0 0 0 0 0 0 0 0
0 0 18 18 18 18 14 14 18 18 18 14 14 7 18 18 3 18 0 0 0 0 0 0 0 0
0 0 18 10 18 7 14 14 14 18 18 14 14 14 7 18 3 18 0 0 0 0 0 0 0 0
0 0 0 18 7 14 14 14 14 18 18 14 14 14 7 18 18 6 18 0 18 18 0 0 0 0
0 0 0 18 14 14 14 14 14 18 18 14 14 14 14 7 18 6 18 18 14 18 0 0 0 0
0 0 0 18 14 14 14 14 14 14 14 10 10 14 14 7 18 18 14 14 14 18 0 0 0 0
0 0 0 18 14 14 14 14 14 14 14 10 10 14 14 7 18 14 14 7 7 18 0 0 0 0
0 0 0 0 18 14 14 14 14 14 7 14 14 14 14 7 18 14 7 7 18 18 0 0 0 0
0 0 0 0 0 18 7 7 7 7 18 14 14 14 14 14 14 7 18 18 0 0 0 18 0 0
0 0 0 0 0 0 18 18 18 18 14 14 14 14 14 14 14 18 18 18 18 0 18 9 18 0
0 0 0 0 0 0 0 0 0 18 14 14 14 14 14 14 14 10 10 10 10 18 9 9 9 18
0 0 0 0 0 0 0 0 18 14 14 14 14 14 14 14 10 10 10 10 14 14 18 9 9 18
0 0 0 0 0 0 0 18 18 14 14 14 14 14 14 14 14 14 10 10 14 14 18 9 9 18
0 0 0 0 0 0 18 14 18 18 14 7 7 7 7 7 18 7 14 10 14 14 18 18 18 0
0 0 0 0 0 18 14 18 18 14 14 18 18 18 18 18 18 18 14 14 14 14 18 0 0 0
0 0 0 0 0 18 10 18 14 14 14 18 0 0 0 18 14 18 18 14 14 14 18 0 0 0
0 0 0 0 0 0 18 18 10 10 10 18 0 0 0 18 10 10 18 14 14 14 18 0 0 0
0 0 0 0 0 0 0 18 18 18 18 0 0 0 0 0 18 18 18 10 10 10 18 0 0 0
0 0 0 0 0 0 0 0 0 0 0 0 0 0 0 0 0 0 18 18 18 18 0 0 0 0
---
0 0 0 0 0 0 0 0 14 14 14 0 0 0 0 0 0 0 0 0 0 0 0 0 0 0
0 0 0 0 0 0 14 14 14 14 14 14 0 0 0 0 0 0 0 0 0 0 0 0 0 0
0 0 0 0 14 14 14 14 14 14 14 14 14 14 14 0 0 0 0 0 0 0 0 0 0 0
0 0 0 14 14 14 14 14 14 14 14 14 18 18 18 14 0 0 0 0 0 0 0 0 0 0
0 0 0 14 14 14 14 14 14 14 14 18 18 15 15 14 14 0 0 0 0 0 0 0 0 0
14 14 14 14 14 14 14 14 14 14 18 18 15 15 14 7 7 14 0 0 0 0 0 0 0 0
14 10 10 14 14 14 14 18 18 18 18 18 18 14 7 7 7 14 0 0 0 0 0 0 0 0
0 14 10 10 10 14 18 18 18 18 18 18 18 14 14 7 7 14 0 0 0 0 0 0 0 0
0 0 14 10 10 14 18 18 7 18 18 18 18 14 14 7 14 0 0 0 0 0 0 0 0 0
0 0 14 14 14 14 18 18 7 7 7 18 18 14 14 14 9 14 0 0 0 0 0 0 0 0
0 0 14 18 14 18 18 18 18 7 7 18 18 18 14 14 9 14 0 0 0 0 0 0 0 0
0 0 0 14 18 18 18 18 18 7 7 18 18 18 14 14 14 3 14 0 14 14 0 0 0 0
0 0 0 14 18 18 18 18 18 7 7 18 18 18 18 14 14 3 14 14 18 14 0 0 0 0
0 0 0 14 18 18 18 18 18 18 18 7 7 18 18 14 14 14 18 18 18 14 0 0 0 0
0 0 0 14 18 18 18 18 18 18 18 7 7 18 18 14 14 18 18 9 9 14 0 0 0 0
0 0 0 0 14 18 18 18 18 18 18 18 18 18 18 14 14 18 9 9 14 14 0 0 0 0
0 0 0 0 0 14 18 18 18 18 14 18 18 18 18 18 18 9 14 14 0 0 0 14 0 0
0 0 0 0 0 0 14 14 14 14 18 18 18 18 18 18 18 14 14 14 14 0 14 14 14 0
0 0 0 0 0 0 0 0 0 14 18 18 18 18 18 18 18 7 7 7 7 14 14 14 14 14
0 0 0 0 0 0 0 0 14 18 18 18 18 18 18 18 7 7 7 7 18 18 14 14 14 14
0 0 0 0 0 0 0 14 14 18 18 18 18 18 18 18 18 18 7 7 18 18 14 14 14 14
0 0 0 0 0 0 14 10 14 14 18 9 9 9 9 9 10 6 18 7 18 18 14 14 14 0
0 0 0 0 0 10 10 10 10 18 18 10 10 10 10 10 10 10 18 18 18 18 10 0 0 0
0 0 0 0 0 10 15 10 18 18 18 10 0 0 0 10 6 10 10 18 18 18 10 0 0 0
0 0 0 0 0 0 10 10 9 9 9 10 0 0 0 10 7 7 10 18 18 18 10 0 0 0
0 0 0 0 0 0 0 10 10 10 10 0 0 0 0 0 10 10 10 15 15 15 10 0 0 0
0 0 0 0 0 0 0 0 0 0 0 0 0 0 0 0 0 0 10 10 10 10 0 0 0 0
