0 0 0 0 0 18 18 18 18 18 18 18 18 18 0 0 0 0 0
0 0 0 0 18 2 9 2 2 2 2 2 9 2 18 0 0 0 0
0 0 0 18 2 18 18 2 2 2 2 2 18 18 2 18 0 0 0
0 0 0 18 18 14 14 18 18 18 18 18 15 15 18 18 0 0 0
0 0 0 18 14 15 19 19 19 19 19 19 19 15 15 18 0 0 0
0 0 18 14 19 19 18 18 18 18 18 18 18 15 15 15 18 0 0
0 18 14 19 18 18 18 8 8 18 8 8 18 18 18 15 15 18 0
18 18 15 18 18 8 8 14 14 14 14 14 8 8 18 18 15 18 18
18 15 19 18 8 18 14 14 14 18 14 14 14 18 8 18 15 15 18
18 15 18 18 8 14 14 14 14 18 14 14 14 14 8 18 18 15 18
18 15 18 8 14 14 14 14 14 18 14 14 14 14 14 8 18 15 18
18 15 18 14 18 14 14 14 14 18 18 18 14 14 18 14 18 15 18
18 15 18 14 14 14 14 14 14 14 14 14 14 14 14 14 18 15 18
18 15 18 18 14 14 14 14 14 14 14 14 14 14 14 18 18 19 18
18 15 15 18 14 18 14 14 14 14 14 14 14 18 14 18 15 19 18
18 18 15 18 18 14 14 14 14 14 14 14 14 14 18 18 15 18 18
0 18 15 15 18 18 18 14 14 18 14 14 18 18 18 15 19 18 0
0 0 18 15 15 15 18 18 18 18 18 18 18 15 15 19 18 0 0
0 0 0 18 19 15 15 15 15 15 15 15 15 15 19 18 0 0 0
0 0 0 18 18 19 19 18 18 18 18 18 19 19 18 18 0 0 0
0 0 0 18 2 18 18 2 2 2 2 2 18 18 2 18 0 0 0
0 0 0 0 18 2 9 2 2 2 2 2 9 2 18 0 0 0 0
0 0 0 0 0 18 18 18 18 18 18 18 18 18 0 0 0 0 0
---
0 0 0 0 0 14 14 14 14 14 14 14 14 14 0 0 0 0 0
0 0 0 0 14 14 14 14 14 14 14 14 14 14 14 0 0 0 0
0 0 0 14 14 14 14 14 14 14 14 14 14 14 14 14 0 0 0
0 0 0 14 14 8 8 14 14 14 14 14 18 18 14 14 0 0 0
0 0 0 14 8 8 18 18 18 18 18 18 18 18 18 14 0 0 0
0 0 14 8 18 18 15 15 15 15 15 15 15 18 18 18 14 0 0
0 14 8 18 15 15 15 18 18 15 18 18 15 15 15 18 18 14 0
14 14 18 15 15 18 18 18 18 18 18 18 18 18 15 15 18 14 14
14 18 9 15 18 15 18 18 18 8 18 18 18 15 18 15 18 18 14
14 18 15 15 18 18 18 18 18 8 18 18 18 18 18 15 15 18 14
14 18 15 18 18 18 18 18 18 8 18 18 18 18 18 18 15 18 14
14 18 15 18 8 18 18 18 18 8 8 8 18 18 8 18 15 18 14
14 18 2 18 18 18 18 18 18 18 18 18 18 18 18 18 2 18 14
14 18 2 2 18 18 18 18 18 18 18 18 18 18 18 2 2 14 14
14 18 18 2 18 2 18 18 18 18 18 18 18 2 18 2 18 14 14
14 14 18 2 2 18 18 18 18 18 18 18 18 18 2 2 18 14 14
0 14 18 18 2 2 2 18 18 2 18 18 2 2 2 18 14 14 0
0 0 14 18 18 18 2 2 2 2 2 2 2 18 18 14 14 0 0
0 0 0 14 9 18 18 18 18 18 18 18 18 18 14 14 0 0 0
0 0 0 19 19 9 9 14 14 14 14 14 14 14 19 19 0 0 0
0 0 0 19 15 19 19 15 15 15 15 15 19 19 15 19 0 0 0
0 0 0 0 19 15 15 15 15 15 15 15 15 15 19 0 0 0 0
0 0 0 0 0 19 19 19 19 19 19 19 19 19 0 0 0 0 0
