0 0 0 0 0 0 18 18 18 18 18 18 0 0 0 0 0 0
0 0 0 0 18 18 1 1 1 1 1 1 18 18 0 0 0 0
0 0 18 18 1 1 1 1 1 1 1 1 6 6 18 18 0 0
0 0 18 1 1 1 1 1 1 1 1 1 6 6 6 18 18 0
0 18 5 6 1 1 1 1 1 6 1 6 6 6 6 6 18 0
0 18 6 6 6 6 1 1 1 1 6 6 6 6 6 6 18 18
18 5 6 6 6 6 1 1 1 1 6 6 6 6 6 6 6 18
18 5 6 6 6 1 1 1 1 1 1 1 6 6 6 6 6 18
18 5 6 6 1 1 1 1 1 1 6 6 6 6 6 6 6 18
18 5 6 4 1 1 1 1 1 1 6 6 6 6 6 4 6 18
18 4 5 6 6 6 1 1 1 1 1 6 6 6 6 6 5 18
18 4 5 6 6 6 1 1 1 1 1 6 6 6 6 5 4 18
0 18 5 5 6 6 6 1 1 1 1 1 6 6 6 5 4 18
0 18 5 5 5 5 5 1 1 1 1 1 1 6 5 4 18 0
0 0 18 4 5 5 4 1 1 1 1 1 1 5 4 4 18 0
0 0 18 4 4 5 4 4 1 1 1 1 4 4 4 18 0 0
0 0 0 18 18 4 4 4 4 4 4 4 4 18 18 0 0 0
0 0 0 0 0 18 18 18 18 18 18 18 18 0 0 0 0 0
---
0 0 0 0 0 0 6 6 6 6 6 6 0 0 0 0 0 0
0 0 0 0 6 6 4 4 4 4 4 4 6 6 0 0 0 0
0 0 6 6 4 4 4 4 4 4 4 4 1 1 6 6 0 0
0 0 6 4 4 4 4 4 4 4 4 4 1 1 1 6 6 0
0 6 18 18 4 4 5 5 5 1 4 1 1 1 1 1 6 0
0 6 18 18 18 18 5 5 5 5 1 1 1 1 1 1 6 6
6 18 18 18 18 18 5 5 5 5 1 1 1 1 1 1 1 6
6 18 18 18 18 5 5 5 5 5 5 5 1 1 1 1 1 6
6 18 18 18 5 5 5 5 6 6 1 1 1 1 1 1 1 6
6 18 18 18 6 6 6 6 6 6 1 1 1 1 1 1 1 6
6 18 18 18 18 18 6 6 6 6 6 1 1 1 1 1 1 6
6 18 18 18 18 18 6 6 6 6 6 1 1 1 1 1 1 6
0 6 18 18 18 18 18 18 6 6 6 6 1 1 1 1 1 6
0 6 18 18 18 18 18 18 18 18 18 6 6 1 1 1 6 0
0 0 6 1 18 18 1 18 18 18 1 1 6 1 1 1 6 0
0 0 6 1 1 18 1 1 18 18 1 1 1 1 1 6 0 0
0 0 0 6 6 1 1 1 1 1 1 1 1 6 6 0 0 0
0 0 0 0 0 6 6 6 6 6 6 6 6 0 0 0 0 0
