0 0 0 0 0 0 16 16 16 16 16 16 0 0 0 0 0 0
0 0 0 0 16 16 9 9 9 9 9 9 16 16 0 0 0 0
0 0 0 16 9 9 8 9 9 9 8 9 9 9 16 0 0 0
0 0 16 9 9 9 9 9 9 9 9 9 9 9 9 16 0 0
0 16 9 9 8 9 9 9 9 8 9 9 8 9 9 9 16 0
0 16 9 9 9 9 9 9 9 9 9 9 9 9 9 9 16 0
0 16 9 9 9 9 9 9 9 9 9 9 9 9 9 9 16 0
16 5 16 16 16 16 16 16 16 16 16 16 16 16 16 16 5 16
16 5 5 5 5 5 5 5 5 5 5 5 5 5 5 5 5 16
0 16 5 5 16 16 5 5 16 16 5 5 16 16 5 5 16 0
0 0 16 16 16 13 16 16 13 13 16 16 13 16 16 16 0 0
0 16 15 15 15 15 15 15 15 15 15 15 15 15 15 15 16 0
0 16 16 16 15 15 15 15 15 15 15 15 15 15 16 16 16 0
16 12 12 12 16 16 16 16 16 16 16 16 16 16 12 12 12 16
16 12 12 12 12 12 12 12 12 12 12 12 12 12 12 12 12 16
0 16 16 16 16 16 16 16 16 16 16 16 16 16 16 16 16 0
0 16 9 9 9 9 9 9 9 9 9 9 9 9 9 9 16 0
0 0 16 16 16 16 16 16 16 16 16 16 16 16 16 16 0 0
---
0 0 0 0 0 0 9 9 5 5 5 5 0 0 0 0 0 0
0 0 0 0 9 9 16 16 16 16 16 16 5 5 0 0 0 0
0 0 0 9 16 16 16 16 16 16 16 16 16 16 5 0 0 0
0 0 9 16 16 16 16 16 16 16 16 16 16 16 16 5 0 0
0 9 16 16 16 16 16 16 16 16 16 16 16 16 16 16 5 0
0 9 16 16 16 16 16 16 16 16 16 16 16 16 16 16 5 0
0 9 16 16 16 16 16 16 16 16 16 16 16 16 16 16 5 0
9 12 9 9 9 9 9 9 9 9 9 15 15 15 15 15 15 5
9 12 12 12 12 12 12 12 12 12 12 12 12 12 12 15 15 5
0 9 12 12 9 9 12 12 9 9 12 12 5 5 12 15 5 0
0 0 9 9 9 8 9 9 8 8 9 9 8 5 5 5 0 0
0 9 16 16 16 16 16 16 16 16 16 16 16 16 16 16 5 0
0 9 9 9 16 16 16 16 16 16 16 16 16 16 5 5 5 0
9 16 16 16 9 9 9 9 9 9 9 9 9 9 15 15 15 5
9 16 16 16 16 16 16 16 16 16 16 16 16 16 15 15 15 5
0 9 9 9 9 9 9 9 9 9 9 9 9 9 9 9 5 0
0 9 13 13 13 13 8 15 15 15 15 15 15 15 15 15 9 0
0 0 9 9 9 9 9 9 9 9 9 9 9 9 9 9 0 0
