0 0 0 0 0 0 16 16 16 0 0 0 0 0 0 0
0 0 0 0 16 16 16 16 16 16 0 0 0 0 0 0
0 0 0 0 0 0 16 16 15 15 16 0 0 0 0 0
0 0 0 0 0 16 15 15 15 15 15 16 0 0 0 0
0 0 0 0 16 15 15 15 15 15 15 15 16 0 0 0
0 0 0 16 15 13 13 15 15 15 15 15 15 13 13 0
0 0 0 16 15 15 15 13 13 15 15 13 13 16 0 0
0 0 16 15 15 15 14 14 16 15 15 14 16 15 16 0
16 0 16 15 15 15 15 14 14 9 9 9 9 9 16 0
0 16 15 15 15 15 15 15 15 9 9 9 15 15 15 16
16 0 16 16 15 14 14 14 14 14 14 14 14 14 16 0
0 0 0 0 16 16 16 16 16 16 16 16 16 16 0 0
---
0 0 0 0 0 0 14 14 14 0 0 0 0 0 0 0
0 0 0 0 14 14 14 14 14 14 0 0 0 0 0 0
0 0 0 0 0 0 14 14 16 16 14 0 0 0 0 0
0 0 0 0 0 15 16 16 16 16 16 14 0 0 0 0
0 0 0 0 15 16 16 16 16 16 16 16 14 0 0 0
0 0 0 15 16 15 15 16 16 16 16 16 16 15 15 0
0 0 0 15 16 16 16 15 15 16 16 15 15 15 0 0
0 0 15 16 16 16 16 16 9 16 16 9 15 9 15 0
9 0 9 16 16 16 16 16 16 15 15 15 15 15 15 0
0 9 13 13 13 13 13 13 13 15 15 15 16 16 16 15
9 0 9 15 13 15 15 15 15 15 15 15 15 15 15 0
0 0 0 0 15 15 15 15 15 15 15 15 15 15 0 0
