0 0 0 0 0 0 18 18 0 0 0 0 0 0 0 0 0 0
0 0 0 0 0 0 18 14 18 18 18 18 0 0 0 0 0 0
0 0 0 0 0 18 14 14 1 15 15 15 18 18 0 0 0 0
0 0 0 0 18 15 1 1 1 3 1 1 15 15 18 0 0 0
0 0 0 18 15 15 1 1 1 14 1 1 1 15 15 18 0 0
0 0 0 18 15 1 14 1 1 14 1 1 14 1 15 18 0 0
0 0 18 15 1 1 1 14 3 14 3 14 1 1 1 15 18 0
0 0 18 15 1 1 1 3 14 14 14 3 1 1 1 15 18 0
0 0 18 15 3 14 14 14 14 14 14 14 14 14 3 15 18 0
0 0 18 15 1 1 1 3 14 14 14 3 1 1 1 1 18 0
0 0 18 15 1 1 1 14 3 14 3 14 1 1 1 14 14 18
0 0 0 18 9 9 15 1 1 14 1 1 1 1 1 14 18 18
0 0 18 15 13 14 9 1 1 14 1 1 1 15 15 18 0 0
0 0 18 15 13 13 9 1 1 3 1 1 15 15 18 0 0 0
0 18 11 15 15 15 18 15 15 15 15 15 18 18 0 0 0 0
18 11 15 11 11 18 0 18 18 18 18 18 0 0 0 0 0 0
18 15 11 11 15 18 0 0 0 0 0 0 0 0 0 0 0 0
0 18 18 0 18 18 0 0 0 0 0 0 0 0 0 0 0 0
---
0 0 0 0 0 0 1 1 0 0 0 0 0 0 0 0 0 0
0 0 0 0 0 0 1 3 1 1 1 1 0 0 0 0 0 0
0 0 0 0 0 1 3 3 14 14 14 14 1 1 0 0 0 0
0 0 0 0 1 3 14 14 14 9 18 18 14 14 1 0 0 0
0 0 0 1 3 3 14 14 14 18 18 18 18 14 14 1 0 0
0 0 0 1 3 14 18 14 14 18 18 18 18 18 14 1 0 0
0 0 1 3 14 14 14 18 14 18 9 18 18 18 18 14 1 0
0 0 1 3 14 14 14 14 18 18 18 9 18 18 18 14 1 0
0 0 1 3 15 18 18 18 18 18 18 18 18 18 9 14 1 0
0 0 1 3 15 15 15 15 18 18 18 14 15 15 15 15 1 0
0 0 1 3 15 15 15 18 15 18 14 18 15 15 15 13 13 1
0 0 0 1 11 11 11 15 15 18 15 15 15 15 15 13 1 1
0 0 1 1 14 11 11 15 15 18 15 15 15 18 18 1 0 0
0 0 1 1 14 14 11 15 15 1 15 15 18 18 1 0 0 0
0 1 15 1 1 1 1 18 18 18 18 18 1 1 0 0 0 0
1 15 1 15 15 1 0 1 1 1 1 1 0 0 0 0 0 0
1 1 15 15 1 1 0 0 0 0 0 0 0 0 0 0 0 0
0 1 1 0 1 1 0 0 0 0 0 0 0 0 0 0 0 0
