0 0 18 18 18 18 18 18 18 18 18 18 18 18 18 18 0 0 0 0
0 18 7 7 7 7 7 7 7 7 7 7 7 7 18 10 18 0 0 0
0 18 7 7 7 7 7 7 7 7 7 7 7 7 18 10 10 18 0 0
0 18 7 7 7 7 7 7 7 7 7 7 7 7 18 10 10 10 18 0
0 18 7 7 7 7 7 7 7 7 7 7 7 7 18 10 10 10 10 18
0 0 18 18 18 18 18 18 18 18 18 18 18 18 10 18 10 10 10 18
0 0 18 3 3 3 3 3 3 3 3 3 3 18 18 10 18 10 10 18
0 0 0 18 3 4 4 4 4 4 4 4 3 3 18 10 10 18 18 18
0 0 0 18 3 4 14 14 14 14 14 14 3 3 18 10 10 10 10 18
0 0 0 18 3 4 14 10 10 14 10 10 3 3 18 10 10 10 10 18
0 0 0 18 3 4 14 14 10 10 10 14 3 3 18 10 10 10 10 18
0 0 0 18 3 4 14 14 14 10 14 14 3 3 18 10 10 10 10 18
0 0 0 18 9 9 3 3 3 3 3 3 3 3 18 10 10 10 10 18
0 0 0 9 8 9 9 18 18 18 18 18 18 18 18 10 10 10 10 18
0 0 18 9 9 9 9 7 7 7 7 7 7 18 10 10 10 10 10 18
0 18 7 7 18 18 7 7 8 8 9 7 18 10 10 10 10 10 10 18
18 7 7 18 18 18 18 7 9 9 9 7 18 10 10 10 10 10 10 18
18 7 7 7 7 7 7 7 7 7 7 7 18 10 10 10 10 10 10 18
0 18 18 18 18 18 18 18 18 18 18 18 18 18 10 10 10 10 10 18
0 0 18 3 3 3 3 3 3 3 3 3 3 3 18 10 10 10 10 18
0 0 18 3 3 3 3 3 3 3 3 3 3 3 18 10 10 10 10 18
0 0 18 3 3 3 3 3 3 3 3 3 3 3 18 10 10 10 10 18
0 0 18 3 3 3 3 3 3 3 3 3 3 3 18 10 10 10 10 18
0 0 0 18 18 18 18 18 18 18 18 18 18 18 18 18 18 18 18 0
---
0 0 10 10 10 10 10 10 10 10 10 10 10 10 10 10 0 0 0 0
0 10 9 9 9 9 4 4 10 10 10 18 18 18 10 18 10 0 0 0
0 10 9 9 9 4 4 4 10 10 10 18 18 18 10 18 18 10 0 0
0 10 9 9 9 4 4 4 10 10 8 8 8 18 10 18 18 18 10 0
0 10 9 9 9 4 4 4 14 14 14 14 14 14 10 18 18 18 18 10
0 0 10 10 10 10 10 10 10 10 10 10 10 10 3 10 18 18 18 10
0 0 10 18 18 18 18 18 18 18 18 18 18 7 7 3 10 18 18 10
0 0 0 10 18 18 18 18 18 18 18 18 18 18 7 3 3 10 10 10
0 0 0 10 18 18 18 18 18 18 18 18 18 18 7 3 3 3 3 10
0 0 0 10 18 18 18 18 18 18 18 18 18 18 7 3 3 3 3 10
0 0 0 10 18 18 18 18 18 18 18 18 18 18 7 3 3 3 3 10
0 0 0 10 18 18 18 18 18 18 18 18 18 18 7 3 3 3 3 10
0 0 0 10 14 14 18 18 18 18 18 18 18 18 7 3 3 3 3 10
0 0 0 14 14 14 14 7 7 7 7 7 7 7 7 3 3 3 3 10
0 0 7 14 14 14 14 3 3 3 3 3 3 7 3 3 3 3 3 10
0 7 3 3 3 3 3 3 3 3 3 3 7 3 3 3 3 3 3 10
7 3 3 3 3 3 3 3 3 3 3 3 7 7 7 7 7 7 7 10
7 3 3 3 3 3 3 3 3 3 3 3 7 7 7 7 7 7 7 10
0 7 7 7 7 7 7 7 7 7 7 7 7 7 7 7 7 7 7 10
0 0 10 18 18 18 18 18 18 18 18 18 18 18 7 7 7 7 7 10
0 0 10 18 18 18 18 18 18 18 18 18 18 18 7 7 7 7 7 10
0 0 10 18 18 18 18 18 18 18 18 18 18 18 7 7 7 7 7 10
0 0 10 18 18 18 18 18 18 18 18 18 18 18 7 7 7 7 7 10
0 0 0 10 10 10 10 10 10 10 10 10 10 10 10 10 10 10 10 0
