0 0 18 18 18 18 18 0 0 0 0 0 0 0 0 0 0 0 0 0
0 18 5 6 6 6 6 18 0 0 0 0 0 0 0 0 0 0 0 0
0 18 5 6 6 6 6 6 18 0 18 18 0 0 0 0 0 0 0 0
0 18 5 6 6 5 6 6 6 18 9 9 18 0 0 0 0 0 0 0
0 0 18 5 6 6 5 6 6 9 9 9 18 0 0 0 0 0 0 0
0 0 0 18 5 6 6 5 6 9 9 18 18 18 18 18 0 0 0 0
0 0 0 18 1 5 5 6 5 9 9 16 16 1 1 1 18 0 0 0
0 0 18 1 1 1 1 5 5 16 16 16 3 3 3 3 1 18 0 0
0 18 1 1 1 3 3 3 1 1 1 3 3 3 3 14 14 1 18 0
18 1 1 1 3 3 3 3 3 3 1 3 3 3 3 14 14 3 1 18
18 1 1 1 3 3 3 3 3 3 3 3 3 3 14 3 3 3 3 18
18 1 1 1 3 3 3 3 3 3 3 3 3 3 3 3 3 3 3 18
18 1 1 1 3 3 3 18 3 3 3 3 3 18 3 3 3 3 3 18
18 1 1 1 10 10 14 3 3 3 3 3 3 3 14 10 10 3 3 18
18 1 1 10 10 10 10 10 3 18 3 18 3 10 10 10 10 10 3 18
18 1 1 1 10 10 10 3 3 3 18 3 3 3 10 10 10 3 3 18
0 18 1 1 1 3 3 3 3 3 3 3 3 3 3 3 3 3 18 0
0 18 9 1 1 1 3 3 3 3 3 3 3 3 3 3 3 15 18 0
0 0 18 9 9 1 1 1 3 3 3 3 3 3 3 15 15 18 0 0
0 0 0 18 9 9 9 9 9 9 15 15 15 15 15 15 18 0 0 0
0 0 0 0 18 18 9 9 9 18 18 9 9 9 18 18 0 0 0 0
0 0 0 0 0 0 18 18 18 0 0 18 18 18 0 0 0 0 0 0
---
0 0 3 3 3 3 3 0 0 0 0 0 0 0 0 0 0 0 0 0
0 3 3 9 9 9 9 3 0 0 0 0 0 0 0 0 0 0 0 0
0 3 3 9 9 9 9 9 3 0 3 3 0 0 0 0 0 0 0 0
0 3 3 9 9 3 9 9 9 3 15 15 3 0 0 0 0 0 0 0
0 0 3 3 9 9 3 9 9 15 15 15 3 0 0 0 0 0 0 0
0 0 0 3 3 9 9 3 9 15 15 3 3 3 3 3 0 0 0 0
0 0 0 3 3 3 3 9 3 15 15 14 14 10 10 10 3 0 0 0
0 0 3 3 3 3 3 3 3 14 14 14 18 1 1 1 10 3 0 0
0 3 3 3 3 18 18 18 3 3 3 18 18 1 1 16 16 10 3 0
3 3 3 3 18 18 18 18 18 18 3 18 18 1 1 16 16 6 10 3
3 3 3 3 18 18 18 18 18 18 18 18 18 1 16 1 1 6 6 3
3 3 3 3 18 18 18 18 18 18 18 18 18 1 1 1 1 6 6 3
3 3 3 3 18 18 18 14 18 18 18 18 1 1 1 1 1 6 6 3
3 3 3 3 1 1 9 18 18 18 18 18 1 1 9 5 5 6 6 3
3 3 3 1 1 1 1 1 18 5 18 5 1 5 5 5 5 5 6 3
3 3 3 3 1 1 1 18 18 18 5 18 1 1 5 5 5 6 6 3
0 3 3 3 3 18 18 18 18 18 18 18 1 1 1 1 1 6 3 0
0 3 10 3 3 3 18 18 18 18 18 18 1 1 1 1 1 6 3 0
0 0 3 10 10 3 3 3 18 18 18 18 1 1 1 6 6 3 0 0
0 0 0 3 10 10 10 10 10 10 6 6 6 6 6 6 3 0 0 0
0 0 0 0 3 3 10 10 10 3 3 10 10 14 3 3 0 0 0 0
0 0 0 0 0 0 3 3 3 0 0 3 3 3 0 0 0 0 0 0
