0 0 0 0 0 0 0 0 0 0 0 0 0 0 0 0 0 0
0 0 0 0 0 0 0 0 16 16 16 0 0 0 0 0 0 0
0 0 0 0 0 0 0 16 5 5 16 0 0 0 0 0 0 0
0 0 0 0 0 0 0 16 5 5 16 0 0 0 0 0 0 0
0 0 0 16 16 16 16 16 5 5 16 16 16 16 16 0 0 0
0 0 16 16 15 15 9 2 16 16 2 15 15 9 16 16 0 0
0 16 15 15 9 9 2 9 9 9 9 2 9 9 9 9 16 0
0 16 9 9 9 16 9 9 9 9 9 9 16 9 9 9 16 0
16 2 9 9 16 16 16 9 9 9 9 16 16 16 9 9 2 16
16 2 9 9 16 16 16 9 9 9 9 16 16 16 9 9 2 16
16 2 9 16 16 16 16 16 9 9 16 16 16 16 16 9 2 16
16 2 9 9 9 9 9 9 9 9 9 9 9 9 9 9 2 16
16 2 16 16 16 9 16 16 9 9 16 16 9 16 16 16 2 16
16 2 9 16 16 16 16 16 16 16 16 16 16 16 16 9 2 16
0 16 2 9 16 16 9 16 16 16 16 9 16 16 9 2 16 0
0 16 2 2 9 9 9 9 9 9 9 9 9 9 2 2 16 0
0 0 16 16 2 2 2 2 2 2 2 2 2 2 16 16 0 0
0 0 0 16 16 16 16 16 16 16 16 16 16 16 16 0 0 0
---
0 0 0 0 0 0 0 0 0 0 0 0 0 0 0 0 0 0
0 0 0 0 0 0 0 0 9 9 9 0 0 0 0 0 0 0
0 0 0 0 0 0 0 9 16 16 9 0 0 0 0 0 0 0
0 0 0 0 0 0 0 9 16 16 9 0 0 0 0 0 0 0
0 0 0 9 9 9 9 9 16 16 9 9 9 9 9 0 0 0
0 0 9 9 16 16 16 16 9 9 16 16 16 16 9 9 0 0
0 9 16 16 15 15 16 16 16 16 16 16 16 16 16 16 9 0
0 9 16 15 15 16 15 16 16 16 16 16 15 16 16 16 9 0
9 16 16 16 16 16 16 16 16 16 16 5 5 5 16 16 16 9
9 16 16 16 16 16 16 16 16 16 16 5 5 5 16 16 16 9
9 16 16 16 16 16 16 16 16 16 9 9 9 9 9 16 16 9
9 16 16 16 16 16 16 16 16 16 16 16 16 16 16 16 16 9
9 16 9 9 9 16 9 9 16 16 2 2 16 2 2 2 16 9
9 16 2 9 9 9 9 9 2 2 2 2 2 2 2 2 16 9
0 9 16 2 9 9 2 9 9 2 2 2 2 2 2 16 9 0
0 9 16 16 2 2 2 2 2 2 2 2 2 2 16 16 9 0
0 0 9 9 16 16 16 16 16 16 16 16 16 16 9 9 0 0
0 0 0 9 9 9 9 9 9 9 9 9 9 9 9 0 0 0
