0 0 0 0 0 0 0 0 0 0 0 0 0 0 0 0 0 0
0 0 0 0 0 0 0 0 0 0 0 0 0 0 0 0 0 0
0 0 0 0 0 0 0 0 0 0 0 0 0 0 0 0 0 0
0 16 16 0 0 0 0 0 0 16 16 0 0 0 0 0 0 0
0 16 9 16 0 0 0 0 16 9 16 0 0 0 0 0 0 0
0 16 9 2 16 16 16 16 2 9 16 0 0 0 0 0 0 0
0 16 9 2 9 2 2 9 2 9 16 0 0 0 0 0 0 0
16 9 9 2 9 2 2 9 2 9 9 16 0 0 0 0 0 0
16 9 9 9 9 9 9 9 9 9 9 16 0 0 0 0 0 0
16 9 9 9 9 9 9 9 9 9 9 16 0 0 0 16 16 0
16 9 9 16 9 9 9 16 9 9 9 16 0 0 0 16 2 16
16 9 9 9 8 13 8 9 9 9 9 16 0 0 16 16 9 16
0 16 16 8 8 8 8 8 9 9 1 16 16 16 2 9 2 16
0 0 0 16 1 1 1 1 1 1 2 2 9 2 2 9 16 0
0 0 0 16 9 9 9 9 9 9 2 2 9 2 9 16 0 0
0 0 0 16 9 9 9 2 9 9 9 9 9 2 16 0 0 0
0 0 0 16 9 8 9 2 2 9 8 9 9 9 16 0 0 0
0 0 0 16 8 16 8 16 16 8 8 8 16 8 16 0 0 0
---
0 0 0 0 0 0 0 0 0 0 0 0 0 0 0 0 0 0
0 0 0 0 0 0 0 0 0 0 0 0 0 0 0 0 0 0
0 0 0 0 0 0 0 0 0 0 0 0 0 0 0 0 0 0
0 9 9 0 0 0 0 0 0 9 9 0 0 0 0 0 0 0
0 9 16 9 0 0 0 0 9 16 9 0 0 0 0 0 0 0
0 9 16 8 9 9 9 9 8 16 9 0 0 0 0 0 0 0
0 9 16 8 16 9 9 16 8 16 9 0 0 0 0 0 0 0
9 16 16 8 16 9 9 16 8 16 16 9 0 0 0 0 0 0
9 16 16 16 16 16 16 16 16 16 16 9 0 0 0 0 0 0
9 16 16 16 16 16 16 16 16 16 16 9 0 0 0 9 9 0
9 16 16 1 16 16 16 1 16 16 16 9 0 0 0 9 1 9
9 16 16 16 9 16 9 16 16 16 16 9 0 0 9 9 8 9
0 9 9 9 9 9 9 9 16 16 9 9 9 9 9 8 1 9
0 0 0 9 9 9 9 9 9 9 8 8 2 9 9 8 9 0
0 0 0 9 2 2 2 2 2 2 8 8 2 9 8 9 0 0
0 0 0 9 2 2 2 1 2 2 2 2 2 9 9 0 0 0
0 0 0 9 2 16 2 1 1 2 9 2 2 2 9 0 0 0
0 0 0 9 16 13 16 2 2 9 9 9 8 9 9 0 0 0
