0 0 0 0 9 0 9 0 0 9 0 9 9 0 0 0 0 0 0
0 0 0 0 15 9 15 0 9 15 9 15 9 15 0 0 0 0 0
0 0 0 0 15 15 15 9 15 15 15 15 15 15 0 0 0 0 0
0 0 0 18 13 13 15 15 15 15 15 13 13 7 18 18 0 0 0
0 0 18 18 18 13 13 13 13 18 18 18 18 13 13 7 18 0 0
0 18 13 14 14 18 13 13 18 14 14 14 14 18 13 7 18 0 0
0 18 14 14 12 12 13 13 12 12 12 14 14 14 13 13 7 18 0
0 18 14 12 9 9 13 13 9 9 12 12 14 14 13 13 7 18 0
0 18 14 14 12 12 13 13 12 12 12 14 14 14 13 13 13 7 18
0 18 13 14 14 14 13 13 14 14 14 14 14 13 13 13 13 7 18
0 18 13 13 13 13 13 13 13 13 13 13 13 13 13 13 13 7 18
18 13 13 18 14 14 14 14 14 14 18 13 13 13 13 13 13 7 18
18 13 13 18 18 18 18 18 18 18 18 18 13 13 13 13 13 7 18
18 13 18 18 18 10 10 10 10 10 18 18 18 13 13 13 13 7 18
18 13 18 18 18 18 18 18 10 10 10 18 18 13 13 13 13 7 18
18 13 18 14 14 14 14 14 14 14 14 14 18 13 13 13 13 7 18
0 18 13 13 13 13 13 13 13 13 13 13 13 13 7 13 7 18 0
0 0 18 18 18 18 18 18 18 18 18 18 18 18 18 18 18 0 0
---
0 0 0 0 13 0 13 0 0 13 0 13 13 0 0 0 0 0 0
0 0 0 0 13 13 13 0 13 13 13 13 13 13 0 0 0 0 0
0 0 0 0 13 13 13 13 13 13 13 13 13 13 0 0 0 0 0
0 0 0 13 18 18 13 13 13 13 13 7 7 13 14 14 0 0 0
0 0 13 13 13 18 18 18 18 13 13 13 13 7 7 12 14 0 0
0 13 14 9 9 13 18 18 13 13 13 13 13 13 7 12 14 0 0
0 14 9 9 9 18 18 18 18 18 18 13 13 13 7 7 12 14 0
0 14 9 9 18 18 18 18 15 15 18 18 13 13 7 7 12 14 0
0 14 9 9 9 9 18 18 18 18 18 13 13 13 7 7 7 12 14
0 14 18 9 9 9 18 18 13 13 13 13 13 10 7 7 7 12 14
0 14 18 18 18 18 18 18 18 18 10 10 10 10 10 10 10 12 14
14 18 18 13 13 13 13 13 13 13 13 18 18 18 18 18 18 12 14
14 18 18 13 13 13 13 13 13 13 13 13 18 18 18 18 18 12 14
14 18 13 13 13 15 15 15 15 15 13 13 13 18 18 18 18 12 14
14 18 13 13 13 13 13 13 15 15 15 13 13 18 18 18 18 12 14
14 18 13 15 15 15 15 15 15 15 15 15 13 18 18 18 18 12 14
0 14 18 18 18 18 18 18 18 18 18 18 18 18 18 18 12 14 0
0 0 14 14 14 14 14 14 14 14 14 14 14 14 14 14 14 0 0
