0 16 0 0 0 0 0 0 0 0 0 0 0 0
0 16 16 0 0 0 0 0 16 16 16 16 16 16
0 16 9 16 0 0 0 16 10 10 10 10 16 0
0 16 9 9 16 0 16 10 10 10 10 16 0 0
0 16 9 9 9 16 16 10 10 10 16 0 0 0
0 16 9 9 9 9 16 16 10 16 0 0 0 0
0 0 16 9 9 16 1 1 16 16 16 0 0 0
0 0 0 16 16 16 1 1 16 15 15 16 0 0
0 0 0 0 16 13 16 16 15 15 15 15 16 0
0 0 0 16 13 13 13 16 16 15 15 15 16 0
0 0 16 13 13 13 13 16 0 16 15 15 16 0
0 16 13 13 13 13 16 0 0 0 16 15 16 0
16 16 16 16 16 16 0 0 0 0 0 16 16 0
0 0 0 0 0 0 0 0 0 0 0 0 16 0
---
0 15 0 0 0 0 0 0 0 0 0 0 0 0
0 15 15 0 0 0 0 0 16 16 16 16 16 16
0 15 16 16 0 0 0 16 13 13 13 13 16 0
0 15 16 16 16 0 16 13 13 13 13 16 0 0
0 15 16 16 16 16 16 13 13 13 16 0 0 0
0 15 16 16 16 16 1 1 13 16 0 0 0 0
0 0 15 16 16 15 16 16 1 16 16 0 0 0
0 0 0 15 15 15 16 16 1 16 16 10 0 0
0 0 0 0 16 9 16 10 16 16 16 16 10 0
0 0 0 16 9 9 9 16 10 16 16 16 10 0
0 0 16 9 9 9 9 16 0 10 16 16 10 0
0 16 9 9 9 9 16 0 0 0 10 16 10 0
16 16 16 16 16 16 0 0 0 0 0 10 10 0
0 0 0 0 0 0 0 0 0 0 0 0 10 0
