0 0 0 0 0 0 0 13 16 16 16 16 16 0 0 0 0 0 0 0
0 0 0 0 0 0 13 13 13 5 5 15 5 16 0 0 0 0 0 0
0 0 0 16 16 16 5 13 5 5 5 5 5 5 16 16 16 0 0 0
0 0 16 6 6 17 5 5 5 5 5 5 5 5 17 6 6 16 0 0
0 0 16 6 6 17 5 5 5 5 5 5 15 5 13 6 6 16 0 0
0 0 13 6 6 17 5 15 5 5 5 5 5 13 13 13 6 16 0 0
0 13 13 13 17 5 5 5 5 5 5 5 5 5 13 17 6 6 16 0
0 16 13 6 17 5 5 5 5 5 5 5 5 15 5 17 6 6 16 0
0 16 6 6 17 15 5 5 13 5 5 5 5 5 5 17 6 6 13 0
0 16 6 6 17 5 5 13 13 13 5 15 5 5 5 17 6 13 13 13
0 16 6 6 17 17 5 5 13 5 5 5 5 5 17 17 6 6 13 0
0 0 16 6 6 17 5 15 5 5 5 5 5 15 17 6 6 16 0 0
0 0 16 6 6 17 17 5 5 5 5 5 5 17 17 6 6 16 0 0
16 16 16 16 16 16 16 16 16 16 16 16 16 16 16 16 16 16 16 16
16 9 9 9 9 9 9 9 9 9 9 9 9 9 9 9 9 9 9 16
16 9 9 9 9 9 9 9 9 9 9 9 9 9 9 9 9 9 9 16
0 16 16 16 16 16 16 16 16 16 16 16 16 16 16 16 16 16 16 0
0 0 16 2 2 2 2 2 2 2 2 2 2 2 2 2 2 16 0 0
0 0 16 2 2 2 2 2 2 2 2 2 2 2 2 2 2 16 0 0
0 0 0 16 2 2 2 2 2 2 2 2 2 2 2 2 16 0 0 0
0 0 0 16 2 2 2 2 2 2 2 2 2 2 2 2 16 0 0 0
0 0 0 16 16 16 2 2 2 2 2 2 2 2 16 16 16 0 0 0
0 0 0 0 0 16 16 16 16 16 16 16 16 16 16 0 0 0 0 0
---
0 0 0 0 0 0 0 15 2 2 2 2 2 0 0 0 0 0 0 0
0 0 0 0 0 0 15 15 15 16 16 2 16 2 0 0 0 0 0 0
0 0 0 13 13 13 16 15 16 16 16 16 16 16 2 2 2 0 0 0
0 0 13 2 2 16 16 16 16 16 16 16 16 16 2 13 13 2 0 0
0 0 13 2 2 6 16 16 16 16 16 16 13 16 17 13 13 2 0 0
0 0 17 2 2 6 16 16 16 16 16 16 16 17 17 17 13 2 0 0
0 17 17 17 6 16 16 16 16 16 16 16 16 16 17 16 13 13 2 0
0 5 17 17 6 16 16 16 16 16 16 16 16 17 16 16 13 13 2 0
0 5 17 17 6 2 16 16 15 16 16 16 16 16 16 16 13 13 5 0
0 5 17 17 6 16 16 5 15 15 16 2 16 16 16 16 13 5 5 5
0 5 17 17 6 6 16 16 5 16 16 16 16 16 16 16 13 13 5 0
0 0 5 17 17 6 16 5 16 16 16 16 16 13 16 13 13 5 0 0
0 0 5 17 17 6 6 16 16 16 16 16 16 16 16 13 13 5 0 0
5 5 5 5 5 5 5 5 5 5 5 5 5 5 5 5 5 5 5 5
5 2 2 2 2 2 2 2 2 2 2 2 2 2 2 2 2 2 2 5
5 2 2 2 2 2 2 2 2 2 2 2 2 2 2 2 2 2 2 5
0 5 5 5 5 5 5 5 5 5 5 5 5 5 5 5 5 5 5 0
0 0 5 6 6 6 6 6 9 9 9 9 9 9 9 9 9 5 0 0
0 0 5 6 6 6 6 6 6 9 9 9 9 9 9 9 9 5 0 0
0 0 0 5 6 6 6 6 6 9 9 9 9 9 9 9 5 0 0 0
0 0 0 5 6 6 6 6 6 9 9 9 9 9 9 9 5 0 0 0
0 0 0 5 5 5 6 6 6 9 9 9 9 9 5 5 5 0 0 0
0 0 0 0 0 5 5 5 5 5 5 5 5 5 5 0 0 0 0 0
