0 0 0 0 0 0 0 0 0 2 2 2 0 0 0 0 0 0 0 0 0
0 0 0 0 0 0 0 0 2 14 2 9 2 0 0 0 0 0 0 0 0
0 0 0 0 0 0 0 0 2 15 2 9 2 0 0 0 0 0 0 0 0
0 0 0 0 0 0 2 2 9 2 2 2 9 2 2 0 0 0 0 0 0
0 0 0 0 0 2 15 14 2 0 0 0 2 15 15 2 0 0 0 0 0
0 0 0 2 2 2 2 2 2 2 2 2 2 2 2 2 2 2 0 0 0
0 0 2 15 15 15 15 14 14 15 15 15 15 15 15 15 15 15 2 0 0
0 2 15 9 2 2 2 2 2 2 2 2 2 2 2 2 2 9 15 2 0
0 2 9 2 4 3 3 1 4 8 4 3 3 1 4 3 4 2 9 2 0
0 2 9 4 3 4 1 4 14 8 3 4 1 4 3 3 3 4 9 2 0
0 0 2 4 1 1 4 1 1 1 1 1 4 1 1 1 1 4 2 0 0
0 0 4 1 1 4 1 4 1 1 1 4 1 4 1 1 1 4 4 0 0
0 4 4 3 4 8 8 3 4 3 4 8 3 3 4 3 4 3 3 4 0
4 3 3 4 3 3 3 1 1 4 3 3 1 1 1 4 3 3 1 1 4
4 1 4 3 4 1 1 1 4 3 4 1 1 1 4 3 4 1 1 1 4
4 4 3 3 3 4 1 4 3 8 3 4 1 4 3 3 1 4 1 4 4
4 3 3 1 3 3 4 3 1 3 1 3 4 3 1 1 1 1 4 1 4
4 1 1 1 1 4 3 4 1 1 1 4 3 4 1 1 1 4 1 4 4
0 4 1 1 4 3 1 3 4 1 4 3 1 1 4 1 4 1 1 4 0
0 0 4 4 4 1 1 1 1 4 3 1 1 1 1 4 4 4 4 0 0
0 0 0 0 0 4 4 4 4 4 4 4 4 4 4 4 0 0 0 0 0
---
0 0 0 0 0 0 0 0 0 4 4 4 0 0 0 0 0 0 0 0 0
0 0 0 0 0 0 0 0 4 4 4 14 4 0 0 0 0 0 0 0 0
0 0 0 0 0 0 0 0 4 4 4 14 4 0 0 0 0 0 0 0 0
0 0 0 0 0 0 4 4 1 4 4 4 14 4 4 0 0 0 0 0 0
0 0 0 0 0 4 4 4 4 0 0 0 4 4 4 4 0 0 0 0 0
0 0 0 4 4 4 4 4 4 4 4 4 4 4 4 4 4 4 0 0 0
0 0 4 1 1 1 1 15 15 9 9 9 9 9 9 9 9 9 4 0 0
0 4 1 3 4 4 4 4 4 4 4 4 4 4 4 4 4 3 9 4 0
0 4 3 4 2 8 8 4 2 14 2 8 8 4 2 15 1 4 3 4 0
0 4 3 2 8 2 4 2 1 14 8 2 4 2 15 15 15 1 3 4 0
0 0 4 2 4 4 2 4 4 4 4 4 2 4 4 4 4 1 4 0 0
0 0 2 4 4 2 4 2 4 4 4 2 4 2 4 4 4 1 1 0 0
0 2 2 1 2 1 1 1 2 1 2 1 1 1 1 1 1 1 1 1 0
2 1 1 2 1 1 1 15 15 2 1 1 3 3 3 1 1 1 3 3 1
2 3 2 1 2 15 15 15 2 1 2 3 3 3 1 1 3 3 3 3 1
2 2 1 1 1 2 15 2 1 1 1 2 3 1 1 1 3 1 3 1 1
2 1 1 15 1 1 2 1 3 1 3 1 2 1 3 3 3 3 1 3 1
2 15 15 15 15 2 1 2 3 3 3 2 1 2 3 3 3 1 3 1 1
0 2 15 15 2 1 3 1 2 3 2 1 3 3 1 3 1 3 3 1 0
0 0 2 2 2 3 3 3 3 2 1 3 3 3 3 1 1 1 1 0 0
0 0 0 0 0 2 2 2 2 2 2 2 2 2 1 1 0 0 0 0 0
