0 0 0 0 0 0 18 18 18 18 18 18 0 0 0 0 0 0
0 0 0 0 18 18 14 14 14 14 14 14 18 18 0 0 0 0
0 0 18 18 14 14 1 1 1 1 1 1 14 14 18 18 0 0
0 0 18 14 1 1 1 1 1 3 1 1 1 1 14 18 18 0
0 18 14 1 4 1 4 1 3 14 3 3 1 1 1 14 18 0
0 18 14 4 4 4 1 1 1 3 14 3 1 1 1 14 18 18
18 14 1 4 4 4 1 1 4 4 3 3 4 1 1 1 14 18
18 14 1 4 4 4 1 1 1 4 4 3 3 1 1 1 14 18
18 14 1 4 4 4 1 1 1 1 4 4 3 4 4 1 14 18
18 14 1 4 4 4 4 1 1 1 1 1 1 4 1 1 14 18
18 14 1 4 4 1 1 4 1 1 1 4 4 1 1 4 14 18
18 14 1 4 4 4 4 4 4 1 1 4 4 4 1 1 14 18
0 18 14 1 4 4 4 4 4 4 4 4 4 4 4 1 14 18
0 18 14 1 1 4 4 4 4 4 4 4 4 4 1 14 18 0
0 0 18 14 1 1 4 4 4 4 4 4 1 1 1 14 18 0
0 0 18 14 14 1 1 1 1 1 1 1 1 14 14 18 0 0
0 0 0 18 18 14 14 14 14 14 14 14 14 18 18 0 0 0
0 0 0 0 0 18 18 18 18 18 18 18 18 0 0 0 0 0
---
0 0 0 0 0 0 14 14 14 14 14 14 0 0 0 0 0 0
0 0 0 0 14 14 18 18 18 18 18 18 14 14 0 0 0 0
0 0 14 14 18 18 4 4 4 4 4 4 18 18 14 14 0 0
0 0 14 18 4 4 4 4 4 1 4 4 4 4 18 14 14 0
0 14 18 4 1 4 1 4 1 18 1 1 4 4 4 18 14 0
0 14 18 1 1 1 4 4 4 1 18 1 4 4 4 18 14 14
14 18 4 1 1 1 4 4 1 1 1 1 1 4 4 4 18 14
14 18 4 1 1 1 4 4 4 1 1 1 1 4 4 4 18 14
14 18 4 1 1 1 4 4 4 4 1 1 1 1 1 4 18 14
14 18 4 1 1 1 1 4 4 4 4 4 4 1 4 4 18 14
14 18 4 1 1 4 4 1 4 4 4 1 1 18 18 1 18 14
14 18 4 1 1 1 1 1 1 4 4 1 1 1 18 18 18 14
0 14 18 4 1 1 1 1 1 1 1 1 1 1 1 18 18 14
0 14 18 4 4 1 1 1 1 1 1 1 1 1 18 18 14 0
0 0 14 18 4 4 1 1 1 1 1 1 3 3 3 18 14 0
0 0 14 18 18 3 3 3 3 3 3 3 3 18 18 14 0 0
0 0 0 14 14 18 18 18 18 18 18 18 18 14 14 0 0 0
0 0 0 0 0 14 1 1 1 1 1 1 14 0 0 0 0 0
