0 0 0 0 18 18 18 18 18 18 0 0 0 0
0 0 18 18 13 13 9 9 9 13 18 18 0 0
0 18 13 13 9 9 9 9 15 15 9 13 18 0
0 18 13 13 9 9 9 9 15 15 9 13 18 0
18 13 13 13 13 9 9 9 9 9 9 9 13 18
18 13 13 13 13 9 9 9 9 9 9 9 13 18
18 13 13 13 13 13 13 13 9 9 9 13 13 18
18 18 13 13 13 13 13 18 18 13 13 13 18 18
18 14 18 18 13 13 18 14 14 18 18 18 14 18
0 18 14 14 18 18 18 14 14 18 14 14 18 0
0 18 14 14 14 14 14 18 18 14 14 14 18 0
0 0 18 18 14 14 14 14 14 14 18 18 0 0
0 0 0 0 18 18 18 18 18 18 0 0 0 0
---
0 0 0 0 13 13 13 13 13 13 0 0 0 0
0 0 13 13 18 18 14 14 14 14 9 9 0 0
0 13 18 18 14 14 14 14 14 14 13 14 9 0
0 13 18 18 14 14 14 15 14 14 13 14 9 0
13 18 18 18 18 18 15 15 13 13 13 13 14 9
13 18 18 18 18 18 15 13 13 13 13 13 14 9
13 18 18 18 18 18 18 18 13 13 13 14 14 9
13 13 18 18 18 18 18 9 9 14 14 14 9 9
13 18 13 13 18 18 9 18 18 9 9 9 18 9
0 13 18 18 9 9 9 18 18 9 18 18 9 0
0 13 18 18 18 18 18 9 9 18 18 18 9 0
0 0 13 13 18 18 18 18 18 18 9 9 0 0
0 0 0 0 13 13 9 9 9 9 0 0 0 0
