0 0 0 0 0 16 16 0 0 0 0 0 0 0 0
0 0 0 0 16 14 9 16 0 0 0 0 16 0 0
0 0 0 0 16 13 14 9 16 0 16 16 14 16 0
0 0 0 0 16 13 14 9 9 16 9 14 9 16 0
0 0 0 0 16 13 9 14 9 9 14 9 9 16 0
0 0 16 16 13 9 9 9 14 9 14 9 13 16 0
0 16 14 14 9 9 9 9 9 14 9 9 16 0 0
16 13 9 9 9 14 14 9 14 9 14 9 9 16 0
0 16 13 13 9 9 9 14 9 9 9 14 14 9 16
0 0 16 16 16 13 9 14 9 9 13 13 13 14 16
0 0 0 0 16 16 13 14 9 13 16 16 16 16 0
0 0 0 0 0 16 14 9 13 16 16 0 0 0 0
0 0 0 0 0 16 13 13 16 0 0 0 0 0 0
0 0 0 0 0 0 16 16 0 0 0 0 0 0 0
---
0 0 0 0 0 9 9 0 0 0 0 0 0 0 0
0 0 0 0 9 9 14 9 0 0 0 0 14 0 0
0 0 0 0 13 9 9 16 14 0 14 14 9 14 0
0 0 0 0 13 9 9 16 16 14 16 9 16 14 0
0 0 0 0 13 9 16 9 16 16 9 16 16 14 0
0 0 13 13 9 16 16 16 9 16 9 16 9 14 0
0 13 13 13 16 16 16 16 16 9 16 16 14 0 0
13 9 16 16 16 9 9 16 9 16 9 16 16 14 0
0 13 9 9 16 16 16 9 16 16 16 9 9 16 14
0 0 13 13 13 9 16 9 16 16 9 9 9 9 14
0 0 0 0 13 13 9 9 16 9 14 14 14 14 0
0 0 0 0 0 13 9 16 9 14 14 0 0 0 0
0 0 0 0 0 13 9 9 14 0 0 0 0 0 0
0 0 0 0 0 0 14 14 0 0 0 0 0 0 0
