0 0 16 16 16 16 16 0 0 0 0 0 0 0 16 16 16 16 16 0 0 0 0 0
0 16 14 14 14 14 10 16 16 0 0 0 0 16 14 14 14 14 10 16 0 0 0 0
16 14 10 10 10 10 10 10 10 16 0 0 16 14 14 10 10 10 10 10 16 0 0 0
16 12 10 10 10 10 10 10 10 10 16 16 10 10 10 10 10 10 10 10 16 0 0 0
16 12 12 12 12 10 10 10 10 10 10 16 14 10 10 10 10 10 10 10 16 0 0 0
0 16 12 1 1 12 1 1 10 10 10 16 10 10 10 10 10 10 12 10 16 0 0 0
0 0 1 3 3 1 3 3 1 10 10 16 10 10 10 10 10 16 12 10 16 0 0 0
0 0 1 3 3 15 3 3 1 10 10 10 16 10 10 10 16 12 12 10 16 0 0 0
0 0 1 1 15 15 15 1 10 10 10 10 10 16 16 16 12 12 10 10 10 16 0 0
0 16 1 3 3 15 3 3 1 10 10 10 10 10 12 12 12 10 10 10 10 10 16 0
16 12 1 3 3 1 3 3 1 10 10 10 10 10 10 10 10 10 10 10 10 10 12 16
16 10 12 1 1 12 1 1 1 16 16 16 16 16 16 16 16 16 10 10 10 10 12 16
16 10 12 12 12 16 7 7 7 7 7 7 7 7 7 7 7 7 16 10 10 10 12 16
16 10 10 12 16 7 14 14 14 14 14 14 14 14 14 14 14 14 7 16 12 10 12 16
16 10 10 16 7 14 14 14 14 14 14 14 14 14 14 14 14 14 14 7 16 12 12 16
16 10 10 16 14 14 16 16 14 14 14 14 14 14 14 14 16 16 14 14 16 12 12 16
16 10 10 16 14 14 16 16 14 14 14 14 14 14 14 14 16 16 14 14 16 12 12 16
16 12 10 16 14 14 16 16 14 14 14 9 9 14 14 14 16 16 14 14 16 12 12 16
0 16 12 16 7 14 14 14 14 14 14 14 14 14 14 14 14 14 14 7 16 12 16 0
0 0 16 12 16 7 14 14 14 14 14 14 14 14 14 14 14 14 7 16 12 16 0 0
0 0 0 16 16 16 16 16 16 16 16 16 16 16 16 16 16 16 16 16 16 0 0 0
0 0 0 0 0 16 10 10 12 12 16 0 0 16 10 10 10 12 16 0 0 0 0 0
0 0 0 0 0 16 16 12 12 16 0 0 0 0 16 12 12 16 16 0 0 0 0 0
0 0 0 0 16 0 16 16 16 0 0 0 0 0 0 16 16 16 0 16 0 0 0 0
---
0 0 10 10 10 10 10 0 0 0 0 0 0 0 10 10 10 10 10 0 0 0 0 0
0 10 7 7 7 7 7 10 10 0 0 0 0 10 1 1 1 1 16 10 0 0 0 0
10 7 16 16 16 16 16 16 16 10 0 0 10 1 1 16 16 16 16 16 10 0 0 0
10 14 16 16 16 16 16 16 16 16 10 10 16 16 16 16 16 16 16 16 10 0 0 0
10 14 14 14 14 16 16 16 16 16 16 10 7 16 16 16 16 16 16 16 10 0 0 0
0 10 14 14 14 14 14 14 16 16 16 10 16 16 16 16 16 16 14 16 10 0 0 0
0 0 14 1 1 14 7 7 14 16 16 10 16 16 16 16 16 10 14 16 10 0 0 0
0 0 14 1 1 16 7 7 14 16 16 16 10 16 16 16 10 14 14 16 10 0 0 0
0 0 14 14 16 16 16 14 16 16 16 16 16 10 10 10 14 14 16 16 16 10 0 0
0 14 14 14 14 16 16 16 14 16 16 16 16 16 14 14 14 16 16 16 16 16 10 0
14 1 14 14 14 14 16 16 14 16 16 16 16 16 16 16 16 16 16 16 16 16 16 10
14 14 1 14 14 1 14 14 14 10 10 10 10 10 10 10 10 10 16 16 16 16 16 10
14 14 1 1 1 14 3 3 3 3 3 3 3 3 3 3 3 3 10 16 16 16 16 10
14 14 14 1 14 1 12 12 12 12 12 12 10 10 10 10 10 10 3 10 16 16 16 10
14 14 14 14 1 12 12 12 12 12 12 12 12 10 10 10 10 10 10 3 10 16 16 10
14 14 14 14 12 12 7 7 12 12 12 12 12 10 10 10 14 14 10 10 10 16 16 10
14 14 14 14 12 12 7 7 12 12 12 12 12 10 10 10 14 14 10 10 10 16 16 10
14 7 14 14 12 12 7 7 12 12 12 3 3 10 10 10 14 14 10 10 10 16 16 10
0 14 7 14 14 12 12 12 12 12 12 12 12 10 10 10 10 10 10 9 10 16 10 0
0 0 14 7 14 14 12 12 12 12 12 12 12 10 10 10 10 10 9 10 16 10 0 0
0 0 0 14 14 14 14 14 14 14 14 14 10 10 10 10 10 10 10 10 10 0 0 0
0 0 0 0 0 14 15 15 16 16 14 0 0 10 15 15 15 1 10 0 0 0 0 0
0 0 0 0 0 14 14 16 16 14 0 0 0 0 10 1 1 10 10 0 0 0 0 0
0 0 0 0 14 0 14 14 14 0 0 0 0 0 0 10 10 10 0 10 0 0 0 0
