0 0 0 0 0 18 18 18 18 18 0 0 0 0 0
0 0 0 0 18 3 3 3 3 1 18 0 0 0 0
0 0 0 0 18 3 3 3 3 1 18 0 0 0 0
0 0 0 0 0 18 3 3 1 18 0 0 0 0 0
0 0 0 0 0 18 3 3 1 18 0 0 0 0 0
0 0 0 0 0 18 3 3 1 18 0 0 0 0 0
0 0 0 0 0 18 3 3 1 18 0 0 0 0 0
0 0 0 0 0 18 3 3 1 18 0 0 0 0 0
0 0 0 0 0 18 3 3 1 18 0 0 0 0 0
0 0 0 0 18 3 3 3 3 1 18 0 0 0 0
0 0 18 18 1 10 10 10 10 10 1 18 18 0 0
0 18 1 1 10 10 14 10 10 10 10 1 1 18 0
18 1 10 10 10 14 14 10 10 10 10 12 12 1 18
18 1 12 10 10 10 10 10 10 10 12 12 12 1 18
18 1 12 12 12 12 12 12 12 12 12 12 12 1 18
18 1 3 12 12 12 12 12 12 12 12 12 3 1 18
0 18 1 1 3 3 3 3 3 3 3 1 1 18 0
0 0 18 18 18 18 18 18 18 18 18 18 18 0 0
---
0 0 0 0 0 3 3 3 3 3 0 0 0 0 0
0 0 0 0 3 10 10 10 10 18 3 0 0 0 0
0 0 0 0 3 10 10 10 10 18 3 0 0 0 0
0 0 0 0 0 1 10 10 18 3 0 0 0 0 0
0 0 0 0 0 1 10 10 18 3 0 0 0 0 0
0 0 0 0 0 1 10 10 18 3 0 0 0 0 0
0 0 0 0 0 1 10 10 18 3 0 0 0 0 0
0 0 0 0 0 1 10 10 18 3 0 0 0 0 0
0 0 0 0 0 1 10 10 18 3 0 0 0 0 0
0 0 0 0 1 10 10 10 10 18 3 0 0 0 0
0 0 1 1 18 12 12 12 12 12 18 3 3 0 0
0 1 18 18 12 12 1 12 12 12 12 18 18 3 0
1 18 12 12 12 1 1 12 12 12 12 18 18 18 3
1 18 18 12 12 12 12 12 12 12 18 18 18 18 3
1 18 18 18 18 18 18 18 18 18 18 18 18 18 3
1 14 12 18 18 18 18 18 18 18 18 18 10 18 3
0 1 14 14 1 1 1 1 1 1 1 18 18 3 0
0 0 1 1 3 3 3 3 3 3 3 3 3 0 0
