0 0 0 0 0 0 18 18 18 18 18 18 0 0 0 0 0 0
0 0 0 0 18 18 15 15 15 14 14 14 18 18 0 0 0 0
0 0 18 18 9 15 15 15 15 15 15 15 14 14 18 18 0 0
0 0 18 9 15 15 15 15 15 15 15 15 15 14 14 15 18 0
0 18 9 15 15 15 15 15 15 15 15 15 15 15 15 14 18 0
0 18 9 15 18 18 18 18 15 15 15 18 18 18 18 15 15 18
18 9 15 18 14 4 4 4 18 15 18 14 4 4 4 18 15 18
18 9 15 18 14 4 4 4 18 15 18 14 4 4 4 18 14 18
18 9 15 18 14 14 4 4 18 15 18 14 14 4 4 18 15 18
18 9 15 18 14 14 14 14 18 15 18 14 14 14 14 18 15 18
18 9 15 15 18 18 18 18 15 15 15 18 18 18 18 15 15 18
18 9 15 15 15 15 15 15 15 15 15 15 15 15 15 15 15 18
0 18 9 15 15 15 15 18 18 18 18 18 15 15 15 15 9 18
0 18 9 9 15 15 18 15 15 15 15 15 18 15 15 15 18 0
0 0 18 9 15 15 15 15 9 9 9 15 15 15 15 9 18 0
0 0 18 9 9 9 15 15 15 15 15 15 15 9 9 18 0 0
0 0 0 18 18 9 9 9 9 9 9 9 9 18 18 0 0 0
0 0 0 0 0 18 18 18 18 18 18 18 18 0 0 0 0 0
---
0 0 0 0 0 0 15 15 15 15 15 15 0 0 0 0 0 0
0 0 0 0 15 15 14 14 14 18 18 18 15 15 0 0 0 0
0 0 15 15 15 14 14 14 14 14 14 14 18 18 15 15 0 0
0 0 15 15 14 14 14 14 14 14 14 14 14 18 18 18 15 0
0 15 15 14 14 14 14 14 14 18 18 18 18 18 18 18 15 0
0 15 15 18 4 4 4 4 18 18 18 15 15 15 15 18 18 15
15 15 18 4 9 9 9 9 4 18 15 9 9 9 9 15 18 15
15 15 18 4 9 9 9 9 4 18 15 9 9 9 9 15 15 15
15 15 18 4 9 9 9 9 4 18 15 9 9 9 9 15 18 15
15 15 18 4 9 9 9 9 4 18 15 9 9 9 9 15 18 15
15 15 18 18 4 4 4 4 18 18 18 15 15 15 15 18 18 15
15 15 18 18 18 18 18 18 18 18 18 18 18 18 18 18 18 15
0 15 15 18 18 18 18 15 15 15 15 15 18 18 18 18 18 15
0 15 15 15 18 18 15 18 18 18 18 18 15 18 18 18 15 0
0 0 15 15 18 18 18 18 18 18 18 18 18 18 18 15 15 0
0 0 15 15 15 15 18 18 18 18 18 18 18 15 15 15 0 0
0 0 0 15 15 15 15 15 15 15 15 15 15 15 15 0 0 0
0 0 0 0 0 15 15 15 15 15 15 15 15 0 0 0 0 0
