0 0 0 0 0 0 0 0 0 0 0 0 0
0 0 0 0 0 0 0 0 0 0 0 0 0
0 0 0 0 0 0 0 0 0 0 0 0 0
0 0 0 0 0 0 0 0 0 0 0 0 0
0 0 0 0 0 16 16 0 16 16 0 0 0
0 0 0 0 16 6 6 16 6 6 16 0 0
0 0 0 16 5 6 6 6 6 6 16 0 0
0 0 16 5 6 6 16 6 6 16 6 16 0
0 16 5 6 6 10 6 6 6 6 10 6 16
16 5 5 6 6 6 6 8 8 8 8 8 16
16 5 5 5 6 6 8 8 8 8 8 16 0
16 5 6 6 5 6 6 8 8 8 16 0 0
0 16 6 6 6 16 6 16 16 6 16 0 0
---
0 0 0 0 0 0 0 0 0 0 0 0 0
0 0 0 0 0 0 0 0 0 0 0 0 0
0 0 0 0 0 0 0 0 0 0 0 0 0
0 0 0 0 0 0 0 0 0 0 0 0 0
0 0 0 0 0 5 6 0 6 6 0 0 0
0 0 0 0 5 16 16 6 16 16 6 0 0
0 0 0 5 6 16 16 16 16 16 6 0 0
0 0 5 6 16 16 10 16 16 6 16 6 0
0 5 6 16 16 5 16 16 16 16 8 16 6
5 6 6 16 16 16 16 6 6 6 6 6 6
5 6 6 6 8 16 6 6 6 6 6 6 0
5 6 8 8 6 8 8 6 6 6 6 0 0
0 5 8 8 8 10 8 8 8 8 6 0 0
