0 0 0 0 0 0 0 0 0 0 0 0 0 0 16 16 16 0 0 0 0 0 0 0
0 0 0 0 0 0 0 0 0 0 0 0 0 16 16 16 0 0 0 0 0 0 16 16
0 0 0 0 1 1 1 0 0 0 0 0 0 16 16 0 0 0 0 0 0 16 16 16
0 0 3 1 3 14 14 1 0 0 0 2 16 16 2 16 16 16 16 0 16 16 0 0
0 3 14 14 14 3 3 3 1 16 2 15 16 8 8 8 15 15 15 2 16 0 0 0
3 14 14 14 14 14 1 3 9 15 8 8 8 8 8 8 8 8 8 15 2 0 0 0
3 14 14 14 14 14 14 1 9 8 8 8 15 15 8 8 8 8 8 8 15 16 0 0
3 14 14 14 14 14 9 9 8 8 15 16 16 16 15 8 8 8 8 8 8 9 16 0
1 14 14 14 14 3 9 9 15 15 16 8 16 16 16 15 8 8 8 8 15 9 8 16
1 3 14 14 3 9 9 9 15 15 16 16 16 16 16 15 15 15 15 15 15 15 16 16
0 1 1 1 16 9 9 9 15 15 16 16 16 16 16 15 15 15 16 16 15 15 16 16
0 0 0 16 15 9 9 9 9 15 15 16 16 16 15 8 15 15 15 15 15 9 16 0
0 0 0 16 15 9 9 9 9 9 15 15 15 8 8 15 15 15 15 15 15 9 16 0
0 0 16 15 15 15 9 9 9 9 9 9 15 15 15 15 15 15 15 15 9 16 0 0
0 0 16 15 15 15 15 9 9 9 9 9 9 9 9 9 9 9 9 9 16 0 0 0
0 0 16 9 15 15 15 15 9 9 9 9 9 9 9 9 9 9 9 9 16 0 0 0
0 0 16 9 15 15 15 15 15 9 9 9 9 9 9 9 9 9 9 9 16 0 0 0
0 0 16 9 9 15 15 15 15 16 2 16 2 9 9 9 2 16 2 16 0 0 0 0
0 0 16 9 9 15 15 15 15 16 2 2 15 15 15 15 16 16 2 16 0 0 0 0
0 0 0 9 9 9 15 15 15 15 16 2 15 15 15 15 16 16 2 16 0 0 0 0
0 0 0 16 9 9 9 9 16 2 16 16 15 15 2 16 16 0 16 16 0 0 0 0
0 0 0 0 16 9 9 9 16 2 9 9 9 16 2 16 0 0 0 0 0 0 0 0
0 0 0 0 0 16 16 16 16 2 16 16 16 16 2 16 0 0 0 0 0 0 0 0
0 0 0 0 0 0 0 0 16 16 0 0 0 16 2 0 0 0 0 0 0 0 0 0
---
0 0 0 0 0 0 0 0 0 0 0 0 0 0 2 2 2 0 0 0 0 0 0 0
0 0 0 0 0 0 0 0 0 0 0 0 0 2 2 2 0 0 0 0 0 0 15 15
0 0 0 0 15 15 15 0 0 0 0 0 0 2 2 0 0 0 0 0 0 15 15 15
0 0 14 15 15 15 15 15 0 0 0 2 2 2 2 2 2 2 2 0 15 15 0 0
0 14 15 15 15 15 15 15 15 15 2 15 2 15 15 15 8 8 8 15 15 0 0 0
14 15 15 15 15 15 16 15 16 16 15 15 15 15 15 15 15 15 15 8 15 0 0 0
14 15 15 15 15 15 15 16 16 15 15 15 9 9 9 9 15 15 15 15 8 8 0 0
14 15 15 15 15 15 16 16 15 15 9 15 15 15 9 9 9 9 15 15 15 3 8 0
16 15 15 15 15 2 16 16 9 9 15 9 15 15 15 9 9 9 15 15 9 3 8 8
16 2 15 15 2 16 16 16 9 9 15 15 15 15 15 9 9 9 9 9 9 9 8 8
0 16 16 16 3 16 16 16 9 9 15 15 15 15 15 9 9 9 3 3 9 9 8 8
0 0 0 3 9 16 16 16 16 9 9 15 15 15 9 9 9 9 9 9 9 8 8 0
0 0 0 3 9 16 16 16 16 16 9 9 9 9 9 9 9 9 9 9 9 16 8 0
0 0 3 9 9 9 16 16 16 16 16 16 9 9 9 9 9 9 9 9 16 8 0 0
0 0 3 9 9 9 9 16 16 16 16 16 16 16 16 16 16 16 16 16 8 0 0 0
0 0 3 16 9 9 9 9 16 16 16 16 16 16 16 16 16 16 16 16 8 0 0 0
0 0 3 16 9 9 9 9 9 16 1 1 16 16 16 16 16 16 16 16 8 0 0 0
0 0 3 16 16 9 9 9 9 1 1 1 1 16 16 16 8 8 8 8 0 0 0 0
0 0 3 16 16 9 9 9 9 1 1 1 16 16 16 16 8 8 8 8 0 0 0 0
0 0 0 16 16 16 9 9 9 9 1 1 16 16 16 16 8 8 8 8 0 0 0 0
0 0 0 14 16 16 16 16 14 14 1 1 16 16 16 8 8 0 8 8 0 0 0 0
0 0 0 0 14 16 16 16 14 14 14 14 14 14 16 8 0 0 0 0 0 0 0 0
0 0 0 0 0 14 14 14 14 14 14 14 14 14 16 8 0 0 0 0 0 0 0 0
0 0 0 0 0 0 0 0 14 14 0 0 0 14 16 0 0 0 0 0 0 0 0 0
