0 0 0 0 0 0 0 0 0 0 0 0 0 0 0 0 0 0 0 0 0 0 0 0
0 0 0 0 0 0 0 0 0 14 0 0 0 0 14 0 0 0 0 0 0 0 0 0
0 0 0 0 0 0 0 14 0 0 14 0 0 14 0 0 14 0 0 0 0 0 0 0
0 0 0 14 14 0 14 16 14 0 0 0 0 0 0 14 16 14 0 14 14 0 0 0
0 0 14 16 16 14 16 2 16 14 0 0 0 0 14 16 2 16 14 16 16 14 0 0
0 14 16 2 2 16 16 2 16 14 14 14 14 14 14 16 2 16 16 2 2 16 14 0
0 14 16 2 2 2 2 2 16 14 16 16 16 16 14 16 2 2 2 2 2 16 14 0
0 0 14 16 16 2 2 2 2 16 9 9 9 9 16 2 2 2 2 16 16 14 5 0
0 14 16 9 9 16 2 16 16 9 9 8 16 9 9 16 16 2 16 9 9 16 14 0
0 14 16 9 12 9 16 9 9 16 8 8 8 16 9 9 9 16 9 12 9 16 14 0
0 14 16 9 12 16 9 9 9 9 16 16 16 9 9 9 9 9 16 12 9 16 14 0
0 0 14 16 9 16 9 9 9 9 9 9 9 9 9 9 9 9 16 9 16 14 0 0
0 0 0 14 16 9 9 9 9 9 16 9 9 16 9 9 9 9 9 16 14 0 0 0
0 0 0 14 16 9 9 9 9 9 16 8 8 16 9 9 9 9 9 16 14 0 0 0
0 14 0 14 16 8 8 9 9 8 13 13 13 13 8 9 9 8 8 16 14 0 0 0
0 0 0 14 16 10 10 8 8 13 13 13 14 14 13 8 8 10 10 16 14 0 0 0
0 0 0 14 16 8 8 8 8 13 13 13 13 13 13 8 8 8 8 16 14 0 0 0
0 0 0 0 14 16 8 8 8 8 13 13 13 13 8 8 8 8 16 14 0 0 14 0
0 0 0 0 14 16 8 8 8 8 8 8 8 8 8 8 8 8 16 14 0 0 0 0
0 0 14 0 0 14 16 8 8 8 8 8 8 8 8 8 8 16 14 0 0 0 0 0
0 14 5 14 0 0 14 16 16 8 8 8 8 8 8 16 16 14 0 0 0 14 0 0
0 0 14 0 0 0 0 14 14 16 16 16 16 16 16 14 14 0 0 0 14 5 14 0
0 0 0 0 0 14 0 0 0 14 14 14 14 14 14 0 0 0 0 0 0 14 0 0
0 0 0 0 0 0 0 0 0 0 0 0 0 0 0 0 0 14 0 0 0 0 0 0
---
0 0 0 0 0 0 0 0 0 0 0 0 0 0 0 0 0 0 0 0 0 0 0 0
0 0 0 0 0 0 0 0 0 10 0 0 0 0 13 0 0 0 0 0 0 0 0 0
0 0 0 0 0 0 0 9 0 0 10 0 0 13 0 0 8 0 0 0 0 0 0 0
0 0 0 9 9 0 9 8 9 0 0 0 0 0 0 8 8 8 0 8 8 0 0 0
0 0 9 8 8 9 8 16 8 9 0 0 0 0 9 8 13 8 8 8 8 8 0 0
0 9 8 16 16 8 8 16 8 9 9 9 9 9 9 8 13 8 8 13 13 8 8 0
0 9 9 16 16 16 16 16 8 9 8 8 8 8 9 8 13 13 13 13 13 8 8 0
0 0 9 9 9 16 16 16 16 8 16 16 16 16 8 13 13 13 13 8 8 8 2 0
0 9 14 16 16 9 16 9 9 16 16 9 9 16 16 8 8 13 8 16 16 8 8 0
0 9 14 16 9 16 9 16 16 9 9 9 9 9 16 16 16 8 16 9 16 8 8 0
0 9 14 16 9 9 16 16 16 16 9 9 9 16 16 16 16 16 8 9 16 8 8 0
0 0 9 14 16 9 16 16 16 16 16 16 16 16 16 16 16 16 14 16 14 8 0 0
0 0 0 9 14 16 16 16 16 16 2 16 16 2 16 16 16 16 16 14 8 0 0 0
0 0 0 9 14 16 16 16 16 16 2 10 10 2 16 16 16 16 16 14 8 0 0 0
0 2 0 9 14 14 14 16 16 14 2 2 2 2 14 16 16 16 16 14 8 0 0 0
0 0 0 9 14 5 5 14 14 2 2 2 13 13 2 14 14 12 12 14 8 0 0 0
0 0 0 9 14 14 14 14 14 2 2 2 2 2 2 14 14 14 14 14 8 0 0 0
0 0 0 0 9 14 14 14 14 14 2 2 2 2 14 14 14 14 14 8 0 0 5 0
0 0 0 0 9 14 14 14 14 14 14 14 14 14 14 14 14 14 14 8 0 0 0 0
0 0 9 0 0 9 14 14 14 14 14 14 14 14 14 14 14 14 8 0 0 0 0 0
0 9 9 9 0 0 9 14 14 14 14 14 14 14 14 14 14 8 0 0 0 2 0 0
0 0 9 0 0 0 0 9 9 14 14 14 14 14 14 9 9 0 0 0 2 9 2 0
0 0 0 0 0 12 0 0 0 9 9 9 9 9 9 0 0 0 0 0 0 2 0 0
0 0 0 0 0 0 0 0 0 0 0 0 0 0 0 0 0 12 0 0 0 0 0 0
