7 7 7 7 7 7 7 7 7 7 7 7 7 7 7 7 7 7 7 7 7 7 7 7
7 7 7 7 7 7 7 7 7 7 7 7 7 16 16 16 7 7 7 7 7 7 7 7
7 7 7 7 7 7 7 7 7 7 7 7 16 16 16 16 7 7 7 7 7 7 7 7
7 7 7 7 7 7 7 7 7 7 7 16 16 16 16 16 7 7 7 7 7 7 7 7
7 7 7 7 7 7 7 7 7 7 16 16 16 9 9 16 7 7 7 7 7 7 7 16
7 7 7 7 16 16 16 16 16 16 16 9 9 15 15 16 7 7 7 7 7 16 16 9
7 7 16 16 13 13 13 13 14 16 9 9 15 15 16 7 7 7 7 16 16 9 9 15
7 16 14 13 13 13 13 13 16 9 9 15 15 15 15 16 16 16 16 9 9 9 15 15
16 14 14 14 13 13 13 13 16 9 9 15 15 15 15 15 9 9 9 9 15 15 15 15
14 14 14 14 14 13 13 16 9 9 15 15 15 15 15 15 15 15 15 15 15 15 15 16
14 14 14 14 14 14 16 16 9 9 15 15 15 15 15 15 15 15 15 15 15 15 15 16
14 14 14 14 14 16 16 9 9 9 15 15 15 15 15 15 15 15 15 15 15 15 16 7
13 13 13 13 16 7 16 9 9 9 15 15 15 15 15 15 15 15 15 15 15 15 16 7
13 13 13 13 16 7 16 9 9 9 15 15 15 15 15 15 15 15 15 15 15 15 15 16
13 13 13 13 16 16 16 16 9 15 15 15 15 15 15 15 15 15 15 16 16 16 16 16
13 13 13 16 9 9 9 9 9 15 15 15 15 15 15 15 16 16 16 16 16 16 16 16
14 14 14 16 9 15 15 15 15 15 15 15 15 15 16 16 16 16 16 15 15 15 15 16
14 14 14 14 16 9 15 15 15 15 15 15 15 15 15 15 15 15 15 15 15 15 15 15
14 14 14 14 14 16 16 16 9 9 9 9 15 15 15 15 15 15 15 15 15 15 15 15
14 14 14 14 14 13 16 9 9 9 9 9 9 15 15 15 15 15 15 16 16 16 16 15
16 14 14 14 13 13 16 9 9 9 9 15 15 15 15 15 15 16 16 16 16 16 16 16
1 16 16 13 13 13 16 16 9 9 9 9 15 15 16 16 16 16 16 15 15 15 15 16
14 1 1 16 16 16 1 16 9 9 9 9 15 15 15 15 15 15 15 15 15 15 15 15
1 1 1 1 14 1 1 1 16 9 9 9 9 9 9 9 9 15 15 15 15 15 15 15
---
9 9 9 9 9 9 9 9 9 15 15 15 15 15 15 15 15 15 15 15 15 15 15 15
9 9 9 9 9 9 9 9 9 15 15 15 15 15 15 15 15 15 15 15 15 15 15 15
9 9 9 9 9 9 9 9 9 15 15 15 15 15 15 15 15 15 15 15 15 15 15 15
9 9 9 9 9 9 9 9 9 15 15 15 15 15 15 15 15 15 15 15 15 15 15 15
9 9 9 9 9 9 9 9 9 15 15 15 15 15 15 15 15 15 15 15 15 15 15 15
9 9 9 9 15 15 15 15 15 15 15 15 15 16 16 15 15 15 15 15 15 15 15 15
9 9 15 15 9 9 9 9 1 15 15 15 16 16 15 15 15 15 15 15 15 15 15 16
9 15 16 9 9 9 9 9 15 15 15 16 16 16 16 15 15 15 15 15 15 15 16 16
15 16 16 16 9 9 9 9 15 15 15 16 16 16 16 16 15 15 15 15 16 16 16 16
16 16 16 16 16 9 9 15 15 15 16 16 16 16 16 16 16 16 16 16 16 16 16 14
16 16 16 16 16 16 15 15 15 15 16 16 16 16 16 16 16 16 16 16 16 16 16 14
16 16 16 16 16 15 15 15 15 15 16 16 16 16 16 16 16 16 16 16 16 16 14 1
14 14 14 14 15 1 15 15 15 15 16 16 7 7 7 7 7 7 7 7 7 7 14 1
14 14 14 14 15 1 15 15 15 15 7 7 7 7 7 7 7 7 7 7 7 7 7 14
14 14 14 14 15 15 15 15 15 7 7 7 7 7 7 7 7 7 7 14 14 14 14 14
14 14 14 15 15 15 15 15 15 7 7 7 7 7 7 7 14 14 14 14 14 14 14 14
13 13 13 15 15 7 7 7 7 7 7 7 7 7 14 14 14 14 14 7 7 7 7 14
13 13 13 13 15 15 7 7 7 7 7 7 7 7 7 7 7 7 7 7 7 7 7 7
13 13 13 13 13 15 15 15 16 16 16 16 7 7 7 7 7 7 7 7 7 7 7 7
13 13 13 13 13 1 15 16 16 16 16 16 16 7 7 7 7 7 7 13 13 13 13 7
15 15 13 13 1 1 15 16 16 16 16 7 7 7 7 7 7 13 13 13 13 13 13 13
14 15 15 1 1 1 15 15 16 16 16 16 7 7 13 13 13 13 13 7 7 7 7 13
15 14 16 15 15 15 9 15 16 16 16 16 7 7 7 7 7 7 7 7 7 7 7 7
14 14 16 16 15 9 9 9 15 16 16 16 16 16 16 16 16 7 7 7 7 7 7 7
