0 0 0 0 0 0 0 16 0 0 0 0 0 0
0 0 0 0 0 0 16 0 0 0 0 0 0 0
0 0 0 0 13 16 13 13 0 0 0 0 0 0
0 0 0 0 13 7 13 13 12 12 0 0 0 0
0 0 0 12 13 13 13 13 12 12 12 0 0 0
0 0 8 12 12 13 13 12 12 12 12 8 0 0
0 4 8 15 12 12 12 12 12 12 15 8 4 0
4 3 8 15 15 15 15 15 15 15 15 8 3 4
4 14 1 8 15 15 15 15 15 15 8 1 3 4
0 4 3 1 8 8 8 8 8 8 1 3 4 0
0 4 14 14 3 1 1 1 1 1 3 3 4 0
0 0 4 4 14 14 1 1 3 3 4 4 0 0
0 0 0 0 4 4 3 3 4 4 0 0 0 0
0 0 0 0 0 4 14 3 4 0 0 0 0 0
0 0 0 0 4 4 14 1 4 4 0 0 0 0
0 0 0 4 3 14 14 1 1 3 4 0 0 0
0 0 0 4 4 3 1 1 3 4 4 0 0 0
0 0 0 0 4 4 4 4 4 4 0 0 0 0
---
0 0 0 0 0 0 0 14 0 0 0 0 0 0
0 0 0 0 0 0 14 0 0 0 0 0 0 0
0 0 0 0 8 14 8 8 0 0 0 0 0 0
0 0 0 0 8 16 8 8 4 4 0 0 0 0
0 0 0 4 8 8 8 8 4 4 4 0 0 0
0 0 1 4 4 8 8 4 4 4 4 1 0 0
0 12 1 4 4 4 4 4 4 4 4 1 15 0
12 15 1 4 4 4 4 4 4 4 4 1 13 15
12 3 4 1 4 4 4 4 4 4 1 3 13 15
0 12 14 4 1 1 1 1 1 1 3 13 15 0
0 12 1 1 7 3 3 3 3 3 13 13 15 0
0 0 12 12 8 8 3 3 13 13 15 15 0 0
0 0 0 0 12 12 13 13 15 15 0 0 0 0
0 0 0 0 0 12 12 13 15 0 0 0 0 0
0 0 0 0 12 12 12 14 15 15 0 0 0 0
0 0 0 12 13 12 12 14 14 16 15 0 0 0
0 0 0 12 3 13 14 14 16 15 15 0 0 0
0 0 0 0 3 3 3 3 3 3 0 0 0 0
