0 0 0 8 8 8 8 8 0 0 0
0 0 8 10 10 8 10 10 8 0 0
0 8 8 10 10 8 10 10 8 8 0
8 10 10 8 8 8 8 8 10 10 8
8 10 10 8 10 10 10 8 10 10 8
8 8 8 10 10 10 10 10 8 8 8
0 8 10 10 10 10 10 10 10 8 0
0 8 10 10 10 10 10 10 10 8 0
0 8 8 10 10 8 10 10 8 8 0
0 0 8 8 8 8 8 8 8 0 0
---
0 0 0 8 8 8 8 8 0 0 0
0 0 8 8 8 8 8 8 8 0 0
0 8 8 8 8 8 8 8 8 8 0
10 8 8 8 8 8 8 8 8 8 10
10 8 8 8 10 10 10 8 8 8 10
10 10 8 10 10 10 10 10 8 10 10
0 10 10 10 10 10 10 10 10 10 0
0 10 10 10 10 10 10 10 10 10 0
0 10 10 10 10 8 10 10 10 10 0
0 0 8 8 8 8 8 8 8 0 0
