0 0 0 0 0 0 0 4 4 4 4 4 4 4 4 0 0 0 0 0 0 4 0 0 0 0 0 0 0 0 0
0 0 0 0 0 0 4 7 7 7 7 7 14 7 7 4 0 0 0 0 4 14 4 0 0 0 0 0 0 0 0
0 0 0 0 0 4 7 14 14 14 14 7 7 7 10 7 4 4 0 0 0 4 0 0 0 0 0 0 0 0 0
0 0 0 0 4 7 14 14 14 7 7 7 7 7 10 10 7 7 4 0 0 0 0 0 0 0 0 0 4 0 0
0 0 0 4 7 14 14 14 7 7 7 7 7 7 7 10 10 10 7 4 4 0 0 0 0 0 0 4 14 4 0
0 0 0 4 7 14 14 14 7 7 7 7 7 7 7 7 10 10 10 7 7 4 0 0 0 0 0 0 4 0 0
0 0 4 7 14 14 14 7 7 7 7 7 7 7 7 10 10 10 10 10 7 4 0 0 0 0 0 0 0 0 0
0 4 7 7 14 14 7 7 7 7 7 7 7 7 10 10 10 10 10 10 7 4 0 0 0 0 0 0 0 0 0
0 4 7 14 14 7 7 7 7 7 7 10 10 10 10 10 7 7 7 7 7 4 0 0 4 4 0 0 0 0 0
0 4 7 7 7 7 7 7 9 10 10 7 7 7 7 12 7 12 12 12 7 4 0 4 1 14 4 0 0 0 0
0 4 7 14 7 7 7 9 7 7 12 12 12 12 12 9 12 12 4 4 4 0 0 4 1 1 4 0 0 0 0
0 4 7 7 7 9 9 7 12 12 12 12 10 12 12 9 4 4 0 0 0 0 0 0 4 4 0 0 0 0 0
0 4 9 7 9 7 7 12 12 10 12 12 10 12 12 9 9 4 0 0 0 0 0 0 0 0 0 0 0 0 0
0 4 7 9 7 12 12 9 7 10 12 10 7 10 12 9 4 9 4 4 4 4 4 4 0 0 0 0 0 0 0
0 0 4 7 7 12 12 9 7 12 12 10 7 10 12 12 4 4 9 9 9 9 19 19 4 4 4 0 0 0 0
0 0 0 4 4 4 4 9 7 12 12 7 7 10 10 12 9 4 4 4 4 4 4 4 19 19 19 4 0 0 0
0 0 0 0 0 0 4 9 7 10 12 12 7 10 10 12 4 0 9 9 9 4 4 4 4 4 19 19 4 0 0
0 4 4 0 0 0 4 9 7 7 10 12 7 7 10 10 12 4 4 4 4 19 19 19 4 4 4 4 19 4 0
4 1 14 4 0 4 9 4 7 7 10 10 12 7 7 10 10 10 12 4 4 4 4 4 19 19 4 4 19 19 4
4 1 1 4 0 4 9 4 4 7 10 10 10 12 7 7 10 10 10 10 14 4 0 4 4 4 19 4 19 19 4
0 4 4 0 0 4 9 4 4 7 7 10 10 12 7 7 10 7 10 10 10 14 4 0 0 4 19 4 4 4 0
0 0 0 0 4 9 4 0 4 14 7 7 10 10 12 7 7 7 7 7 10 10 14 4 0 4 19 19 4 0 0
0 0 0 0 4 9 4 0 0 4 14 14 7 10 12 7 14 7 7 7 7 10 14 4 0 4 19 19 4 0 0
0 0 0 0 4 9 4 0 0 0 4 14 7 10 10 12 4 14 14 7 7 7 10 14 4 4 19 19 4 0 0
0 0 0 0 4 9 4 0 0 0 0 4 7 7 10 10 4 4 4 14 14 7 10 14 4 4 4 4 0 0 0
0 0 0 0 0 4 19 4 0 0 0 4 14 7 10 10 14 4 0 4 14 7 7 10 14 14 4 0 0 0 0
0 0 0 0 0 4 19 4 0 0 0 4 4 7 7 10 10 14 4 4 14 14 7 7 14 4 0 0 0 0 0
0 0 4 0 0 0 4 19 4 4 4 4 4 14 7 7 10 10 14 4 4 14 14 14 14 4 0 0 0 0 0
0 0 0 0 0 0 0 4 19 19 19 19 4 4 14 7 7 10 14 4 0 4 4 4 4 0 0 0 4 0 0
0 0 0 0 0 0 0 0 4 19 19 19 19 4 4 4 7 7 10 14 4 0 0 0 0 0 0 4 14 4 0
0 0 0 0 0 0 0 0 0 4 4 4 4 0 0 0 4 14 14 14 14 4 0 0 0 0 0 0 4 0 0
0 0 0 0 0 0 0 0 0 0 0 0 0 0 0 0 0 4 4 4 4 0 0 0 0 0 0 0 0 0 0
---
0 0 0 0 0 0 0 14 14 14 14 14 14 14 9 0 0 0 0 0 0 7 0 0 0 0 0 0 0 0 0
0 0 0 0 0 0 14 4 4 4 4 4 4 4 4 9 0 0 0 0 7 7 7 0 0 0 0 0 0 0 0
0 0 0 0 0 14 4 4 4 4 4 4 4 4 4 4 9 9 0 0 0 7 0 0 0 0 0 0 0 0 0
0 0 0 0 14 4 4 4 4 4 4 4 4 4 4 4 4 4 9 0 0 0 0 0 0 0 0 0 7 0 0
0 0 0 14 4 4 4 4 4 4 4 4 4 4 4 4 4 4 4 9 9 0 0 0 0 0 0 7 7 7 0
0 0 0 14 4 4 4 4 4 4 4 4 4 4 4 4 4 4 4 4 4 9 0 0 0 0 0 0 7 0 0
0 0 1 4 4 4 4 4 4 4 4 4 4 4 4 4 4 4 4 4 4 9 0 0 0 0 0 0 0 0 0
0 1 4 4 4 4 4 4 4 4 4 4 4 4 4 4 4 4 4 4 4 9 0 0 0 0 0 0 0 0 0
0 1 4 4 4 4 4 4 4 4 4 4 4 4 4 4 4 4 4 4 4 9 0 0 7 7 0 0 0 0 0
0 1 4 4 4 4 4 4 4 4 4 4 4 4 4 7 4 7 7 7 4 9 0 7 7 7 7 0 0 0 0
0 1 4 4 4 4 4 4 4 4 7 7 7 7 7 7 7 7 9 9 9 0 0 7 7 7 7 0 0 0 0
0 1 4 4 4 4 4 4 7 7 7 7 7 7 7 7 9 9 0 0 0 0 0 0 7 7 0 0 0 0 0
0 12 4 4 4 4 4 7 7 14 7 7 7 7 7 7 7 9 0 0 0 0 0 0 0 0 0 0 0 0 0
0 12 4 4 4 7 7 12 14 14 7 7 4 7 7 7 19 7 9 9 9 9 9 9 0 0 0 0 0 0 0
0 0 12 4 4 7 7 12 14 7 7 7 4 7 7 7 19 19 7 7 7 7 7 7 9 9 9 0 0 0 0
0 0 0 12 12 12 12 12 14 7 7 4 4 7 7 7 7 19 19 19 19 19 19 19 7 7 7 9 0 0 0
0 0 0 0 0 0 12 12 14 14 7 7 4 7 7 7 19 0 7 7 7 19 19 19 19 19 7 7 9 0 0
0 7 7 0 0 0 12 12 14 14 14 7 4 4 7 7 7 19 19 19 19 7 7 7 19 19 19 19 7 9 0
7 7 7 7 0 12 12 10 14 14 14 14 7 4 4 7 7 7 7 19 19 19 10 10 7 7 19 19 7 7 9
7 7 7 7 0 12 12 10 10 14 14 14 14 7 4 4 7 7 7 7 4 7 0 10 10 10 7 19 7 7 9
0 7 7 0 0 12 12 10 10 14 14 14 14 7 4 4 7 4 7 7 7 4 7 0 0 10 7 19 19 9 0
0 0 0 0 12 12 10 0 10 10 14 14 14 14 7 4 4 4 4 4 7 7 4 7 0 10 7 7 19 0 0
0 0 0 0 12 12 10 0 0 10 10 10 14 14 7 4 4 4 4 4 4 7 4 7 0 10 7 7 19 0 0
0 0 0 0 12 12 10 0 0 0 10 10 14 14 14 7 10 4 4 4 4 4 7 4 10 10 7 7 19 0 0
0 0 0 0 12 12 10 0 0 0 0 10 14 14 14 14 10 10 10 4 4 4 7 4 10 10 10 19 0 0 0
0 0 0 0 0 12 12 10 0 0 0 10 10 14 14 14 10 10 0 10 4 4 4 7 4 4 10 0 0 0 0
0 0 0 0 0 12 12 10 0 0 0 10 10 14 14 14 14 10 10 10 4 4 4 4 4 10 0 0 0 0 0
0 0 7 0 0 0 12 12 10 10 10 10 10 10 14 14 14 14 10 10 10 4 4 4 4 10 0 0 0 0 0
0 0 0 0 0 0 0 12 12 12 12 12 10 10 10 14 14 14 10 10 0 10 10 10 10 0 0 0 7 0 0
0 0 0 0 0 0 0 0 12 12 12 12 12 10 10 10 14 14 14 10 10 0 0 0 0 0 0 7 7 7 0
0 0 0 0 0 0 0 0 0 12 12 12 12 0 0 0 10 10 10 10 10 10 0 0 0 0 0 0 7 0 0
0 0 0 0 0 0 0 0 0 0 0 0 0 0 0 0 0 10 10 10 10 0 0 0 0 0 0 0 0 0 0
