3 3 3 3 3 3 16 16 16 16 16 4 4 4 3 3 3 3
3 3 3 3 16 16 15 15 15 15 15 16 16 4 3 3 3 3
3 3 3 16 15 15 9 9 9 9 9 9 9 16 4 3 3 3
3 3 3 16 9 9 9 9 9 9 9 9 9 16 4 3 3 3
3 3 3 16 9 14 16 9 9 14 16 9 9 16 4 3 3 3
3 3 3 16 9 16 16 9 9 16 16 9 9 16 4 3 3 3
3 16 16 16 9 9 9 13 13 9 9 9 9 16 16 16 4 3
16 16 15 16 9 9 9 9 13 9 9 9 16 16 9 16 16 4
16 9 9 14 16 9 9 9 9 9 9 16 16 14 9 9 16 4
16 9 14 9 9 2 2 17 9 17 9 9 9 9 14 9 16 4
3 16 9 9 9 9 9 9 12 9 9 9 9 9 9 16 4 3
3 3 16 16 16 9 9 17 9 17 9 9 16 16 16 4 4 3
3 3 3 3 16 9 9 9 12 9 9 9 16 4 4 4 3 3
3 3 3 3 16 9 9 17 9 17 9 9 16 4 3 3 3 3
3 3 3 16 14 9 9 9 9 9 9 9 14 16 4 3 3 3
3 3 3 16 9 14 9 9 16 9 9 14 9 16 4 3 3 3
3 3 3 16 9 9 14 16 4 16 14 9 9 16 4 3 3 3
3 3 3 3 16 16 16 4 3 3 16 16 16 4 3 3 3 3
---
16 16 16 16 16 16 9 9 9 9 9 14 14 14 9 9 9 9
16 16 16 16 9 9 4 4 4 4 4 9 9 14 9 9 9 9
16 16 16 9 4 4 3 3 3 3 3 3 3 9 14 9 9 9
16 16 16 9 3 3 3 3 3 3 3 3 3 9 14 9 9 9
16 16 16 9 3 13 4 3 3 13 15 3 3 9 14 9 9 9
16 16 16 9 3 4 4 3 3 15 15 3 3 9 14 9 9 9
16 17 9 9 3 3 3 4 4 3 3 3 3 9 9 9 16 9
17 17 4 9 3 3 3 3 4 3 3 3 9 9 3 9 9 16
17 16 16 4 9 3 3 3 3 3 3 9 9 9 3 3 9 16
17 16 4 16 16 15 15 14 16 14 3 3 3 3 9 3 9 16
16 17 16 16 16 16 16 16 13 3 3 3 3 3 3 9 16 9
16 16 9 9 9 16 16 12 3 12 3 3 9 9 9 16 16 9
16 16 16 16 9 3 3 3 15 3 3 3 9 16 16 16 9 9
16 16 16 16 9 3 3 2 3 2 3 3 9 16 9 9 9 9
16 16 16 9 9 3 3 3 3 3 3 3 4 9 16 9 9 9
16 16 16 9 3 9 3 3 9 3 3 4 3 9 16 9 9 9
16 4 4 9 3 3 9 9 15 9 4 3 3 9 16 9 9 9
4 4 4 4 9 9 9 15 14 14 9 9 9 16 9 9 9 9
