0 0 16 16 0 0 0 0 0 0 16 16 16 0 0 0 0 0 0 0
0 16 9 9 16 16 16 16 16 16 15 15 15 16 0 0 0 0 0 0
16 9 9 9 15 15 15 15 15 15 15 15 15 15 16 0 0 0 0 0
16 9 9 15 14 15 15 15 15 14 15 9 15 15 16 0 0 0 0 0
16 9 9 15 15 15 15 15 15 15 15 9 15 15 16 0 0 0 0 0
0 16 16 14 14 15 15 14 14 14 15 9 9 16 0 0 0 0 0 0
0 0 16 14 1 15 15 14 1 1 15 15 9 9 16 0 0 0 0 0
0 16 9 14 1 15 15 14 1 1 15 15 15 9 16 0 0 0 0 0
0 16 9 9 15 16 16 15 15 15 15 15 9 9 16 0 0 0 0 0
0 16 9 14 14 14 12 12 12 14 14 9 9 9 16 0 0 16 16 0
0 0 16 14 14 12 10 12 14 14 14 9 5 16 0 0 16 14 14 16
0 0 0 16 17 10 12 17 17 5 5 5 5 16 0 0 0 16 14 16
0 0 0 0 17 17 17 5 5 14 9 9 9 15 16 0 0 16 15 16
0 0 0 0 16 14 14 14 14 15 9 15 15 15 16 16 0 16 15 16
0 0 0 0 16 16 14 14 15 15 15 15 15 15 15 16 16 15 9 16
0 0 0 0 0 16 9 14 15 15 15 14 15 9 15 16 9 15 16 0
0 0 0 0 0 16 9 15 15 15 9 14 9 15 15 15 9 16 0 0
0 0 0 0 16 9 9 15 15 9 9 9 15 15 9 9 9 16 0 0
0 0 0 0 16 16 16 16 16 16 16 16 16 16 16 16 16 0 0 0
---
0 0 15 15 0 0 0 0 0 0 15 15 15 0 0 0 0 0 0 0
0 15 16 16 15 15 15 15 15 15 16 16 16 15 0 0 0 0 0 0
15 16 16 16 16 16 16 16 16 16 16 16 16 16 15 0 0 0 0 0
15 16 16 16 15 16 16 16 16 15 16 14 16 16 15 0 0 0 0 0
15 16 16 16 16 16 16 16 16 16 16 14 16 16 15 0 0 0 0 0
0 15 15 10 10 16 16 15 15 15 16 14 14 15 0 0 0 0 0 0
0 0 15 1 12 16 16 15 12 12 16 16 14 14 15 0 0 0 0 0
0 15 17 1 12 16 16 15 12 12 16 16 16 14 15 0 0 0 0 0
0 15 17 17 16 17 17 16 16 16 16 16 14 14 15 0 0 0 0 0
0 15 17 9 9 9 14 14 14 9 9 14 14 14 15 0 0 15 15 0
0 0 15 9 9 14 14 14 9 9 9 14 14 15 0 0 15 5 5 15
0 0 0 15 14 14 14 14 14 14 14 14 14 15 0 0 0 15 5 15
0 0 0 0 14 14 14 14 14 9 16 16 16 9 15 0 0 15 5 15
0 0 0 0 15 9 9 9 9 9 16 9 9 9 15 15 0 15 5 15
0 0 0 0 15 15 9 9 9 9 9 9 9 9 9 15 15 5 9 15
0 0 0 0 0 15 1 9 9 9 9 16 9 16 9 15 16 5 15 0
0 0 0 0 0 15 1 9 9 9 16 16 16 9 9 9 16 15 0 0
0 0 0 0 15 1 1 9 9 16 16 16 9 9 16 16 16 15 0 0
0 0 0 0 15 15 15 15 15 15 15 15 15 15 15 15 15 0 0 0
