0 5 0 0 0 0 0 16 16 0 0 0 0 0 0 0
5 15 5 0 0 0 16 13 14 16 16 16 0 0 0 0
0 5 0 0 0 16 16 13 13 16 13 14 16 0 5 0
0 5 0 0 16 13 14 16 16 16 13 13 16 0 0 0
0 0 0 0 16 13 13 16 13 14 16 16 16 0 0 0
0 0 0 16 5 16 16 16 13 13 16 5 6 16 0 0
0 0 16 5 5 5 16 16 16 16 16 5 5 6 16 0
0 0 16 5 5 16 9 15 15 15 16 16 5 5 16 0
0 16 5 16 16 9 15 15 15 15 15 16 16 16 5 16
0 16 16 0 16 9 15 15 15 15 15 16 0 0 16 16
0 0 0 0 16 9 15 15 15 15 15 16 0 0 0 0
0 0 0 16 9 9 15 15 15 15 15 15 16 0 0 0
0 0 0 16 9 9 9 9 9 9 9 9 16 0 0 0
0 0 0 0 16 16 16 16 16 16 16 16 0 0 5 0
0 0 0 0 0 0 16 9 15 16 0 0 0 5 15 5
0 5 0 0 0 0 0 16 16 0 0 0 0 0 5 0
0 0 0 0 0 0 0 0 0 0 0 0 0 0 5 0
---
0 16 0 0 0 0 0 15 15 0 0 0 0 0 0 0
16 13 16 0 0 0 15 16 16 15 15 15 0 0 0 0
0 16 0 0 0 15 15 16 16 15 9 9 15 0 14 0
0 16 0 0 15 16 16 15 15 15 9 9 15 0 0 0
0 0 0 0 15 16 16 15 14 9 15 15 5 0 0 0
0 0 0 13 16 15 15 15 14 14 15 16 13 5 0 0
0 0 13 16 16 16 15 15 15 15 5 16 16 13 5 0
0 0 13 16 16 13 16 16 16 16 5 5 16 16 5 0
0 13 16 13 13 16 16 16 16 16 16 5 5 5 16 5
0 9 9 0 9 16 16 16 16 16 16 5 0 0 5 5
0 0 0 0 9 16 16 16 16 16 16 5 0 0 0 0
0 0 0 9 16 16 16 16 16 16 16 16 5 0 0 0
0 0 0 9 16 16 16 16 16 16 16 16 5 0 0 0
0 0 0 0 9 9 9 5 5 5 5 5 0 0 16 0
0 0 0 0 0 0 9 6 6 5 0 0 0 16 13 16
0 13 0 0 0 0 0 5 5 0 0 0 0 0 16 0
0 0 0 0 0 0 0 0 0 0 0 0 0 0 16 0
