0 0 0 0 0 0 0 0 0 0 0 0 18 18 18 0 0 18 18 18 0 0 0 0 0 0 0 0 0 0 0 0
0 0 0 0 0 0 0 0 0 0 0 18 10 10 10 18 18 10 10 10 18 0 0 0 0 0 0 0 0 0 0 0
0 0 0 0 0 0 0 0 0 0 0 18 10 10 10 10 10 10 10 10 18 0 0 0 0 0 0 0 0 0 0 0
0 0 0 0 0 0 0 0 0 0 0 18 10 10 10 10 10 10 10 10 18 0 0 0 0 0 0 0 0 0 0 0
0 0 0 0 0 0 0 0 0 0 0 0 18 10 10 10 10 10 10 18 0 0 0 0 0 0 0 0 0 0 0 0
0 0 0 0 0 0 0 0 0 0 0 0 0 18 10 10 10 10 18 0 0 0 0 0 0 0 0 0 0 0 0 0
0 0 0 18 0 18 0 0 0 0 0 0 0 0 18 10 10 18 0 0 0 0 0 0 0 0 18 0 18 0 0 0
0 0 18 10 10 10 18 0 0 0 0 0 0 0 0 18 18 0 0 0 0 0 0 0 0 18 10 10 10 18 0 0
0 0 0 18 10 18 0 0 0 18 18 18 18 0 0 0 0 0 0 18 18 18 18 0 0 0 18 10 18 0 0 0
0 0 0 0 18 0 0 18 18 15 15 15 15 18 18 0 0 18 18 15 15 15 15 18 18 0 0 18 0 0 0 0
0 0 0 0 0 0 18 19 15 15 15 15 15 15 15 18 18 15 15 15 15 15 15 15 19 18 0 0 0 0 0 0
0 0 0 0 0 18 19 15 15 15 15 15 15 15 15 15 18 15 15 15 15 15 15 15 15 19 18 0 0 0 0 0
0 0 0 0 0 18 19 15 15 18 15 15 15 15 15 18 15 15 15 15 15 15 18 15 15 19 18 0 0 0 0 0
0 0 0 0 18 19 15 15 18 14 18 15 15 15 15 18 15 15 15 15 15 18 14 18 15 15 19 18 0 0 0 0
0 0 0 0 18 19 15 15 18 18 18 15 18 18 15 19 18 15 18 18 15 18 18 18 15 15 19 18 0 0 0 0
0 0 0 0 18 19 15 15 15 18 15 18 9 9 18 18 15 18 9 9 18 15 18 15 15 15 19 18 0 0 0 0
0 0 0 0 0 18 19 15 15 15 15 15 18 9 9 18 18 9 9 18 15 15 15 15 15 19 18 0 0 0 0 0
0 0 0 0 18 19 18 19 19 15 15 15 15 18 18 0 15 18 18 15 15 15 15 19 19 18 19 18 0 0 0 0
0 0 0 18 19 19 15 15 15 15 15 15 15 15 15 18 18 15 15 15 15 15 15 15 15 15 15 19 18 0 0 0
0 0 0 18 19 15 15 15 15 15 15 14 14 8 18 15 15 18 15 14 14 14 15 15 15 15 15 19 18 0 0 0
0 18 18 19 19 15 15 18 14 14 14 14 14 14 8 18 18 8 14 14 14 14 14 15 18 15 15 19 15 18 18 0
18 19 19 15 15 19 18 15 14 14 14 14 14 14 8 8 18 19 8 14 14 14 14 14 15 18 19 15 15 19 19 18
18 19 15 15 15 18 15 14 14 14 14 14 14 14 14 8 18 8 14 14 14 14 14 14 14 15 18 15 15 15 19 18
0 18 19 15 15 15 14 14 14 14 18 18 8 18 18 8 18 18 18 8 18 18 8 14 14 14 15 15 15 19 18 0
0 0 18 19 15 14 14 14 14 18 9 9 18 9 9 18 18 9 9 18 9 9 18 8 14 14 14 15 19 18 0 0
0 0 0 18 18 8 8 8 18 9 9 9 18 9 9 18 18 9 9 18 9 9 9 18 8 8 15 18 18 0 0 0
0 0 0 0 0 18 18 18 18 18 18 18 18 18 18 0 0 18 18 18 18 18 18 18 18 18 18 0 0 0 0 0
---
0 0 0 0 0 0 0 0 0 0 0 0 10 10 10 0 0 10 10 10 0 0 0 0 0 0 0 0 0 0 0 0
0 0 0 0 0 0 0 0 0 0 0 10 15 15 15 10 10 15 15 15 10 0 0 0 0 0 0 0 0 0 0 0
0 0 0 0 0 0 0 0 0 0 0 10 15 15 15 15 15 15 15 15 10 0 0 0 0 0 0 0 0 0 0 0
0 0 0 0 0 0 0 0 0 0 0 10 15 15 15 15 15 15 15 15 10 0 0 0 0 0 0 0 0 0 0 0
0 0 0 0 0 0 0 0 0 0 0 0 10 15 15 15 15 15 15 10 0 0 0 0 0 0 0 0 0 0 0 0
0 0 0 0 0 0 0 0 0 0 0 0 0 10 15 15 15 15 10 0 0 0 0 0 0 0 0 0 0 0 0 0
0 0 0 10 0 10 0 0 0 0 0 0 0 0 10 15 15 10 0 0 0 0 0 0 0 0 10 0 10 0 0 0
0 0 10 15 15 15 10 0 0 0 0 0 0 0 0 10 10 0 0 0 0 0 0 0 0 10 15 15 15 10 0 0
0 0 0 10 15 10 0 0 0 8 8 8 8 0 0 0 0 0 0 19 19 19 19 0 0 0 10 15 10 0 0 0
0 0 0 0 10 0 0 8 8 18 18 18 18 8 8 0 0 19 19 18 18 18 18 19 19 0 0 10 0 0 0 0
0 0 0 0 0 0 8 15 18 18 18 18 18 18 18 10 10 18 18 18 18 18 18 18 15 19 0 0 0 0 0 0
0 0 0 0 0 8 15 18 18 18 18 18 18 18 18 18 10 18 18 18 18 18 18 18 18 15 19 0 0 0 0 0
0 0 0 0 0 8 15 18 18 9 18 18 18 18 18 10 18 18 18 18 18 18 9 18 18 15 19 0 0 0 0 0
0 0 0 0 8 15 18 18 9 14 9 18 18 18 18 10 18 18 18 18 18 9 14 9 18 18 15 19 0 0 0 0
0 0 0 0 8 15 18 18 9 9 9 18 9 9 18 19 10 18 9 9 18 9 9 9 18 18 15 19 0 0 0 0
0 0 0 0 8 15 18 18 18 9 18 9 15 15 9 9 18 9 15 15 9 18 9 18 18 18 15 19 0 0 0 0
0 0 0 0 0 8 15 18 18 18 18 18 14 15 15 9 9 15 15 9 18 18 18 18 18 15 19 0 0 0 0 0
0 0 0 0 8 15 8 15 15 18 18 18 18 14 14 0 18 14 14 18 18 18 18 15 15 19 15 19 0 0 0 0
0 0 0 8 15 15 18 18 18 18 18 18 18 18 18 14 14 18 18 18 18 18 18 18 18 18 18 15 19 0 0 0
0 0 0 14 15 18 18 18 18 18 18 15 15 18 14 18 18 14 18 15 15 15 18 18 18 18 18 15 19 0 0 0
0 14 14 15 15 18 18 15 15 15 15 15 15 15 18 14 14 18 15 15 15 15 15 18 15 18 18 15 18 19 19 0
14 15 15 18 18 15 15 18 15 15 15 15 15 15 18 18 14 18 18 15 15 15 15 15 18 15 15 18 18 18 18 19
14 15 18 18 18 15 18 15 15 15 15 15 15 15 15 18 14 18 15 15 15 15 15 15 15 18 15 18 18 18 18 19
0 14 15 18 18 18 15 15 15 15 14 14 18 14 14 18 14 14 14 18 19 19 14 15 15 15 18 18 18 18 19 0
0 0 14 15 18 15 15 15 15 14 15 15 14 15 15 14 14 15 15 14 15 15 19 14 15 15 15 18 18 19 0 0
0 0 0 14 14 14 14 14 14 15 15 15 14 15 15 14 14 15 15 14 15 15 15 19 14 14 18 19 19 0 0 0
0 0 0 0 0 14 14 14 14 14 14 14 14 14 14 0 0 19 19 19 19 19 19 19 19 19 19 0 0 0 0 0
