0 0 0 0 0 0 0 0 0 0 0 0 0 0 0 0 0 0
0 0 0 0 0 16 16 0 0 0 0 16 16 0 0 0 0 0
0 0 0 0 16 15 15 16 0 0 16 15 15 16 0 0 0 0
0 0 0 16 15 13 13 15 16 16 15 13 13 15 16 0 0 0
0 0 0 16 15 9 15 15 15 15 15 15 9 15 16 0 0 0
0 0 16 15 9 15 15 15 15 15 15 15 15 9 15 16 0 0
0 0 16 15 9 12 12 15 15 15 15 12 12 9 15 16 0 0
0 16 15 9 15 15 16 12 15 15 12 16 15 15 9 15 16 0
0 16 15 9 15 15 15 16 15 15 16 15 15 15 12 12 16 0
0 16 9 9 15 15 15 15 15 15 15 15 15 12 15 15 15 16
16 15 13 13 13 13 13 13 13 13 13 13 13 12 15 15 15 16
16 15 9 13 13 13 13 13 8 8 13 13 13 13 12 12 16 16
16 15 9 15 15 5 5 8 8 8 8 5 5 12 8 8 12 16
16 15 9 15 15 5 5 8 9 8 8 5 12 8 9 9 8 12
0 16 15 15 15 5 5 5 8 8 5 5 12 8 8 8 8 12
0 16 15 9 15 15 5 5 5 5 5 5 12 8 9 9 8 12
0 0 16 15 15 15 15 15 15 15 15 15 15 12 8 8 12 0
0 0 0 16 16 16 16 16 16 16 16 16 16 16 12 12 0 0
---
0 0 0 0 0 0 0 0 0 0 0 0 0 0 0 0 0 0
0 0 0 0 0 15 15 0 0 0 0 15 15 0 0 0 0 0
0 0 0 0 15 13 13 15 0 0 15 16 16 15 0 0 0 0
0 0 0 15 13 8 8 16 15 15 16 15 15 16 15 0 0 0
0 0 0 15 13 13 16 16 16 16 16 16 13 16 15 0 0 0
0 0 15 13 13 16 16 16 16 16 16 16 16 13 16 15 0 0
0 0 15 13 13 13 13 16 16 16 16 5 5 13 16 15 0 0
0 15 13 13 16 16 13 13 16 16 5 9 16 16 13 16 15 0
0 15 13 13 16 16 16 13 16 16 9 16 16 16 8 8 15 0
0 15 13 13 16 16 16 16 16 16 16 16 16 8 9 9 9 15
15 12 15 15 15 15 15 15 15 15 15 15 15 8 9 9 9 15
15 12 8 15 15 15 15 15 9 9 15 15 15 15 8 8 15 15
15 12 8 12 12 15 15 9 9 9 9 15 15 8 5 5 8 15
15 12 8 12 12 15 15 9 9 9 9 15 8 5 5 5 5 8
0 15 12 12 12 15 15 15 9 9 15 15 8 5 5 5 5 8
0 15 12 5 12 12 15 15 15 15 15 15 8 5 15 15 5 8
0 0 15 12 12 12 12 12 12 12 12 12 12 8 5 5 8 0
0 0 0 15 15 15 15 15 15 15 15 15 15 15 8 8 0 0
