0 0 0 0 0 0 0 0 0 0 0 0 0 0 0 0 0 0 0 0 0 0 0 0
0 0 0 0 0 0 0 0 0 0 0 0 0 0 0 0 0 0 0 0 14 0 0 0
0 0 0 16 16 16 0 0 0 0 0 16 0 0 0 0 0 0 0 14 15 14 0 0
0 0 0 16 9 9 16 0 0 16 16 1 16 0 0 0 0 0 0 0 14 0 0 0
0 0 0 16 9 15 9 16 16 1 1 14 14 16 16 0 0 0 0 0 0 0 0 0
0 0 0 0 16 15 9 15 1 1 1 14 14 14 14 16 16 0 0 0 0 0 0 0
0 0 0 0 0 16 9 15 1 1 1 1 14 14 14 1 1 16 0 0 0 0 0 0
0 0 16 16 16 14 14 15 1 14 14 14 14 14 14 2 14 1 16 0 0 0 0 0
0 16 14 14 14 14 2 1 1 1 1 14 14 14 14 2 2 14 16 0 0 0 0 0
0 16 1 14 16 14 2 2 2 1 1 1 14 2 2 2 2 14 16 0 0 0 14 0
0 16 1 14 16 14 14 2 2 2 2 2 2 2 2 2 14 14 16 0 0 14 15 14
0 16 1 1 14 14 14 14 14 2 2 2 2 2 14 14 14 14 16 0 0 0 14 0
0 0 16 1 1 14 1 1 14 14 14 14 14 14 14 14 14 14 16 16 0 0 0 0
0 0 0 16 16 14 14 1 14 14 14 14 14 14 14 14 14 14 16 14 16 0 0 0
0 0 0 16 14 1 14 14 14 14 14 14 14 14 14 9 9 9 9 9 14 16 0 0
0 0 16 1 14 1 1 14 14 14 14 14 14 14 9 15 15 15 15 15 9 16 0 0
0 0 16 1 14 14 1 1 14 14 14 14 14 9 15 15 9 15 15 9 15 9 16 0
0 0 16 16 1 14 14 14 1 1 1 1 1 9 15 15 15 15 15 15 15 9 16 0
0 0 0 16 1 14 14 14 14 14 14 14 14 9 15 9 15 9 15 15 15 9 16 0
0 0 0 16 16 16 1 1 14 14 14 14 14 9 15 15 9 15 15 15 15 9 16 0
0 14 0 0 0 16 16 16 1 1 1 1 1 1 9 15 15 9 15 9 9 9 16 0
14 15 14 0 0 0 0 0 16 16 16 16 16 16 16 9 9 9 9 9 9 16 0 0
0 14 0 0 0 0 0 0 0 0 0 0 0 0 16 16 16 16 16 16 16 0 0 0
0 0 0 0 0 0 0 0 0 0 0 0 0 0 0 0 0 0 0 0 0 0 0 0
---
0 0 0 0 0 0 0 0 0 0 0 0 0 0 0 0 0 0 0 0 0 0 0 0
0 0 0 0 0 0 0 0 0 0 0 0 0 0 0 0 0 0 0 0 16 0 0 0
0 0 0 14 14 14 0 0 0 0 0 14 0 0 0 0 0 0 0 16 14 16 0 0
0 0 0 14 1 1 14 0 0 14 14 14 14 0 0 0 0 0 0 0 16 0 0 0
0 0 0 14 1 1 1 14 14 14 14 9 9 14 14 0 0 0 0 0 0 0 0 0
0 0 0 0 14 1 1 1 14 14 14 9 9 9 9 14 14 0 0 0 0 0 0 0
0 0 0 0 0 14 1 1 14 14 14 14 9 9 9 14 14 14 0 0 0 0 0 0
0 0 14 14 14 16 16 1 14 9 9 9 9 9 9 15 16 14 14 0 0 0 0 0
0 14 16 16 16 16 15 14 14 14 14 9 9 9 9 15 15 16 14 0 0 0 0 0
0 14 1 16 2 16 15 15 15 14 14 14 9 15 15 15 15 16 14 0 0 0 15 0
0 14 1 16 2 16 16 15 15 15 15 15 15 15 15 15 16 16 14 0 0 15 16 15
0 14 1 1 16 16 16 16 16 15 15 15 15 15 16 16 16 16 14 0 0 0 15 0
0 0 14 1 1 16 2 2 16 16 16 16 16 16 16 16 16 16 14 14 0 0 0 0
0 0 0 14 14 16 16 2 16 16 16 16 16 16 16 16 16 16 14 14 14 0 0 0
0 0 0 14 2 15 16 16 16 16 16 16 16 16 16 14 14 14 14 14 14 14 0 0
0 0 14 9 2 15 15 16 16 16 16 16 16 16 14 1 1 1 1 1 14 14 0 0
0 0 14 9 2 2 15 15 16 16 16 16 16 14 1 1 1 1 1 14 1 14 14 0
0 0 14 14 9 2 2 2 15 15 15 15 15 14 1 1 1 1 1 1 1 14 14 0
0 0 0 14 9 2 2 2 2 2 2 2 2 14 1 1 1 1 1 1 1 14 14 0
0 0 0 14 14 14 9 9 2 2 2 2 2 14 1 1 1 1 1 1 1 14 14 0
0 9 0 0 0 14 14 14 9 9 9 9 9 9 14 1 1 14 1 14 14 14 14 0
9 9 9 0 0 0 0 0 14 14 14 14 14 14 14 14 14 14 14 14 14 14 0 0
0 9 0 0 0 0 0 0 0 0 0 0 0 0 14 14 14 14 14 14 14 0 0 0
0 0 0 0 0 0 0 0 0 0 0 0 0 0 0 0 0 0 0 0 0 0 0 0
