0 0 0 0 0 0 0 0 0 18 18 18 18 18 18 0 0 0
0 0 0 0 18 18 18 18 18 1 3 3 3 3 3 18 0 0
0 0 0 18 1 1 3 1 1 1 1 1 1 1 1 18 0 0
0 0 18 3 3 1 1 1 1 1 1 1 1 4 18 0 0 0
0 18 3 3 3 3 1 1 1 1 1 1 4 4 4 18 0 0
0 18 3 3 3 3 1 1 1 1 1 1 1 4 1 1 18 0
0 18 3 3 1 1 1 1 1 1 1 1 1 1 1 1 18 0
0 18 3 1 1 18 14 1 1 1 1 1 1 1 1 1 1 18
18 3 1 1 1 18 18 1 1 1 1 3 3 1 1 1 4 18
18 1 1 1 1 1 1 1 1 4 1 3 1 1 4 1 4 18
0 18 18 14 14 14 14 14 14 18 14 1 1 18 1 1 4 18
0 0 0 18 18 18 4 4 18 18 14 1 18 14 14 1 4 18
0 0 0 0 0 0 18 18 0 0 18 18 0 18 14 4 4 18
0 0 0 0 0 0 0 0 0 0 0 0 0 18 14 14 4 18
0 0 0 0 0 0 0 0 0 0 0 18 18 14 14 14 18 0
0 0 0 0 0 0 0 0 0 0 18 14 14 14 14 18 0 0
0 0 0 0 0 0 0 0 0 0 0 18 18 18 14 14 18 0
0 0 0 0 0 0 0 0 0 0 0 0 0 0 18 18 18 0
---
0 0 0 0 0 0 0 0 0 1 1 1 1 1 1 0 0 0
0 0 0 0 1 1 1 1 1 18 4 4 4 4 4 1 0 0
0 0 0 1 18 18 4 18 18 18 18 18 18 18 18 1 0 0
0 0 1 1 1 18 18 18 18 18 18 18 18 3 1 0 0 0
0 1 1 1 1 1 18 18 18 18 18 18 3 3 3 1 0 0
0 1 1 1 1 1 18 18 18 18 18 18 18 3 14 14 1 0
0 1 1 1 18 18 18 18 18 18 18 18 14 14 14 14 1 0
0 1 1 18 18 1 4 18 18 18 18 18 14 14 14 14 14 1
1 1 18 18 18 1 1 18 18 18 18 4 4 14 14 14 1 1
1 18 18 18 18 18 18 18 18 3 18 4 14 14 3 14 1 1
0 1 1 4 4 4 4 4 4 1 3 14 14 1 14 14 1 1
0 0 0 1 1 1 1 1 1 1 3 14 1 3 3 14 1 1
0 0 0 0 0 0 1 1 0 0 1 1 0 1 3 1 1 1
0 0 0 0 0 0 0 0 0 0 0 0 0 1 3 3 1 1
0 0 0 0 0 0 0 0 0 0 0 1 1 3 3 3 1 0
0 0 0 0 0 0 0 0 0 0 1 3 3 3 3 1 0 0
0 0 0 0 0 0 0 0 0 0 0 1 1 1 3 3 1 0
0 0 0 0 0 0 0 0 0 0 0 0 0 0 1 1 1 0
