0 0 0 9 9 0 0 0 0 0 0 0 0 0 9 9 0 0 0 0 0
0 0 9 14 14 9 0 0 0 0 0 0 0 9 14 14 9 0 0 0 0
0 9 14 10 10 14 9 0 0 0 0 0 9 14 10 10 14 9 0 0 0
0 9 14 10 10 10 14 9 9 9 9 9 14 10 10 10 14 9 0 0 0
0 9 14 10 10 10 10 14 14 14 14 14 10 10 10 10 14 9 0 0 0
0 9 14 10 10 10 14 14 14 14 14 14 14 10 10 10 14 9 0 0 0
0 9 14 10 10 14 14 14 14 14 14 14 14 14 10 10 14 9 0 0 0
0 9 14 10 14 14 14 14 14 14 14 14 14 14 14 10 14 9 0 0 0
0 9 14 14 14 16 16 14 14 14 14 14 16 16 14 14 14 9 0 0 0
9 9 14 14 16 16 16 14 14 14 14 14 16 16 16 14 14 14 9 0 0
9 14 14 14 14 16 16 14 14 14 14 14 16 16 14 14 14 14 9 0 0
9 14 14 14 14 16 16 14 14 14 14 14 16 16 14 14 14 14 9 0 0
9 14 14 14 14 14 14 14 14 10 14 14 14 14 14 14 14 14 9 0 0
9 14 14 14 14 14 14 14 16 16 16 14 14 14 14 14 14 9 0 0 0
9 14 14 14 14 14 14 14 14 16 14 14 14 14 14 9 9 0 0 0 0
0 9 14 14 14 14 14 14 14 14 14 14 14 9 9 9 0 0 0 0 0
0 0 9 9 14 14 14 14 14 14 14 14 9 9 0 0 0 0 0 0 0
0 0 0 0 9 9 9 9 9 9 9 9 9 0 0 0 0 0 0 0 0
0 0 0 0 9 14 14 14 14 14 14 14 14 9 0 0 0 0 0 0 0
0 0 0 0 9 14 14 9 14 9 14 14 14 9 0 9 9 9 9 9 0
0 0 0 0 9 14 14 9 14 9 14 14 14 9 9 14 14 14 14 14 9
0 0 0 0 9 14 14 14 9 14 14 9 14 9 14 14 14 14 9 9 0
0 0 0 0 0 9 9 9 9 9 9 9 9 9 9 9 9 9 0 0 0
---
0 0 0 9 9 0 0 0 0 0 0 0 0 0 9 9 0 0 0 0 0
0 0 9 9 14 9 0 0 0 0 0 0 0 9 10 10 9 0 0 0 0
0 9 9 9 14 14 9 0 0 0 0 0 9 10 10 10 10 9 0 0 0
0 9 9 9 14 14 14 14 14 14 14 14 10 10 10 10 10 9 0 0 0
0 9 14 14 14 14 14 14 14 14 14 14 10 10 10 10 10 9 0 0 0
0 9 14 14 14 14 14 14 14 14 14 14 10 10 10 10 10 9 0 0 0
0 9 14 14 14 14 14 14 14 14 14 14 10 10 10 10 10 9 0 0 0
0 9 14 14 14 14 14 14 14 14 14 14 10 10 10 10 10 9 0 0 0
0 9 14 14 14 14 14 14 14 14 14 14 14 14 14 14 14 9 0 0 0
9 9 14 14 14 14 14 14 14 14 14 14 14 14 14 14 14 14 9 0 0
9 14 14 14 14 14 14 14 14 14 14 14 14 14 14 14 14 14 9 0 0
9 14 14 14 14 14 14 14 14 14 14 14 14 14 14 14 14 14 9 0 0
9 14 14 14 14 14 14 14 14 14 14 14 14 14 14 14 14 14 9 0 0
9 14 14 14 14 14 14 14 14 14 14 14 14 14 14 14 14 9 0 0 0
9 14 14 14 14 14 14 14 14 14 14 14 14 14 14 9 9 0 0 0 0
0 9 14 14 14 14 14 14 14 14 14 14 14 9 9 9 0 0 0 0 0
0 0 9 9 14 14 14 14 14 14 14 14 9 9 0 0 0 0 0 0 0
0 0 0 0 9 14 14 14 14 14 14 14 9 0 0 0 0 0 0 0 0
0 0 0 0 9 16 16 16 16 14 14 14 9 9 0 0 0 0 0 0 0
0 0 0 0 9 16 16 9 16 14 14 14 9 9 0 9 9 9 9 9 0
0 0 0 0 9 16 16 9 16 9 9 9 9 9 9 16 16 16 16 16 9
0 0 0 0 9 16 16 16 9 9 9 9 9 9 16 16 16 16 9 9 0
0 0 0 0 0 9 9 9 9 9 9 9 9 9 9 9 9 9 0 0 0
