0 0 0 0 16 16 16 16 16 16 0 0 0 0
0 0 16 16 15 15 15 15 15 15 16 16 0 0
0 16 15 15 15 14 15 15 9 9 9 15 16 0
0 16 9 9 14 14 14 14 19 15 15 15 16 0
16 15 19 19 19 14 14 15 15 9 9 15 15 16
16 9 15 14 15 15 15 9 9 15 19 9 9 16
16 19 9 9 9 9 9 19 15 15 15 19 19 16
16 15 19 19 19 19 19 19 15 15 15 15 15 16
16 15 15 15 15 15 15 15 15 15 15 15 15 16
0 16 9 15 15 15 15 9 9 9 9 9 16 0
0 16 15 9 9 9 15 9 15 19 19 15 16 0
0 0 16 16 15 19 15 15 15 15 16 16 0 0
0 0 0 0 16 16 16 16 16 16 0 0 0 0
---
0 0 0 0 15 15 15 15 15 15 0 0 0 0
0 0 15 15 16 16 16 16 16 16 15 15 0 0
0 15 16 16 16 15 16 16 16 16 16 9 15 0
0 15 16 16 15 15 15 15 15 9 9 9 15 0
15 16 14 14 14 15 15 9 9 16 16 9 9 15
15 16 16 9 9 9 9 16 16 9 14 16 16 15
15 16 16 16 16 16 16 16 9 9 9 14 14 15
15 19 16 16 16 16 16 16 9 9 9 9 9 15
15 19 19 19 19 19 19 9 9 9 9 9 9 15
0 15 15 19 19 19 19 15 15 15 15 15 15 0
0 15 19 15 15 15 19 15 19 15 15 14 15 0
0 0 15 15 14 15 19 19 19 19 15 15 0 0
0 0 0 0 15 15 15 15 15 15 0 0 0 0
