2 2 2 2 2 2 2 2 2 2 2 2 2 2 2 2 2 2 2 2 2 2 2 2 2 2 2 2 2 2 2 2 2 2 2 2 2 2 2 2
2 2 2 2 2 2 2 2 2 2 2 2 2 2 2 2 2 2 2 2 2 2 2 2 2 2 2 2 2 2 2 2 2 2 2 2 2 2 2 2
2 16 16 16 16 16 16 16 16 16 16 16 16 16 16 16 16 16 16 16 16 16 16 16 16 16 16 16 16 16 16 16 16 16 16 16 16 16 16 2
2 16 15 9 15 1 1 14 14 4 1 1 15 9 9 9 15 1 1 4 4 14 1 15 15 15 15 1 4 4 4 4 4 1 1 1 1 1 16 2
2 16 1 15 1 4 4 18 4 4 4 14 1 15 15 15 1 4 4 4 4 4 1 15 15 9 9 1 4 4 4 14 14 1 1 1 1 1 16 2
2 16 1 1 1 18 18 18 1 4 4 14 14 1 1 1 4 4 4 4 4 4 1 15 15 9 9 1 4 4 14 1 1 15 15 15 15 15 16 2
2 16 1 1 1 18 18 18 9 1 4 4 14 4 4 4 4 4 1 4 4 4 4 1 1 1 1 4 4 14 14 1 1 15 9 9 9 9 16 2
2 16 4 1 4 18 18 9 9 9 1 4 4 4 4 4 4 4 4 1 1 4 4 4 4 4 4 4 14 4 1 1 15 9 9 9 9 9 16 2
2 16 14 4 1 18 18 9 9 9 1 4 4 1 1 1 4 1 1 14 14 14 14 4 4 4 1 1 1 4 1 1 15 9 9 9 9 9 16 2
2 16 1 14 4 18 18 9 9 1 4 1 1 14 14 14 14 14 14 9 1 4 4 14 14 1 15 15 15 1 1 1 15 9 9 9 9 9 16 2
2 16 1 14 4 18 18 1 1 4 4 1 4 14 4 4 4 15 14 15 1 4 4 4 14 1 15 9 9 1 1 1 15 9 9 9 9 9 16 2
2 16 1 9 14 18 18 14 4 1 1 14 14 4 4 4 4 4 4 14 14 1 4 9 14 1 15 9 9 1 1 1 15 15 9 9 9 9 16 2
2 16 14 1 1 18 18 18 4 14 14 1 4 4 4 4 14 14 4 15 14 1 4 4 15 14 1 1 1 4 4 1 1 15 9 9 9 9 16 2
2 16 14 4 18 18 18 18 18 4 1 14 1 4 4 14 1 14 4 4 14 1 4 4 15 14 4 14 4 4 4 1 1 15 15 15 15 15 16 2
2 16 4 4 18 18 18 18 18 1 4 1 4 4 4 14 1 14 14 4 14 1 4 4 15 14 4 4 14 14 14 14 4 1 1 1 1 1 16 2
2 16 4 4 18 18 18 18 18 4 4 4 1 1 1 14 1 4 4 14 1 4 4 14 14 1 1 1 1 4 4 4 14 1 1 1 1 1 16 2
2 16 4 4 18 18 18 18 18 4 4 1 15 15 15 1 14 1 1 4 14 14 14 14 1 4 4 14 1 1 4 4 4 14 14 4 14 9 16 2
2 16 1 1 18 18 18 18 18 4 1 15 15 9 15 15 1 14 14 1 4 4 4 1 4 4 14 14 4 1 4 4 4 4 4 14 15 4 16 2
2 16 4 1 18 18 18 18 18 1 15 15 9 9 9 15 15 1 14 1 4 4 4 1 4 14 14 14 4 4 1 4 4 4 4 15 4 4 16 2
2 16 4 14 18 18 18 18 4 1 15 9 9 9 9 9 15 1 4 14 1 1 1 4 14 4 4 4 4 4 4 1 4 15 15 4 4 4 16 2
2 16 4 1 18 18 18 18 4 1 15 15 9 9 9 15 15 1 4 4 4 4 4 4 4 4 4 4 4 4 1 15 1 4 4 4 4 18 16 2
2 16 4 4 18 18 18 18 18 4 1 15 15 9 15 15 1 15 15 4 1 1 1 1 14 14 14 14 14 4 14 1 4 4 4 4 18 18 16 2
2 16 4 4 18 18 18 18 18 4 4 1 15 15 15 1 4 15 9 1 4 4 4 4 14 4 4 4 18 18 18 4 4 4 4 4 18 18 16 2
2 16 9 15 18 18 18 18 18 18 4 4 18 1 1 15 1 1 1 1 14 14 14 14 14 4 4 4 18 18 18 18 18 18 18 18 18 18 16 2
2 16 1 14 18 18 18 18 18 18 4 18 4 4 4 1 1 1 4 14 4 4 4 4 4 4 4 18 4 1 1 1 18 18 18 18 4 4 16 2
2 16 4 1 18 18 18 18 18 18 4 18 18 4 14 4 14 14 14 4 4 5 4 4 4 18 18 18 18 1 1 17 17 17 17 17 17 17 16 2
2 16 4 1 18 18 18 18 18 18 4 18 18 4 4 4 4 4 14 4 4 5 4 4 4 1 1 1 1 1 1 17 17 17 17 17 17 17 16 2
2 16 4 18 18 18 18 18 18 18 18 18 18 18 18 4 4 4 4 4 4 5 1 1 1 1 17 17 17 17 17 17 17 17 17 17 17 17 16 2
2 16 5 18 18 18 18 18 18 18 18 18 18 18 18 18 4 4 4 5 5 5 5 17 17 17 17 17 17 17 17 5 5 17 17 17 17 17 16 2
2 16 5 18 18 18 18 18 18 18 18 18 18 18 18 17 5 17 17 5 5 5 5 17 17 17 17 17 17 17 17 5 5 5 5 5 17 17 16 2
2 16 5 18 18 18 18 18 18 18 18 18 18 18 18 17 5 17 17 5 5 5 5 17 17 17 17 17 17 17 17 5 5 5 5 5 17 17 16 2
2 16 17 18 18 18 18 18 18 18 18 18 18 18 18 18 17 5 5 17 17 17 17 17 5 17 17 5 5 17 17 17 17 17 17 18 18 17 16 2
2 16 17 18 18 18 18 18 18 18 18 18 18 18 18 18 17 5 5 5 5 5 5 5 5 5 5 5 5 5 5 17 17 17 17 18 18 17 16 2
2 16 17 17 18 18 18 18 18 18 18 18 18 18 18 18 17 17 17 17 17 17 17 17 5 5 5 18 18 18 18 18 18 18 18 18 18 18 16 2
2 16 17 17 18 18 18 18 18 18 18 18 18 18 18 18 17 17 17 17 17 17 17 17 5 5 5 18 18 18 18 18 18 18 18 18 18 18 16 2
2 16 9 9 9 9 9 9 9 9 9 9 9 9 9 9 9 9 9 9 9 9 9 9 9 9 9 9 9 9 9 9 9 9 9 9 9 9 16 2
2 2 2 2 2 2 2 2 2 2 2 2 2 2 2 2 2 2 2 2 2 2 2 2 2 2 2 2 2 2 2 2 2 2 2 2 2 2 2 2
2 2 2 2 2 2 2 2 2 2 2 2 2 2 2 2 2 2 2 2 2 2 2 2 2 2 2 2 2 2 2 2 2 2 2 2 2 2 2 2
2 2 2 2 2 2 2 2 2 2 2 2 2 2 2 2 2 2 2 2 2 2 2 2 2 2 2 2 2 2 2 2 2 2 2 2 2 2 2 2
16 16 16 16 16 16 16 16 16 16 16 16 16 16 16 16 16 16 16 16 16 16 16 16 16 16 16 16 16 16 16 16 16 16 16 16 16 16 16 16
---
18 18 18 18 18 18 18 18 18 18 18 18 18 18 18 18 18 18 18 16 2 2 2 2 2 2 2 2 2 2 2 2 2 2 2 2 2 2 2 2
18 18 18 18 18 18 18 18 18 18 18 18 18 18 18 18 18 18 18 16 2 2 2 2 2 2 2 2 2 2 2 2 2 2 2 2 2 2 2 2
18 14 14 14 14 14 14 14 14 14 14 14 14 14 14 14 14 14 14 14 16 16 16 16 16 16 16 16 16 16 16 16 16 16 16 16 16 16 16 2
18 14 14 4 14 4 4 1 1 1 4 4 4 15 15 15 4 4 4 16 4 14 1 15 15 15 15 1 4 4 4 4 4 1 1 1 1 1 16 2
18 14 4 14 4 14 14 4 1 1 1 9 4 4 4 4 4 1 1 16 4 4 1 15 15 9 9 1 4 4 4 14 14 1 1 1 1 1 16 2
18 14 4 4 4 4 4 4 2 1 1 9 9 4 4 4 1 1 1 16 4 4 1 15 15 9 9 1 4 4 14 1 1 15 15 15 15 15 16 2
18 14 4 4 4 4 4 4 4 2 1 1 9 1 1 1 1 1 9 16 4 4 4 1 1 1 1 4 4 14 14 1 1 15 9 9 9 9 16 2
18 14 2 4 2 4 4 4 4 4 2 1 1 1 1 1 1 1 1 16 1 4 4 4 4 4 4 4 14 4 1 1 15 9 9 9 9 9 16 2
18 14 4 2 4 4 4 4 4 4 2 1 1 2 2 2 1 2 2 16 14 14 14 4 4 4 1 1 1 4 1 1 15 9 9 9 9 9 16 2
18 14 15 4 2 4 4 4 4 2 1 2 2 2 2 2 2 2 2 16 1 4 4 14 14 1 15 15 15 1 1 1 15 9 9 9 9 9 16 2
18 14 15 4 2 4 4 2 2 1 1 2 1 2 1 1 1 9 2 16 1 4 4 4 14 1 15 9 9 1 1 1 15 9 9 9 9 9 16 2
18 14 15 2 4 4 4 15 1 2 2 2 2 1 1 1 1 1 1 16 14 1 4 9 14 1 15 9 9 1 1 1 15 15 9 9 9 9 16 2
18 14 1 15 15 4 4 4 1 2 2 2 1 1 1 1 15 15 1 16 14 1 4 4 15 14 1 1 1 4 4 1 1 15 9 9 9 9 16 2
18 14 1 9 4 4 4 4 4 1 2 2 2 1 1 15 2 15 1 16 14 1 4 4 15 14 4 14 4 4 4 1 1 15 15 15 15 15 16 2
18 14 9 9 4 4 4 4 4 2 1 2 1 1 1 15 2 15 15 16 14 1 4 4 15 14 4 4 14 14 14 14 4 1 1 1 1 1 16 2
18 14 9 9 4 4 4 4 4 1 1 1 2 2 2 15 2 15 15 16 1 4 4 14 14 1 1 1 1 4 4 4 14 1 1 1 1 1 16 2
18 14 9 9 4 4 4 4 4 1 1 2 9 9 9 2 15 2 2 16 14 14 14 14 1 4 4 14 1 1 4 4 4 14 14 4 14 9 16 2
18 14 2 2 4 4 4 4 4 1 2 9 9 1 9 9 2 15 15 16 4 4 4 1 4 4 14 14 4 1 4 4 4 4 4 14 15 4 16 2
14 14 14 2 4 4 4 4 4 2 9 9 1 1 1 9 9 2 15 16 4 4 4 1 4 14 14 14 4 4 1 4 4 4 4 15 4 4 16 2
16 14 16 16 16 16 16 16 16 16 16 16 16 16 16 16 16 16 16 15 1 1 1 4 14 4 4 4 4 4 4 1 4 15 15 4 4 4 16 2
2 16 4 1 18 18 18 18 4 1 15 15 9 9 9 15 15 1 4 2 16 16 16 16 16 16 16 16 16 16 16 16 16 16 16 16 16 16 16 17
2 16 4 4 18 18 18 18 18 4 1 15 15 9 15 15 1 15 15 16 4 4 4 4 17 17 17 17 17 17 18 15 5 5 5 5 9 9 1 17
2 16 4 4 18 18 18 18 18 4 4 1 15 15 15 1 4 15 9 16 1 1 1 1 17 18 18 18 9 2 14 5 5 5 5 5 9 9 1 17
2 16 9 15 18 18 18 18 18 18 4 4 18 1 1 15 1 1 1 16 17 17 17 17 17 18 18 18 9 9 9 9 9 9 9 9 9 9 1 17
2 16 1 14 18 18 18 18 18 18 4 18 4 4 4 1 1 1 4 16 18 18 18 18 18 18 18 1 18 18 18 18 9 9 9 9 18 18 1 17
2 16 4 1 18 18 18 18 18 18 4 18 18 4 14 4 14 14 14 16 18 18 18 18 18 1 1 1 1 18 18 2 2 2 2 2 2 2 1 17
2 16 4 1 18 18 18 18 18 18 4 18 18 4 4 4 4 4 14 16 18 18 18 18 18 18 18 18 18 18 18 2 2 2 2 2 2 2 1 17
2 16 4 18 18 18 18 18 18 18 18 18 18 18 18 4 4 4 4 16 18 18 18 18 18 18 2 2 2 2 2 2 2 2 2 2 2 2 1 17
2 16 5 18 18 18 18 18 18 18 18 18 18 18 18 18 4 4 4 16 18 18 18 2 2 2 2 2 2 2 2 14 14 2 2 2 2 2 1 17
2 16 5 18 18 18 18 18 18 18 18 18 18 18 18 17 5 17 17 16 18 18 18 2 2 2 2 2 2 2 2 14 14 14 14 14 2 2 1 17
2 16 5 18 18 18 18 18 18 18 18 18 18 18 18 17 5 17 17 16 18 18 18 2 2 2 2 2 2 2 2 14 14 14 14 14 2 2 1 17
2 16 17 18 18 18 18 18 18 18 18 18 18 18 18 18 17 5 5 16 2 2 2 2 4 2 2 4 4 2 2 2 2 2 2 4 4 2 1 17
2 16 17 18 18 18 18 18 18 18 18 18 18 18 18 18 17 5 5 16 4 4 4 4 4 4 4 4 4 4 4 2 2 2 2 4 4 2 1 17
2 16 17 17 18 18 18 18 18 18 18 18 18 18 18 18 17 17 17 16 4 4 4 4 4 4 4 4 4 4 4 4 4 4 4 4 4 4 1 17
2 16 17 17 18 18 18 18 18 18 18 18 18 18 18 18 17 17 17 16 4 4 4 4 4 4 4 4 4 4 4 4 4 4 4 4 4 4 1 17
2 16 9 9 9 9 9 9 9 9 9 9 9 9 9 9 9 9 9 16 5 5 5 5 5 5 5 5 5 5 5 5 5 5 5 5 5 5 1 17
2 2 2 2 2 2 2 2 2 2 2 2 2 2 2 2 2 2 2 16 17 17 17 17 17 17 17 17 17 17 17 17 17 17 17 17 17 17 17 17
2 2 2 2 2 2 2 2 2 2 2 2 2 2 2 2 2 2 2 16 17 17 17 17 17 17 17 17 17 17 17 17 17 17 17 17 17 17 17 17
2 2 2 2 2 2 2 2 2 2 2 2 2 2 2 2 2 2 2 16 17 17 17 17 17 17 17 17 17 17 17 17 17 17 17 17 17 17 17 17
16 16 16 16 16 16 16 16 16 16 16 16 16 16 16 16 16 16 16 5 5 5 5 5 5 5 5 5 5 5 5 5 5 5 5 5 5 5 5 5
