3 3 16 16 16 16 16 3 3 3 3 3
3 16 15 15 15 15 15 16 16 3 3 3
16 15 15 15 15 15 15 9 9 16 3 3
16 15 16 16 16 15 15 9 9 16 3 3
16 15 16 16 16 15 15 9 9 16 17 3
16 15 15 9 16 15 15 9 9 16 17 3
3 16 9 16 15 15 9 9 9 16 17 3
3 16 16 9 9 9 9 16 16 3 17 17
3 3 3 16 16 16 16 3 3 17 17 6
3 3 17 6 6 6 17 3 3 17 17 6
3 17 6 6 17 6 6 17 17 17 3 17
3 3 17 6 6 17 17 17 17 3 3 3
---
3 3 3 3 3 3 3 9 9 9 9 9
3 3 16 16 16 16 16 3 3 9 9 9
3 16 16 16 16 16 16 17 17 3 9 9
3 16 3 3 3 16 16 17 17 3 9 9
3 16 3 3 3 16 16 17 17 3 15 9
3 16 16 17 3 16 16 17 17 3 15 9
6 3 17 3 16 16 17 17 17 3 15 9
6 3 3 17 17 17 17 3 3 17 15 15
6 6 6 3 3 3 3 17 17 15 15 9
6 6 16 16 16 16 15 17 17 15 15 9
6 16 16 16 15 16 16 15 15 15 15 15
6 6 6 16 16 15 15 15 15 15 15 15
