0 0 0 0 0 0 0 0 0 0 0 16 16 0 16 16 0 0 0 0 0 0 0 0 0 0 0 0
0 0 0 0 0 0 0 0 0 0 16 14 13 16 13 13 16 0 0 0 0 0 0 0 0 0 0 0
0 0 0 0 0 0 0 0 0 0 16 13 13 13 13 13 16 0 0 0 0 0 0 0 0 0 0 0
0 0 0 0 0 16 0 16 0 0 0 16 13 13 13 16 0 0 0 0 16 0 16 0 0 0 0 0
0 0 0 0 16 14 16 13 16 0 0 0 16 13 16 0 0 0 0 16 14 16 13 16 0 0 0 0
0 0 0 0 16 13 13 13 16 0 0 0 0 16 0 0 0 0 0 16 13 13 13 16 0 0 0 0
0 0 0 0 0 16 13 16 0 0 0 0 0 0 0 0 0 0 0 0 16 13 16 0 0 0 0 0
0 0 0 0 0 0 16 0 0 16 16 0 0 0 0 0 0 16 16 0 0 16 0 0 0 0 0 0
0 0 0 0 0 0 0 0 16 19 19 16 0 0 0 0 16 14 14 16 0 0 0 0 0 0 0 0
0 0 0 16 16 16 0 0 16 19 10 16 0 0 0 0 16 10 14 16 0 0 16 16 16 0 0 0
0 0 16 19 19 19 16 0 16 19 10 19 16 0 0 16 14 10 14 16 0 16 14 14 14 16 0 0
0 0 16 19 10 10 19 16 0 16 16 19 16 0 0 16 14 16 16 0 16 14 10 10 14 16 0 0
0 0 0 16 19 10 10 19 16 19 19 16 16 16 16 14 14 14 14 16 14 10 10 14 16 0 0 0
0 0 0 0 16 19 16 19 19 19 19 19 19 16 14 14 14 14 14 14 14 16 14 16 0 0 0 0
0 0 0 0 0 16 19 19 19 19 19 19 19 16 14 14 14 14 14 14 14 14 16 0 0 0 0 0
0 0 0 0 0 16 19 19 19 16 19 19 16 14 16 14 14 14 16 14 14 14 16 0 0 0 0 0
0 0 0 0 0 16 19 19 16 19 19 10 16 10 14 16 10 14 14 16 14 14 16 0 0 0 0 0
0 0 0 0 0 16 19 19 19 19 19 19 16 14 14 14 14 14 14 14 14 14 16 0 0 0 0 0
0 0 0 0 0 0 16 16 19 19 16 16 16 16 16 14 14 14 14 14 16 16 0 0 0 0 0 0
0 16 13 16 0 0 16 19 16 19 19 19 19 19 19 16 16 14 14 16 14 16 0 0 16 13 16 0
16 13 13 13 16 0 16 19 19 19 19 19 19 19 16 14 14 14 14 14 14 16 0 16 13 13 13 16
16 13 7 13 16 16 19 19 19 19 16 16 16 16 14 14 14 16 14 14 14 14 16 16 13 7 13 16
0 16 16 16 0 16 19 19 19 19 19 19 19 16 16 16 16 14 14 14 14 14 16 0 16 16 16 0
5 0 16 0 5 0 16 19 19 19 19 19 16 14 16 14 14 14 14 14 14 16 0 5 0 16 0 5
0 5 5 5 0 0 0 16 16 16 16 16 16 16 16 16 16 16 16 16 16 0 0 0 5 5 5 0
0 0 5 0 0 0 0 0 0 0 0 0 0 0 0 0 0 0 0 0 0 0 0 0 0 5 0 0
0 0 0 0 0 0 16 0 16 0 0 0 16 0 16 16 0 0 0 16 0 16 0 0 0 0 0 0
0 0 0 0 0 16 7 16 7 16 0 16 7 16 7 10 16 0 16 7 13 10 16 0 0 0 0 0
0 0 0 0 0 16 7 7 13 0 15 16 7 7 7 10 16 15 0 16 10 10 16 0 0 0 0 0
0 0 0 0 0 0 16 16 0 0 15 0 16 7 10 16 0 15 0 0 16 16 0 0 0 0 0 0
0 0 0 0 0 0 0 0 0 0 0 0 0 16 16 0 0 0 0 0 0 0 0 0 0 0 0 0
---
0 0 0 0 0 0 0 0 0 0 0 13 13 0 13 13 0 0 0 0 0 0 0 0 0 0 0 0
0 0 0 0 0 0 0 0 0 0 13 16 16 13 16 16 13 0 0 0 0 0 0 0 0 0 0 0
0 0 0 0 0 0 0 0 0 0 13 16 16 16 16 16 13 0 0 0 0 0 0 0 0 0 0 0
0 0 0 0 0 7 0 7 0 0 0 13 16 16 16 13 0 0 0 0 14 0 14 0 0 0 0 0
0 0 0 0 7 16 7 16 7 0 0 0 13 16 13 0 0 0 0 14 16 14 16 14 0 0 0 0
0 0 0 0 7 16 16 16 7 0 0 0 0 13 0 0 0 0 0 14 16 16 16 14 0 0 0 0
0 0 0 0 0 7 16 7 0 0 0 0 0 0 0 0 0 0 0 0 14 16 14 0 0 0 0 0
0 0 0 0 0 0 7 0 0 19 19 0 0 0 0 0 0 10 10 0 0 14 0 0 0 0 0 0
0 0 0 0 0 0 0 0 19 14 14 19 0 0 0 0 10 16 16 10 0 0 0 0 0 0 0 0
0 0 0 19 19 19 0 0 19 14 16 19 0 0 0 0 10 16 16 10 0 0 7 19 19 0 0 0
0 0 19 14 14 14 19 0 19 14 16 14 19 0 0 10 16 16 16 10 0 7 16 16 16 19 0 0
0 0 19 14 16 16 14 19 0 19 19 14 19 0 0 10 16 10 10 0 7 16 16 16 16 19 0 0
0 0 0 19 14 16 16 14 19 14 14 19 19 19 10 16 16 16 16 10 16 16 16 16 19 0 0 0
0 0 0 0 19 14 19 14 14 14 14 14 14 19 16 16 16 16 16 16 16 19 16 19 0 0 0 0
0 0 0 0 0 19 14 14 14 14 14 14 14 19 16 16 16 16 16 16 16 16 19 0 0 0 0 0
0 0 0 0 0 19 14 14 14 15 14 14 19 16 19 16 16 16 15 16 16 16 19 0 0 0 0 0
0 0 0 0 0 19 14 14 15 14 14 16 19 16 16 19 16 16 16 15 16 16 19 0 0 0 0 0
0 0 0 0 0 19 14 14 14 14 14 14 19 16 16 16 16 16 16 16 16 16 19 0 0 0 0 0
0 0 0 0 0 0 19 19 14 14 19 19 19 19 19 16 16 16 16 16 19 19 0 0 0 0 0 0
0 13 16 13 0 0 19 14 19 14 14 14 14 14 14 19 19 16 16 19 16 19 0 0 13 16 13 0
13 16 16 16 13 0 19 14 14 14 14 14 14 14 19 16 16 16 16 16 16 19 0 13 16 16 16 13
13 16 16 16 13 13 14 14 14 14 19 19 19 19 16 16 16 19 16 16 16 16 13 13 16 16 16 13
0 13 13 13 0 14 14 14 14 14 14 14 14 19 19 19 19 16 16 16 16 16 14 0 13 13 13 0
16 0 13 0 16 0 14 14 14 14 14 14 19 16 19 16 16 16 16 16 16 14 0 16 0 13 0 16
0 16 16 16 0 0 0 16 16 16 16 16 16 16 16 16 16 16 16 16 16 0 0 0 16 16 16 0
0 0 16 0 0 0 0 0 0 0 0 0 0 0 0 0 0 0 0 0 0 0 0 0 0 16 0 0
0 0 0 0 0 0 10 0 10 0 0 0 5 0 5 5 0 0 0 16 0 16 0 0 0 0 0 0
0 0 0 0 0 10 16 10 16 10 0 5 16 5 16 16 5 0 16 16 16 16 16 0 0 0 0 0
0 0 0 0 0 10 16 16 16 0 16 5 16 16 16 16 5 16 0 16 16 16 16 0 0 0 0 0
0 0 0 0 0 0 10 10 0 0 16 0 5 16 16 5 0 16 0 0 16 16 0 0 0 0 0 0
0 0 0 0 0 0 0 0 0 0 0 0 0 5 5 0 0 0 0 0 0 0 0 0 0 0 0 0
