0 0 0 5 5 0 0 0 0 0 0 0 0
0 0 0 5 5 5 0 16 16 0 0 0 0
0 0 0 0 5 5 16 16 0 0 0 0 0
0 0 13 13 13 0 16 0 13 13 13 0 0
0 13 8 8 8 13 16 13 8 8 8 13 0
13 8 8 8 8 8 13 8 8 8 8 8 13
13 8 8 8 9 9 8 9 9 8 8 8 13
13 8 8 9 9 16 8 16 9 9 8 8 13
13 8 8 9 9 16 8 16 9 9 8 8 13
13 8 8 8 9 16 8 16 9 8 8 8 13
0 13 8 8 8 9 8 9 8 8 8 13 0
0 13 8 8 8 8 8 8 8 8 8 13 0
0 0 13 8 8 8 16 8 8 8 13 0 0
0 0 0 13 13 13 0 13 13 13 0 0 0
---
0 0 0 8 8 0 0 0 0 0 0 0 0
0 0 0 8 8 8 0 8 8 0 0 0 0
0 0 0 0 8 8 8 8 0 0 0 0 0
0 0 8 8 8 0 8 0 8 8 8 0 0
0 8 13 13 13 8 8 8 16 16 16 8 0
8 13 13 13 13 13 8 16 16 16 16 16 8
8 13 13 13 8 8 13 8 8 16 16 16 8
8 13 13 8 8 5 13 5 8 8 16 16 8
8 13 13 8 8 5 13 5 8 8 9 9 8
8 13 13 13 8 5 13 5 8 9 9 9 8
0 8 13 13 13 8 13 8 9 9 9 8 0
0 8 13 13 13 13 9 9 9 9 9 8 0
0 0 8 13 13 13 5 9 9 9 8 0 0
0 0 0 8 8 8 0 8 8 8 0 0 0
