0 0 0 0 0 0 0 0 0 0 0 13 13 0 0 0 0 0 0 0 0 0 0 0 0
0 0 0 0 0 0 0 0 0 0 13 13 9 13 0 0 0 0 0 0 0 0 0 0 0
0 0 0 0 0 0 0 0 0 13 13 9 9 9 13 0 0 13 0 0 0 0 0 0 0
0 0 0 0 0 0 0 0 13 13 9 9 9 9 9 13 13 9 13 0 0 0 0 0 0
0 0 0 0 0 0 0 13 13 9 9 9 15 9 9 9 13 9 9 13 0 0 0 0 0
0 0 0 0 0 0 13 13 9 9 9 15 15 15 9 9 9 9 9 9 13 0 0 0 0
0 0 13 13 13 13 13 9 9 9 15 15 15 15 15 15 9 15 9 9 13 0 0 0 0
0 0 13 9 9 13 9 9 9 15 15 15 15 15 15 15 15 15 15 9 9 13 0 0 0
0 0 13 9 9 9 13 9 15 15 15 15 15 15 15 15 15 13 13 15 9 13 0 0 0
0 0 13 9 15 9 9 9 13 13 15 15 15 15 15 15 13 14 14 13 9 13 0 0 0
0 0 13 9 15 15 9 13 14 14 13 15 15 15 15 15 13 14 14 13 15 9 13 0 0
0 13 13 9 15 15 15 13 14 14 13 15 15 13 13 15 15 13 13 15 15 9 13 0 0
0 13 9 9 15 15 15 15 13 13 15 15 13 15 15 13 15 15 15 15 15 13 16 16 0
0 13 9 9 15 15 15 15 15 15 15 15 15 15 15 15 15 15 13 15 15 13 2 16 0
0 0 13 13 13 13 13 15 15 15 15 13 13 13 13 13 13 13 13 15 15 13 2 16 0
0 16 16 16 16 2 2 13 15 15 15 13 2 2 2 2 2 2 13 13 13 2 2 16 0
16 2 2 2 2 16 16 2 13 13 13 13 2 2 2 2 2 2 2 2 2 2 16 0 0
16 2 2 2 2 2 2 16 2 2 16 2 2 2 2 2 2 2 2 2 2 16 13 0 0
16 2 2 16 16 16 2 16 16 2 2 16 2 2 16 16 2 2 2 2 16 15 9 13 0
16 2 2 16 2 16 2 2 16 2 2 16 2 16 2 2 2 2 2 16 15 15 9 9 13
16 2 2 16 2 2 2 2 16 2 2 16 16 2 2 2 2 16 16 15 15 15 15 9 13
16 2 2 16 16 2 2 2 16 2 2 16 2 2 2 16 16 15 15 15 9 9 9 9 13
16 2 2 2 16 16 16 16 16 2 16 2 2 2 16 15 15 15 9 9 13 13 13 13 0
0 16 16 2 2 2 2 2 2 2 16 2 2 16 15 15 15 9 13 13 0 0 0 0 0
0 0 16 16 16 16 16 16 16 16 15 16 16 15 15 13 13 13 0 0 0 0 0 0 0
0 0 0 0 0 0 13 9 9 9 15 15 15 15 15 9 13 0 0 0 0 0 0 0 0
0 0 0 0 0 0 0 13 13 13 9 9 9 9 9 13 0 0 0 0 0 0 0 0 0
0 0 0 0 0 0 0 0 0 13 13 13 13 13 13 0 0 0 0 0 0 0 0 0 0
---
0 0 0 0 0 0 0 0 0 0 0 2 2 0 0 0 0 0 0 0 0 0 0 0 0
0 0 0 0 0 0 0 0 0 0 2 2 16 2 0 0 0 0 0 0 0 0 0 0 0
0 0 0 0 0 0 0 0 0 2 2 16 16 16 2 0 0 2 0 0 0 0 0 0 0
0 0 0 0 0 0 0 0 2 2 16 16 16 16 16 2 2 16 2 0 0 0 0 0 0
0 0 0 0 0 0 0 2 2 16 16 16 13 16 16 16 2 16 16 2 0 0 0 0 0
0 0 0 0 0 0 2 2 16 16 16 13 13 13 16 16 16 16 16 16 2 0 0 0 0
0 0 2 2 2 2 2 16 16 16 13 13 13 13 13 13 16 13 16 16 2 0 0 0 0
0 0 2 16 16 2 16 16 16 13 13 13 13 13 13 13 13 13 13 16 16 2 0 0 0
0 0 2 16 16 16 2 16 13 13 13 13 13 13 13 13 13 16 16 13 16 2 0 0 0
0 0 2 16 13 16 16 16 9 9 13 13 13 13 13 13 16 15 15 16 16 2 0 0 0
0 0 2 16 13 13 16 9 14 14 9 13 13 13 13 13 16 15 15 16 13 16 2 0 0
0 2 2 16 13 13 13 9 14 14 9 13 13 14 14 13 13 16 16 13 13 16 2 0 0
0 2 16 16 13 13 13 13 9 9 13 13 14 13 13 14 13 13 13 13 13 2 9 9 0
0 2 16 16 13 13 13 13 13 13 13 13 13 13 13 13 13 13 2 13 13 2 15 9 0
0 0 2 2 2 2 2 13 13 13 13 2 2 2 2 2 2 2 2 13 13 2 15 9 0
0 9 9 9 9 2 2 2 13 13 13 2 15 15 15 15 15 15 2 2 2 15 15 9 0
9 15 15 15 15 9 9 9 2 2 2 2 15 15 15 15 15 15 15 15 15 15 9 0 0
9 15 15 15 15 15 15 9 15 15 9 15 15 15 15 15 15 15 15 15 15 9 2 0 0
9 15 15 9 9 9 15 9 9 15 15 9 15 15 9 9 15 15 15 15 9 16 2 2 0
9 15 15 9 15 9 15 15 9 15 15 9 15 9 15 15 15 15 15 9 16 16 2 2 2
9 15 15 9 15 15 15 15 9 15 15 9 9 15 15 15 15 9 9 13 13 13 13 2 2
9 15 15 9 9 15 15 15 9 15 15 9 15 15 15 9 9 13 13 13 2 2 2 2 2
9 15 15 15 9 9 9 9 9 15 9 15 15 15 9 13 13 13 2 2 2 2 2 2 0
0 9 9 15 15 15 15 15 15 15 9 15 15 9 13 13 13 2 2 2 0 0 0 0 0
0 0 9 9 9 9 9 9 9 9 13 9 9 13 13 2 2 2 0 0 0 0 0 0 0
0 0 0 0 0 0 2 15 15 15 13 13 13 13 13 15 2 0 0 0 0 0 0 0 0
0 0 0 0 0 0 0 2 2 2 15 15 15 15 15 2 0 0 0 0 0 0 0 0 0
0 0 0 0 0 0 0 0 0 2 2 2 2 2 2 0 0 0 0 0 0 0 0 0 0
