13 13 13 13 5 5 5 5 5 5 13 13
13 13 13 13 6 6 6 6 6 6 13 13
13 13 13 13 8 5 8 5 8 5 13 13
13 13 13 13 5 8 5 8 5 8 13 13
13 13 13 13 5 5 5 5 5 5 13 13
13 13 13 13 5 5 5 5 5 5 13 13
13 13 13 5 5 5 5 5 5 5 13 13
13 13 5 8 5 5 5 5 6 6 13 13
13 6 5 5 8 5 5 5 6 6 13 13
13 6 6 5 5 8 5 5 6 13 13 13
13 6 6 6 5 5 8 5 13 13 13 13
13 13 6 6 6 5 5 13 13 13 13 13
---
5 5 5 5 8 8 8 8 8 8 6 6
5 5 5 5 13 13 13 13 13 13 6 6
5 5 5 5 5 13 5 13 5 13 6 6
5 5 5 5 13 5 13 5 13 5 6 6
5 5 5 5 13 13 13 13 13 13 6 6
5 5 5 5 13 13 13 13 13 13 6 6
5 5 5 13 13 13 13 13 13 13 6 6
5 5 13 8 13 13 13 13 13 13 6 6
5 13 13 13 8 13 13 13 13 13 6 6
5 13 13 13 13 8 13 13 13 5 6 6
5 13 13 13 13 13 8 13 5 5 5 5
5 5 13 13 13 13 13 5 5 5 5 5
