0 0 0 0 16 16 16 16 0 0 0 0
0 0 0 16 9 15 14 14 16 0 0 0
0 0 16 9 15 15 10 10 15 16 0 0
0 16 9 15 15 10 10 10 10 15 16 0
0 16 9 15 10 10 14 14 10 10 16 0
16 14 15 15 10 10 14 14 14 10 14 16
16 9 15 15 10 11 11 14 14 10 15 16
16 9 15 15 10 11 11 11 11 10 15 16
0 16 9 15 10 11 11 11 14 10 16 0
0 16 9 15 15 10 11 11 10 15 16 0
0 0 16 9 15 15 10 10 15 16 0 0
0 0 0 16 9 9 15 15 16 0 0 0
0 0 0 0 16 16 16 16 0 0 0 0
---
0 0 0 0 11 11 11 11 0 0 0 0
0 0 0 11 10 16 11 11 9 0 0 0
0 0 11 10 16 16 15 15 11 9 0 0
0 11 10 16 16 15 15 15 15 11 9 0
0 14 10 16 15 15 10 10 15 15 9 0
14 16 16 16 15 15 10 10 10 15 16 9
14 16 16 16 15 10 10 10 10 15 15 9
14 16 16 16 15 10 10 10 10 15 15 9
0 14 16 16 15 10 10 10 10 15 9 0
0 14 16 16 16 15 10 10 15 16 9 0
0 0 14 16 16 16 15 15 16 9 0 0
0 0 0 14 16 16 16 16 9 0 0 0
0 0 0 0 14 14 14 14 0 0 0 0
