18 18 18 18 18 18 18 18 18 18 18 18 18 18 18 18 18 18 18 18 4 4 11 11 11 11 11 11 11 11 11 18
18 18 14 18 18 18 18 18 18 18 18 18 14 18 18 18 18 18 4 4 11 11 11 11 11 11 11 11 11 11 19 11
18 14 18 14 18 18 18 18 18 18 18 18 18 18 18 18 4 4 11 11 11 11 11 11 10 10 10 10 10 19 11 11
18 18 14 18 18 18 14 18 18 18 4 4 4 4 4 4 11 11 11 11 11 11 10 10 10 19 19 19 8 10 11 11
18 18 18 18 18 18 14 18 4 4 11 11 11 11 11 11 11 11 11 11 10 10 10 19 19 19 8 8 19 10 11 11
18 18 18 18 18 18 14 4 11 11 11 11 11 11 11 11 11 11 10 10 10 19 19 19 8 8 8 8 19 10 11 11
18 18 18 14 18 14 11 14 11 14 11 11 10 10 10 10 10 10 10 19 19 19 8 8 8 8 8 19 19 10 11 11
18 18 18 18 18 4 14 11 11 11 10 10 10 19 19 19 19 19 19 19 19 8 8 8 8 8 8 19 10 11 11 11
18 18 18 18 4 11 14 11 10 10 10 19 19 19 8 8 8 8 8 19 8 8 8 8 8 8 19 10 10 11 11 11
18 18 18 18 4 11 11 11 10 19 19 19 8 8 8 8 8 8 8 8 8 8 8 8 8 19 10 10 11 11 11 11
18 18 18 4 11 11 11 10 10 19 8 8 8 1 1 1 1 1 1 8 8 8 8 8 19 10 10 10 11 14 11 18
18 18 18 4 11 11 11 10 19 19 8 8 1 4 4 4 4 4 4 1 8 8 8 19 10 10 10 11 11 11 11 18
18 18 18 4 11 11 10 10 19 8 8 1 4 4 4 4 4 4 4 4 8 8 19 10 10 10 10 11 11 14 4 18
18 18 18 4 11 11 10 19 19 8 8 4 4 4 4 4 4 8 4 8 8 19 10 10 19 10 14 11 14 11 14 18
18 14 18 4 11 11 10 19 19 8 1 4 4 4 4 4 4 4 8 8 19 10 10 8 19 10 11 11 11 14 18 18
18 18 18 4 11 11 10 19 8 8 1 4 4 4 4 8 4 8 8 19 10 10 8 8 19 10 11 11 11 14 18 18
18 18 4 11 11 11 10 19 8 8 1 4 4 4 8 4 8 8 19 10 10 1 8 8 19 10 11 11 11 4 18 18
18 18 4 11 11 11 10 19 8 8 1 4 4 8 4 8 8 19 10 10 4 1 8 19 19 10 11 11 4 18 18 18
18 4 11 11 11 10 10 19 8 8 8 1 4 4 8 8 19 10 10 4 1 8 8 19 10 10 11 11 4 14 18 18
18 4 11 11 11 10 19 19 19 8 8 1 1 8 8 19 10 10 4 1 1 8 19 19 10 11 11 11 4 18 18 18
4 11 11 11 10 10 19 19 19 8 8 8 8 8 19 10 10 1 1 1 8 8 19 10 10 11 11 11 4 18 18 18
4 11 11 11 10 19 19 19 8 8 8 8 8 19 10 10 1 8 8 8 8 19 19 10 11 11 11 4 18 18 18 18
4 11 11 10 10 19 19 8 8 8 8 8 19 10 10 8 8 8 8 19 19 19 10 10 11 11 11 4 18 18 18 18
11 11 11 10 19 19 8 8 8 8 8 19 10 10 19 19 19 19 19 19 10 10 10 11 11 11 4 18 18 18 18 18
11 11 11 10 19 19 8 8 8 8 19 10 10 10 10 19 19 19 10 10 10 11 11 11 11 11 4 18 18 14 18 18
11 11 10 10 19 8 8 8 8 19 10 10 10 10 10 10 10 10 10 14 11 11 11 11 11 4 18 18 18 18 18 18
11 11 10 19 19 8 8 8 19 10 10 10 11 11 11 11 11 11 11 11 11 11 11 4 4 18 18 18 18 18 18 18
11 11 10 19 8 8 19 19 10 10 10 11 11 11 11 11 11 11 11 14 11 4 4 18 18 18 18 18 18 18 18 18
11 11 10 19 19 19 10 10 10 11 11 11 11 11 11 11 14 4 14 4 14 18 14 18 18 18 18 18 14 18 18 18
11 11 19 10 10 10 10 11 11 11 11 11 11 11 4 4 18 18 18 14 18 18 18 18 18 18 18 14 18 14 18 18
11 19 11 11 11 11 11 11 11 11 11 11 4 4 18 18 18 18 18 18 18 18 18 18 18 18 18 18 14 18 18 18
4 11 11 11 11 11 11 11 11 11 4 4 18 18 18 18 18 18 18 14 18 18 18 18 18 18 18 18 18 18 18 18
---
10 10 10 10 10 10 10 10 10 10 10 10 10 10 10 10 10 10 10 10 4 4 19 19 19 19 19 19 19 19 19 4
10 10 4 10 10 10 10 10 10 10 10 10 4 10 10 10 10 10 10 4 19 19 19 19 19 19 19 19 19 19 4 1
10 4 10 4 10 10 10 10 10 10 10 10 10 10 10 10 10 10 19 19 19 19 19 19 18 18 18 18 18 4 1 1
10 10 4 10 10 10 4 10 10 10 10 10 10 10 10 10 19 19 19 19 19 19 18 18 18 11 11 11 11 18 1 1
10 10 10 10 10 10 4 10 10 10 19 19 19 19 19 19 19 19 19 19 18 18 18 11 11 11 11 11 11 18 1 1
10 10 10 10 10 10 4 10 19 19 19 19 19 19 19 19 19 19 18 18 18 11 11 11 11 11 11 11 11 18 1 1
10 10 10 4 10 4 19 4 19 4 19 19 18 18 18 18 18 18 18 11 11 11 11 11 11 11 11 11 11 18 1 1
10 10 10 10 10 10 4 19 19 19 18 18 18 11 11 11 11 11 11 11 11 11 11 11 11 11 11 11 18 1 1 1
10 10 10 10 10 19 4 19 18 18 18 11 11 11 11 11 11 11 11 11 11 11 11 11 11 11 11 18 18 19 1 1
10 10 10 10 10 19 19 19 18 11 11 11 11 11 11 11 11 11 11 11 11 11 11 11 11 11 18 18 1 1 1 1
10 10 10 10 19 19 19 18 18 11 11 11 11 18 18 18 18 18 18 11 11 11 11 11 11 18 18 18 1 4 1 8
10 10 10 10 19 19 19 18 11 11 11 11 18 18 18 18 18 18 18 18 11 11 11 11 18 18 18 14 1 1 1 8
10 10 10 10 19 19 18 18 11 11 11 18 18 18 18 18 18 18 18 18 11 11 11 18 18 18 18 14 14 4 8 8
10 10 10 10 19 19 18 11 11 11 11 18 18 18 18 18 18 11 18 11 11 11 18 18 18 18 4 14 4 14 4 8
10 4 10 10 19 19 18 11 11 11 18 18 18 18 18 18 18 18 11 11 11 18 18 18 11 18 14 14 14 4 8 8
10 10 10 10 19 19 18 11 11 11 18 18 18 18 18 11 18 11 11 11 18 18 18 18 11 18 14 14 14 4 8 8
10 10 10 19 19 19 18 11 11 11 18 18 18 18 11 18 11 11 11 18 18 18 18 18 11 18 14 14 14 8 8 8
10 10 10 19 19 19 18 11 11 11 18 18 18 11 18 11 11 11 18 18 18 18 18 11 11 18 14 14 8 8 8 8
10 10 19 19 19 18 18 11 11 11 11 18 18 18 11 11 11 18 18 18 18 18 18 11 18 18 14 14 8 8 8 8
10 10 19 19 19 18 11 11 11 11 11 18 18 11 11 11 18 18 18 18 18 18 11 11 18 14 14 14 8 8 8 8
10 19 19 19 18 18 11 11 11 11 11 11 11 11 11 18 18 18 18 18 18 18 11 18 18 14 14 14 8 8 8 8
10 19 19 19 18 11 11 11 11 11 11 11 11 11 18 18 18 18 18 18 18 11 11 18 14 14 14 8 8 8 8 8
10 19 19 18 18 11 11 11 11 11 11 11 11 18 18 18 18 18 18 11 11 11 18 18 14 14 14 8 8 8 8 8
19 19 19 18 11 11 11 11 11 11 11 11 18 18 11 11 11 11 11 11 18 18 18 14 14 14 8 8 8 8 8 8
19 19 19 18 11 11 11 11 11 11 11 18 18 18 18 11 11 11 18 18 18 4 4 14 14 14 8 8 8 18 8 8
19 19 18 18 11 11 11 11 11 11 18 18 18 18 18 18 18 18 18 4 4 4 4 4 4 8 8 8 8 8 8 8
19 19 18 11 11 11 11 11 11 18 18 18 4 4 4 4 4 4 4 4 4 4 4 8 8 8 8 8 8 8 8 8
19 19 18 11 11 11 11 11 18 18 18 4 4 4 4 4 4 4 4 4 4 8 8 8 8 8 8 8 8 8 8 8
19 19 18 11 11 11 18 18 18 4 4 4 4 4 4 4 4 8 4 8 4 8 4 8 8 8 8 8 4 8 8 8
19 19 11 18 18 18 18 4 4 4 4 4 4 4 8 8 8 8 8 4 8 8 8 8 8 8 8 4 8 4 8 8
19 11 4 4 4 4 4 4 4 4 4 4 8 8 8 8 8 8 8 8 8 8 8 8 8 8 8 8 4 8 8 8
4 4 4 4 4 4 4 4 4 4 8 8 8 8 8 8 8 8 8 8 8 8 8 8 8 8 8 8 8 8 8 8
