14 14 14 14 14 14 7 7 7 7 7 7 7 7 14 14 14 14 14 14 14 7 7 7 14 14 14 14 7 7 7 7
14 14 14 14 7 7 7 7 7 7 7 7 7 14 14 14 14 14 14 14 7 7 7 7 14 14 7 7 7 7 7 7
7 7 7 7 7 7 7 7 7 5 5 7 7 7 7 14 14 14 14 7 7 7 7 7 7 7 7 7 7 7 14 14
7 7 7 7 14 14 14 14 5 5 5 5 7 7 7 7 14 7 7 7 7 7 7 7 7 7 7 7 7 7 14 14
7 7 14 14 14 14 5 5 5 5 5 5 5 7 7 7 7 7 7 7 14 14 14 14 14 14 14 7 7 7 7 14
7 7 7 7 7 5 5 5 5 5 5 5 5 14 7 7 14 14 14 14 14 14 14 14 14 14 14 14 14 7 7 7
7 7 7 7 5 5 5 17 5 17 5 5 5 5 14 14 14 14 14 14 14 14 14 7 14 14 7 7 14 14 7 7
14 14 7 5 5 5 5 5 5 17 5 5 17 5 5 7 7 7 14 14 14 14 7 7 7 7 7 7 7 7 7 7
14 14 7 5 5 5 17 17 5 17 5 17 5 5 5 7 7 7 7 7 7 7 7 7 7 7 7 7 7 7 7 7
7 7 7 5 5 5 5 17 17 5 17 5 17 5 5 7 7 7 7 7 7 7 7 7 7 7 7 7 7 7 7 7
7 7 7 7 5 5 5 5 17 5 17 17 5 5 5 5 7 7 7 7 5 5 5 7 7 7 7 7 7 7 7 7
7 5 5 7 5 5 5 17 17 17 17 5 5 5 5 5 5 7 7 5 5 5 5 5 5 7 7 7 14 14 14 14
5 5 5 5 5 5 17 5 5 17 17 5 5 5 5 17 5 5 5 5 5 5 5 5 5 5 5 14 14 14 14 14
5 17 5 5 5 17 17 17 17 17 17 17 17 5 17 17 5 5 5 17 5 5 17 5 5 5 5 5 7 14 14 7
5 5 5 17 17 5 17 17 17 17 19 8 17 17 5 17 17 17 5 5 5 17 5 5 5 5 5 5 7 7 7 7
17 5 17 5 5 17 5 17 17 17 19 8 17 17 17 17 17 17 17 17 5 5 17 17 5 17 5 5 5 7 7 7
5 17 5 17 17 17 13 13 13 13 13 13 13 13 13 13 17 17 17 5 17 17 17 17 17 5 5 17 5 5 7 7
5 5 5 17 17 13 16 13 13 13 13 13 13 13 13 13 13 17 17 17 17 17 17 17 17 17 5 17 5 5 7 7
5 5 17 17 13 16 19 16 13 13 13 13 13 13 13 13 13 13 17 17 5 17 17 17 5 5 17 5 5 7 7 7
5 17 17 13 16 19 19 19 16 13 13 13 13 13 13 13 13 13 13 17 17 17 5 5 5 5 5 17 5 7 7 7
5 17 13 16 19 19 19 19 19 16 13 13 13 13 13 13 13 13 13 13 17 17 5 5 17 17 5 5 5 5 7 6
5 17 16 19 19 19 16 19 19 19 16 13 13 13 13 13 13 13 13 13 13 17 17 17 17 5 17 17 5 5 5 6
17 17 17 19 19 19 16 19 19 19 19 16 13 13 13 13 13 13 13 13 13 13 17 17 5 17 5 5 5 17 5 5
17 17 6 19 19 19 19 19 19 19 19 19 8 8 8 16 8 8 8 16 8 5 17 5 17 5 17 17 17 5 5 5
6 5 6 19 19 5 19 19 19 19 19 19 8 8 8 16 8 8 8 16 8 5 17 5 5 5 17 5 5 5 17 5
6 6 6 5 19 5 5 19 19 19 19 19 8 8 8 8 8 8 8 8 8 17 5 5 5 17 17 5 17 17 17 17
6 10 10 6 5 5 5 10 6 5 5 5 5 5 5 5 5 5 5 6 5 5 6 6 6 17 5 17 17 6 6 10
6 10 15 6 6 6 10 15 10 6 10 10 6 6 6 6 6 6 6 6 6 6 6 10 10 6 6 6 6 6 10 15
6 6 6 6 6 6 6 6 6 10 15 15 10 6 6 6 10 10 6 6 6 6 10 15 15 10 6 6 6 6 6 6
6 6 6 10 10 10 6 6 6 10 15 15 10 6 6 10 15 15 10 6 6 6 10 15 15 10 6 6 6 10 10 10
6 6 10 15 15 15 10 6 6 6 10 10 6 6 6 6 10 10 6 6 10 6 6 10 10 6 6 6 10 10 15 15
6 6 10 15 15 15 10 6 6 6 6 6 6 6 6 6 6 6 6 10 15 10 6 6 6 6 6 6 10 10 15 15
---
5 5 5 5 5 5 5 5 5 5 5 5 5 5 7 7 7 7 7 7 7 5 5 5 7 7 7 7 5 5 5 5
5 5 5 5 5 5 5 5 5 5 5 5 5 7 7 7 7 7 7 7 5 5 5 5 7 7 5 5 5 5 5 5
5 5 5 5 5 5 5 5 5 14 14 5 5 5 5 7 7 7 7 5 5 5 5 5 5 5 5 5 5 5 5 5
5 5 5 5 15 15 15 15 14 14 14 14 5 5 5 5 7 5 5 5 5 5 5 5 5 5 5 5 5 5 5 5
5 5 15 15 15 15 14 14 14 14 14 14 14 5 5 5 5 5 5 5 7 7 7 7 7 7 7 5 5 5 5 5
5 5 5 5 5 14 14 14 14 14 14 14 14 7 5 5 7 7 7 7 7 7 7 7 7 7 7 7 7 5 5 5
5 5 5 5 14 14 14 5 14 7 14 14 14 14 7 7 7 7 7 7 7 7 7 5 7 7 5 5 7 7 5 5
7 7 5 19 14 14 14 14 14 7 14 14 7 14 14 5 5 5 7 7 7 7 5 5 5 5 5 5 5 5 5 5
7 7 5 19 19 19 7 7 14 7 14 7 14 14 14 5 5 5 5 5 5 5 5 5 5 5 5 5 5 5 5 5
5 5 5 19 19 19 19 7 7 14 7 14 7 14 14 5 5 5 5 5 5 5 5 5 5 5 5 5 5 5 5 5
5 5 5 5 19 19 19 19 7 14 7 7 14 14 14 14 5 5 5 5 14 14 14 5 5 5 5 5 5 5 5 5
5 19 19 5 19 19 19 7 7 7 7 14 14 14 14 14 14 5 5 14 14 14 14 14 14 5 5 5 15 15 15 15
19 19 19 19 19 19 7 19 19 7 7 14 14 14 14 7 14 14 14 14 14 14 14 14 14 14 14 15 15 15 15 15
19 5 19 19 19 7 7 7 7 7 7 7 7 14 7 7 14 14 14 15 14 14 7 14 14 14 14 14 6 15 15 6
19 19 19 7 7 19 7 7 7 7 15 15 7 7 14 7 7 7 14 14 14 7 10 10 10 10 10 14 6 6 6 6
7 19 7 19 19 7 19 7 7 7 15 15 7 7 7 7 7 7 7 7 14 14 7 7 10 7 10 10 10 6 6 6
19 7 19 7 7 7 6 6 6 6 6 6 6 6 6 6 7 7 7 14 7 7 7 7 7 10 10 7 10 10 6 6
19 19 19 7 7 6 6 6 6 6 6 6 6 6 6 6 6 7 7 7 7 7 7 7 7 7 10 7 10 10 6 6
19 19 7 7 6 6 17 6 6 6 6 6 6 6 6 6 6 6 7 7 7 7 7 7 10 10 7 10 10 6 6 6
19 7 7 6 6 17 17 17 6 6 6 6 6 6 6 6 6 6 6 7 7 7 10 10 10 10 10 7 10 6 6 6
19 7 6 6 17 17 17 17 17 6 6 6 6 6 6 6 6 6 6 6 7 7 10 10 7 7 16 16 10 10 6 17
19 7 6 17 17 17 6 17 17 17 6 6 6 6 6 6 6 6 6 6 6 7 7 7 7 16 7 7 10 10 10 17
7 7 7 17 17 17 6 17 17 17 17 6 6 6 6 6 6 6 6 6 6 6 7 7 16 7 10 10 10 7 10 10
7 7 13 17 17 17 17 17 17 17 17 17 17 17 17 6 17 17 17 6 17 16 7 16 7 16 7 7 7 10 10 10
13 7 13 17 17 13 17 17 17 17 17 17 17 17 17 6 17 17 17 6 17 16 7 16 16 16 7 10 10 10 7 10
13 13 13 13 17 13 13 17 17 17 17 17 17 17 17 17 17 17 17 17 17 7 16 16 16 7 7 10 7 7 7 7
13 13 13 13 13 13 13 13 13 13 13 13 13 13 13 13 13 13 13 17 16 16 17 17 17 7 10 17 17 17 17 5
13 13 17 13 13 13 13 17 13 13 13 13 8 8 8 8 8 17 17 17 17 17 17 5 5 17 17 17 17 17 5 17
13 13 13 13 13 13 13 13 13 13 17 17 13 8 8 8 5 5 17 17 17 17 5 17 17 5 17 17 17 17 17 17
13 13 13 13 13 13 13 13 13 13 17 17 13 8 8 5 17 17 5 17 17 17 5 17 17 5 17 17 17 5 5 5
13 13 13 17 17 17 13 13 13 13 13 13 8 8 8 8 5 5 17 17 5 17 17 5 5 17 17 17 5 5 17 17
13 13 13 17 17 17 13 8 8 8 8 8 8 8 8 8 8 8 17 5 17 5 17 17 17 17 17 17 5 5 17 17
