0 0 0 0 0 16 16 16 0 0 0 0 0 0 0 0
0 0 0 0 16 11 11 16 16 16 0 0 0 0 0 0
0 0 0 0 16 11 16 7 7 7 16 0 0 0 0 0
0 0 0 16 5 11 16 7 7 7 7 16 0 0 0 0
0 0 0 16 5 16 7 16 16 7 16 7 16 0 0 0
0 0 16 5 5 16 7 7 7 7 7 7 16 0 0 0
0 0 0 16 7 7 7 7 16 7 16 7 16 0 0 0
0 16 16 7 7 7 10 10 7 7 7 10 7 16 0 0
0 16 7 7 7 7 7 7 16 16 16 7 7 7 16 0
16 7 7 7 7 7 7 7 7 7 7 7 12 7 7 16
16 7 7 7 7 12 7 7 7 7 7 7 7 12 7 16
0 16 16 16 12 12 7 7 7 7 7 7 7 12 7 16
0 0 16 5 5 5 5 5 5 5 5 11 11 12 16 0
0 0 16 12 12 5 11 5 11 11 11 11 12 16 0 0
0 0 16 7 7 12 12 16 16 16 12 12 7 16 0 0
0 0 0 16 7 7 16 0 0 16 7 7 16 0 0 0
0 0 0 16 16 16 0 0 0 16 16 16 0 0 0 0
---
0 0 0 0 0 7 7 7 0 0 0 0 0 0 0 0
0 0 0 0 7 12 12 7 7 7 0 0 0 0 0 0
0 0 0 0 7 12 7 12 12 12 7 0 0 0 0 0
0 0 0 7 11 12 7 12 12 12 12 7 0 0 0 0
0 0 0 7 11 7 12 7 7 16 7 16 7 0 0 0
0 0 7 11 11 7 12 12 16 16 16 16 7 0 0 0
0 0 0 7 16 16 16 16 10 16 10 16 7 0 0 0
0 7 7 16 16 16 7 7 16 16 16 7 16 7 0 0
0 7 16 16 16 16 16 16 11 11 11 16 16 16 7 0
7 16 16 16 16 16 16 16 16 16 16 16 5 16 16 7
7 16 16 16 16 7 16 16 16 16 16 16 16 5 16 7
0 7 7 7 7 7 16 16 16 16 16 16 16 5 16 7
0 0 7 7 7 7 7 7 7 7 7 7 7 5 7 0
0 0 7 5 5 7 10 7 7 7 7 7 5 7 0 0
0 0 7 11 11 5 5 7 7 7 5 5 5 7 0 0
0 0 0 7 11 11 7 0 0 7 5 5 7 0 0 0
0 0 0 7 7 7 0 0 0 7 7 7 0 0 0 0
