1 1 8 1 1 1 1 18 18 18 18 1 1 1 1 1 1 1
1 8 1 8 1 1 18 13 13 13 9 18 1 1 1 1 8 1
1 1 8 1 1 18 13 13 13 9 9 9 18 1 1 8 1 8
1 1 1 1 1 18 13 13 9 9 9 9 18 1 1 1 8 1
1 1 1 18 18 13 13 9 9 9 9 15 15 18 18 1 1 1
1 18 18 13 13 13 9 9 9 9 15 15 15 15 6 18 18 1
18 13 13 13 13 9 9 9 9 15 15 15 15 6 6 6 3 18
18 13 13 13 9 9 9 9 15 15 15 15 6 6 6 3 3 18
18 13 13 9 9 9 9 15 15 15 15 6 6 6 3 3 3 18
18 13 9 9 9 9 15 15 15 15 6 6 6 3 3 3 10 18
1 18 9 9 9 15 15 15 15 6 6 6 3 3 3 10 18 1
1 1 18 9 15 15 15 15 6 6 6 3 3 3 10 18 1 1
1 1 18 15 15 15 15 6 6 6 3 3 3 10 10 18 1 1
1 8 18 15 15 15 6 6 6 3 3 3 10 10 10 18 1 1
8 1 18 15 15 6 6 6 3 3 3 10 10 10 13 18 1 1
1 8 18 15 6 6 6 6 18 18 10 10 10 13 13 18 1 8
1 1 1 18 6 6 6 18 1 1 18 10 13 13 18 1 8 1
1 1 1 1 18 18 18 1 1 1 1 18 18 18 1 1 1 8
---
10 10 15 10 10 10 8 1 1 1 13 13 13 13 13 13 13 13
10 15 10 15 10 8 1 3 3 3 15 13 13 13 13 13 18 13
10 10 15 10 8 1 3 3 3 15 15 15 13 13 13 3 8 18
10 10 10 8 8 1 3 3 15 15 15 15 13 13 13 13 9 13
10 8 8 1 1 3 3 15 15 15 15 18 18 13 13 13 13 13
8 1 1 3 3 3 15 15 15 15 18 18 18 18 9 1 1 13
1 3 3 3 3 15 15 15 15 18 18 18 18 9 9 9 1 1
1 3 3 3 15 15 15 15 18 18 18 18 9 9 9 1 1 1
1 3 3 15 15 15 15 18 18 18 18 9 9 9 1 1 1 1
6 3 15 15 15 15 18 18 18 18 9 9 9 1 1 1 1 1
6 6 15 15 15 18 18 18 18 9 9 9 1 1 1 1 1 1
6 6 6 15 18 18 18 18 9 9 9 1 1 1 1 1 1 1
6 6 6 18 18 18 18 9 9 9 1 1 1 1 1 1 1 1
6 6 6 18 18 18 9 9 9 1 1 1 1 1 1 1 1 1
6 6 6 18 18 9 9 9 1 1 1 1 1 1 8 1 1 1
6 6 6 18 9 9 9 9 1 1 1 1 1 8 8 1 1 18
6 6 6 6 9 9 9 1 6 6 1 1 8 8 1 18 18 18
6 6 6 6 6 6 6 6 6 6 6 1 1 1 18 18 18 18
