0 0 0 0 0 0 0 0 0 0 0 0 0 0 0 0 0 0
0 0 0 0 0 0 0 0 0 0 0 0 0 0 0 0 0 0
0 0 16 16 16 16 0 0 0 0 0 0 0 0 0 0 0 0
0 0 16 8 16 13 16 16 16 16 0 0 0 0 0 0 0 0
0 0 16 15 16 13 13 16 8 8 16 16 16 16 0 0 0 0
0 0 16 15 15 16 16 15 15 15 8 8 8 8 16 16 16 0
0 0 0 16 15 15 15 15 15 15 16 16 15 15 16 15 16 0
0 0 0 16 15 15 15 15 15 16 13 13 16 15 16 9 16 0
0 0 0 16 15 15 15 15 15 16 13 13 16 16 9 9 16 0
0 0 0 16 15 16 16 15 15 15 16 16 15 16 9 16 0 0
0 0 0 0 16 13 13 16 15 15 15 15 16 9 9 16 0 0
0 0 0 0 16 13 13 16 15 15 15 16 9 9 16 0 0 0
0 0 0 0 16 16 16 15 15 15 16 9 9 16 0 0 0 0
0 0 0 0 16 15 15 15 16 16 9 9 16 0 0 0 0 0
0 0 0 0 0 16 16 16 9 9 9 16 0 0 0 0 0 0
0 0 0 0 0 16 9 9 9 16 16 0 0 0 0 0 0 0
0 0 0 0 0 16 16 16 16 0 0 0 0 0 0 0 0 0
0 0 0 0 0 0 0 0 0 0 0 0 0 0 0 0 0 0
---
0 0 0 0 0 0 0 0 0 0 0 0 0 0 0 0 0 0
0 0 0 0 0 0 0 0 0 0 0 0 0 0 0 0 0 0
0 0 15 15 15 15 0 0 0 0 0 0 0 0 0 0 0 0
0 0 15 16 15 8 15 15 15 15 0 0 0 0 0 0 0 0
0 0 15 16 15 8 8 15 16 16 15 15 15 15 0 0 0 0
0 0 15 16 16 15 15 16 16 16 16 16 16 16 15 15 15 0
0 0 0 13 16 16 16 16 16 16 15 15 8 8 15 8 15 0
0 0 0 13 16 16 16 16 16 15 16 16 15 8 15 16 15 0
0 0 0 13 16 16 16 16 16 15 16 16 15 15 16 16 15 0
0 0 0 13 16 13 13 16 16 16 15 15 16 15 16 15 0 0
0 0 0 0 13 16 16 13 16 16 16 16 15 16 16 15 0 0
0 0 0 0 13 16 16 13 16 16 16 9 16 16 15 0 0 0
0 0 0 0 9 9 13 16 16 16 9 16 16 15 0 0 0 0
0 0 0 0 9 16 16 16 9 9 16 16 15 0 0 0 0 0
0 0 0 0 0 9 9 9 16 16 16 9 0 0 0 0 0 0
0 0 0 0 0 9 16 16 16 9 9 0 0 0 0 0 0 0
0 0 0 0 0 9 9 9 9 0 0 0 0 0 0 0 0 0
0 0 0 0 0 0 0 0 0 0 0 0 0 0 0 0 0 0
