1 1 15 1 1 1 1 1 1 15 1 1 1 1 1 1 1 1
1 1 1 1 16 16 1 1 15 7 15 1 16 16 1 1 1 1
1 1 1 16 14 14 16 1 1 15 1 16 14 14 16 1 1 15
15 1 1 16 7 14 16 1 1 1 1 16 14 7 16 1 15 7
1 1 1 16 7 7 14 16 16 16 16 14 7 7 16 1 1 15
1 1 1 16 14 7 14 14 14 14 14 14 7 14 16 1 1 1
1 15 1 1 16 14 14 14 14 14 14 14 14 16 1 1 1 1
15 7 15 16 14 14 14 14 14 14 14 14 14 14 16 1 15 1
1 15 1 16 14 14 14 16 14 14 16 14 14 14 16 1 1 1
1 1 1 16 14 14 14 16 14 14 16 14 14 14 16 1 1 1
1 1 1 16 14 7 7 14 14 14 14 7 7 14 16 1 1 1
1 1 1 1 16 14 14 14 14 14 14 14 14 16 1 1 1 1
15 1 1 1 1 16 14 14 14 14 14 14 16 1 1 1 15 1
1 1 1 1 16 16 14 14 14 14 14 14 16 16 1 15 7 15
1 1 1 1 16 14 14 14 14 14 14 14 14 16 1 1 15 1
1 1 15 7 16 16 14 16 14 14 16 14 16 16 7 7 1 1
7 15 7 15 7 16 16 16 16 16 16 16 16 7 7 7 7 7
1 7 15 7 7 7 7 7 7 7 7 7 7 7 7 15 7 1
---
1 1 14 1 1 1 1 1 1 14 1 1 1 1 1 1 1 1
1 1 1 1 14 14 1 1 14 14 14 1 14 14 1 1 1 1
1 1 1 14 7 7 14 1 1 14 1 14 7 7 14 1 1 14
14 1 1 14 14 7 14 1 1 1 1 14 7 14 14 1 14 14
1 1 1 14 14 14 7 14 14 14 14 7 14 14 14 1 1 14
1 1 1 14 7 14 7 7 7 7 7 7 14 7 14 1 1 1
1 14 1 1 14 7 7 7 7 7 7 7 7 14 1 1 1 1
14 14 14 14 16 16 16 16 16 16 16 16 16 16 14 1 14 1
1 14 1 14 16 16 16 7 16 16 7 16 16 16 14 1 1 1
1 1 1 14 16 16 16 7 16 16 7 16 16 16 14 1 1 1
1 1 1 14 16 14 14 15 15 15 15 14 14 16 14 1 1 1
1 1 1 1 14 15 15 15 15 15 15 15 15 14 1 1 1 1
7 1 1 1 1 14 15 15 15 15 15 15 14 1 1 1 14 1
1 1 1 1 14 14 15 15 15 15 15 15 14 14 1 14 14 14
1 1 1 1 14 7 7 7 7 7 7 7 7 14 1 1 14 1
1 1 16 16 14 14 7 14 7 7 14 7 14 14 16 16 1 1
16 16 16 16 16 14 14 14 14 14 14 14 14 16 16 16 16 16
1 16 16 16 16 16 16 16 16 16 16 16 16 16 16 16 16 1
