1 1 16 16 16 16 16 16 16 1 1
1 1 1 14 14 14 14 14 1 1 1
1 1 14 14 16 14 16 14 14 1 1
1 1 14 14 14 9 14 14 14 1 1
1 1 1 14 14 14 14 14 1 1 1
1 1 14 13 5 13 5 13 14 1 1
1 16 13 13 14 14 14 14 14 16 1
16 14 5 5 14 16 14 14 14 14 16
16 14 13 13 14 14 14 14 14 14 16
1 14 14 14 14 16 14 14 14 14 1
1 1 14 14 14 14 14 14 14 1 1
1 1 1 14 14 14 14 14 1 1 1
---
14 14 1 1 1 1 1 1 1 14 14
14 14 14 16 16 16 16 16 14 14 14
14 14 1 16 14 16 14 16 1 14 14
14 14 1 16 16 9 16 16 1 14 14
14 14 1 16 16 16 16 16 1 14 14
14 1 1 14 14 14 14 14 1 1 14
14 1 14 14 13 13 13 1 1 1 1
1 1 14 14 13 5 13 1 1 1 1
1 1 14 14 13 5 13 1 1 1 1
14 1 1 1 1 5 1 1 1 1 14
14 14 14 14 14 5 14 14 14 14 14
14 14 14 14 14 14 14 14 14 14 14
