0 0 0 0 0 0 16 16 16 16 16 16 0 0 0 0
0 0 0 0 0 16 13 13 13 13 13 13 16 0 0 0
0 0 0 0 16 13 13 13 13 13 13 13 13 16 0 0
0 0 0 16 13 13 13 13 13 13 13 13 13 13 16 0
0 0 16 13 13 13 13 13 13 13 13 13 13 16 14 16
0 0 16 13 13 14 14 14 14 14 14 13 13 16 14 16
0 0 16 13 14 14 14 7 7 14 14 14 13 16 16 0
0 0 16 14 7 7 7 7 7 7 7 7 14 16 0 0
0 16 14 14 7 12 12 7 7 12 12 7 14 14 16 0
0 16 14 14 7 7 7 10 10 7 7 7 14 14 16 0
0 0 16 14 14 14 14 14 14 14 14 14 14 16 0 0
0 0 16 14 14 14 14 14 12 14 14 14 14 16 0 0
0 16 13 16 14 14 14 14 14 14 14 14 16 13 16 0
16 13 16 12 16 16 14 14 14 14 16 16 12 16 13 16
16 5 5 16 13 13 16 16 16 16 13 13 16 5 5 16
16 5 16 16 5 5 15 5 5 15 5 5 16 16 5 16
0 16 5 5 16 13 13 15 15 13 13 16 5 5 16 0
0 16 5 5 16 12 12 12 12 12 12 16 5 5 16 0
0 0 16 16 16 16 16 16 16 16 16 16 16 16 0 0
---
0 0 0 0 0 0 14 14 14 14 14 14 0 0 0 0
0 0 0 0 0 14 16 16 16 16 16 16 13 0 0 0
0 0 0 0 14 16 16 16 16 16 16 16 16 13 0 0
0 0 0 14 16 16 16 16 16 16 16 16 16 16 13 0
0 0 14 16 16 16 16 16 16 16 16 16 16 13 7 13
0 0 14 16 16 16 16 16 16 16 16 16 16 13 7 13
0 0 14 16 16 16 16 5 5 16 16 16 16 13 13 0
0 0 14 16 5 5 5 5 5 5 5 5 16 13 0 0
0 14 16 16 5 13 13 5 5 13 13 5 16 16 13 0
0 14 16 16 5 5 5 15 15 5 5 5 16 16 13 0
0 0 14 16 16 16 16 16 16 16 16 16 16 13 0 0
0 0 14 16 16 16 16 16 12 13 13 13 13 13 0 0
0 14 7 14 13 13 13 13 13 13 13 13 13 15 13 0
14 7 14 7 14 14 13 13 13 13 13 13 13 13 15 13
14 7 7 14 12 12 14 14 14 14 12 12 14 13 13 13
14 7 14 14 7 7 12 10 10 12 13 13 14 14 13 13
0 14 7 7 14 12 12 12 12 12 12 14 13 13 14 0
0 14 7 7 14 7 7 7 7 7 7 14 13 13 14 0
0 0 14 14 14 14 14 14 14 14 14 14 14 14 0 0
