0 0 0 0 0 0 18 18 18 18 18 18 18 0 0 0 0
0 0 0 0 0 18 14 19 14 14 14 14 14 18 0 0 0
0 0 0 0 18 19 19 19 19 14 14 14 14 14 18 0 0
0 0 0 18 19 19 18 18 19 19 19 18 18 14 18 0 0
0 0 0 18 19 19 19 19 19 19 19 19 19 19 19 18 0
0 0 18 19 19 19 18 18 14 19 19 18 18 14 19 18 0
0 0 18 9 19 19 18 18 18 19 19 18 18 18 19 19 18
0 0 18 9 19 19 18 18 18 19 19 18 18 18 19 19 18
0 18 18 9 9 19 19 19 19 19 19 19 19 19 19 9 18
18 19 19 9 9 9 9 9 19 19 19 19 19 19 9 18 18
0 18 9 9 18 18 9 18 19 18 19 18 9 18 18 0 0
0 0 18 18 0 18 9 18 9 18 9 18 9 18 0 0 0
0 0 0 0 0 18 9 18 18 0 18 18 9 18 0 0 0
0 0 0 0 0 0 18 18 0 0 0 18 18 0 0 0 0
---
0 0 0 0 0 0 9 9 9 9 9 9 9 0 0 0 0
0 0 0 0 0 9 9 9 18 18 18 18 18 9 0 0 0
0 0 0 0 19 9 9 9 9 18 18 18 18 18 19 0 0
0 0 0 19 9 9 14 14 9 9 9 14 14 18 19 0 0
0 0 0 19 9 14 18 18 18 18 18 18 18 18 18 19 0
0 0 19 14 14 14 19 19 18 18 18 19 19 18 18 19 0
0 0 19 18 14 14 19 19 19 18 18 19 19 19 18 18 19
0 0 19 18 14 14 19 19 19 18 18 19 19 19 18 18 19
0 19 19 18 18 14 14 18 18 18 18 18 18 18 18 18 19
19 18 18 18 18 18 18 18 18 18 18 18 18 18 18 19 19
0 19 18 18 19 19 18 19 18 19 18 19 18 19 19 0 0
0 0 19 19 0 19 18 19 18 19 18 19 18 19 0 0 0
0 0 0 0 0 19 18 19 19 0 19 19 18 19 0 0 0
0 0 0 0 0 0 19 19 0 0 0 19 19 0 0 0 0
