0 0 0 0 0 9 9 9 9 9 9 9 9 9 0 0 0 0 0
0 0 0 9 9 2 2 2 2 2 2 2 2 2 9 9 0 0 0
0 0 9 2 2 8 8 8 8 8 8 8 2 2 2 2 2 0 0
0 9 2 8 8 6 6 6 6 6 6 6 8 8 2 2 2 2 0
0 9 8 6 6 6 6 16 6 16 6 6 6 6 6 2 2 2 0
0 2 8 6 16 6 6 16 6 16 6 6 16 6 6 2 2 2 2
9 8 6 6 6 16 6 5 5 5 6 16 6 6 6 5 2 2 2
2 8 6 6 6 6 5 8 8 8 5 6 6 6 6 5 2 2 2
2 6 6 16 16 5 8 8 8 8 8 5 16 16 6 5 2 2 2
2 6 6 6 6 5 8 8 8 8 8 5 6 6 6 5 2 2 2
2 6 6 16 16 5 8 8 8 8 8 5 16 16 6 5 2 2 2
2 6 6 6 6 6 5 8 8 8 5 6 6 6 6 5 2 2 2
2 6 6 6 6 16 6 5 5 5 6 16 6 6 6 5 2 2 2
0 2 6 6 16 6 6 16 6 16 6 6 16 6 5 2 2 2 0
0 2 6 6 6 6 6 16 6 16 6 6 6 6 5 2 2 2 0
0 0 2 5 5 6 6 6 6 6 6 6 5 5 2 2 2 0 0
0 0 0 2 2 5 5 5 5 5 5 5 2 2 2 2 0 0 0
0 0 0 0 0 2 2 2 2 2 2 2 2 2 0 0 0 0 0
---
0 0 0 0 0 6 6 6 6 6 6 6 6 6 0 0 0 0 0
0 0 0 6 6 6 6 6 6 6 6 6 6 6 6 6 0 0 0
0 0 6 6 6 2 2 2 2 2 2 2 6 6 6 6 6 0 0
0 6 6 2 2 9 9 9 9 9 9 9 2 2 6 6 2 2 0
0 6 2 9 9 9 9 2 9 2 9 2 2 2 2 5 5 2 0
0 2 2 9 2 9 9 2 9 2 2 2 2 2 2 5 5 5 5
6 2 8 8 8 2 8 6 6 6 2 2 2 2 2 2 5 5 5
6 2 8 8 8 8 6 6 6 6 6 2 2 2 2 2 5 5 5
6 8 8 2 2 6 6 6 6 6 6 6 2 2 2 2 5 5 5
6 8 8 8 8 6 6 6 6 6 6 6 2 2 2 2 5 5 5
6 8 8 2 2 6 6 6 6 6 6 6 2 2 16 2 5 5 5
6 8 8 8 8 8 6 6 6 6 6 16 16 16 16 2 5 5 5
6 8 8 8 8 2 8 6 6 6 16 2 16 16 16 2 5 5 5
0 6 8 8 2 8 8 2 16 2 16 16 2 16 2 5 5 5 0
0 6 8 8 8 8 8 2 16 2 16 16 16 16 2 5 5 5 0
0 0 6 2 2 8 16 16 16 16 16 16 2 2 5 5 5 0 0
0 0 0 6 6 2 2 2 2 2 2 2 6 6 6 6 0 0 0
0 0 0 0 0 6 6 6 6 6 6 6 6 6 0 0 0 0 0
