0 0 0 0 0 0 0 0 0 0 18 0 0 0 0 0 0 18 0 0 0 0 0 0 0
0 0 0 0 0 0 0 0 0 18 14 18 0 0 0 0 18 7 18 0 0 0 0 0 0
0 0 0 0 0 0 0 0 0 18 14 14 18 0 0 18 7 7 18 0 0 0 0 0 0
0 0 0 0 0 0 0 0 0 18 14 14 14 18 18 7 7 7 18 0 0 0 0 0 0
0 0 0 0 0 0 18 18 18 9 14 10 14 14 3 1 3 7 18 0 0 0 0 0 0
0 0 0 0 0 18 3 3 9 3 14 10 10 14 1 1 3 3 18 0 0 0 0 0 0
0 0 0 0 18 3 3 1 9 1 14 10 14 14 1 14 1 1 3 18 0 0 0 0 0
0 0 0 18 1 3 3 1 9 1 14 14 14 14 14 14 1 14 1 18 0 0 0 0 0
0 0 18 3 1 3 1 1 9 1 14 14 14 14 14 14 14 14 14 18 0 0 0 0 0
0 18 3 3 3 3 1 1 1 9 14 14 14 14 14 16 14 14 14 14 18 0 0 0 0
18 3 1 3 3 1 1 1 1 1 9 9 14 14 16 16 14 14 14 14 18 0 0 0 0
18 3 1 3 3 1 1 1 14 1 14 9 9 14 14 14 14 14 14 14 14 18 0 0 0
18 3 1 3 1 1 1 14 14 14 14 9 14 9 9 14 14 14 14 14 14 18 0 0 0
18 3 1 1 1 1 14 14 14 14 14 9 14 14 14 9 14 14 14 14 9 9 18 0 0
18 3 1 1 1 1 14 14 14 14 14 14 9 14 14 14 9 9 14 9 14 14 14 18 0
18 1 1 1 1 14 14 14 14 14 14 14 9 14 14 14 14 14 9 14 14 14 14 14 18
18 1 1 1 14 14 14 14 14 14 14 18 18 18 14 14 14 14 9 14 14 16 16 14 18
18 9 1 1 14 14 14 14 14 14 18 0 0 0 18 18 14 14 9 14 14 14 14 14 18
18 1 9 14 14 14 14 14 14 18 0 0 0 0 0 0 18 9 9 14 14 14 14 14 18
18 1 1 9 9 14 14 14 18 0 0 0 0 0 0 9 9 9 18 18 14 14 14 18 0
18 1 1 14 14 9 9 14 18 0 0 0 0 0 9 9 18 18 0 0 18 18 18 0 0
18 1 14 14 14 14 14 9 9 9 0 0 9 9 9 18 0 0 0 0 0 0 0 0 0
18 14 14 14 14 14 14 18 18 9 9 9 9 18 18 0 0 0 0 0 0 0 0 0 0
18 14 14 14 14 14 18 0 0 18 18 18 18 0 0 0 0 0 0 0 0 0 0 0 0
0 18 18 18 18 18 0 0 0 0 0 0 0 0 0 0 0 0 0 0 0 0 0 0 0
---
0 0 0 0 0 0 0 0 0 0 14 0 0 0 0 0 0 14 0 0 0 0 0 0 0
0 0 0 0 0 0 0 0 0 14 1 14 0 0 0 0 14 18 14 0 0 0 0 0 0
0 0 0 0 0 0 0 0 0 14 1 1 14 0 0 14 18 18 14 0 0 0 0 0 0
0 0 0 0 0 0 0 0 0 14 1 1 1 14 14 18 18 18 14 0 0 0 0 0 0
0 0 0 0 0 0 14 14 14 18 1 18 1 1 14 14 14 18 14 0 0 0 0 0 0
0 0 0 0 0 14 14 14 18 14 1 18 18 1 14 14 14 14 14 0 0 0 0 0 0
0 0 0 0 14 14 14 14 18 14 1 18 1 1 14 1 14 14 14 14 0 0 0 0 0
0 0 0 14 14 14 14 14 18 14 1 1 1 1 1 1 14 1 14 14 0 0 0 0 0
0 0 14 14 14 14 14 14 18 14 1 1 1 1 1 1 1 1 1 14 0 0 0 0 0
0 14 14 14 14 14 14 14 14 18 1 1 1 1 1 18 1 1 1 1 14 0 0 0 0
14 14 14 14 14 14 14 14 14 14 18 18 1 1 18 18 1 1 1 1 14 0 0 0 0
14 14 14 14 14 14 14 14 9 14 9 18 18 1 1 1 1 1 1 1 3 14 0 0 0
14 14 14 14 14 14 14 9 9 9 9 18 9 18 18 1 1 1 1 3 3 14 0 0 0
14 14 14 14 14 14 9 9 9 9 9 18 9 9 10 18 1 7 7 3 18 18 14 0 0
14 14 14 14 14 14 9 9 9 9 9 9 18 9 10 16 18 18 7 18 3 3 3 14 0
14 14 14 14 14 9 9 9 9 9 9 9 18 9 10 16 16 7 18 3 3 3 3 3 14
14 14 14 14 9 9 9 9 9 9 9 14 14 14 10 16 16 7 18 3 3 14 14 3 14
14 18 14 14 9 9 9 9 9 9 14 0 0 0 14 14 7 7 18 3 3 3 3 3 14
14 14 18 9 9 9 9 9 9 14 0 0 0 0 0 0 14 18 18 3 3 3 3 3 14
14 14 14 18 18 18 18 18 14 0 0 0 0 0 0 18 18 18 14 14 3 3 3 14 0
14 14 14 18 18 18 18 18 14 0 0 0 0 0 18 18 14 14 0 0 14 14 14 0 0
14 14 18 18 18 18 18 18 18 18 0 0 18 18 18 14 0 0 0 0 0 0 0 0 0
14 18 18 18 18 18 18 14 14 18 18 18 18 14 14 0 0 0 0 0 0 0 0 0 0
14 18 18 18 18 18 14 0 0 14 14 14 14 0 0 0 0 0 0 0 0 0 0 0 0
0 14 14 14 14 14 0 0 0 0 0 0 0 0 0 0 0 0 0 0 0 0 0 0 0
