1 1 1 1 1 1 1 1 1 14 14 14 1 1 1 1 1 1 1 1 1 1 1 1 1 1 1 1 1 1 14 14
1 1 1 1 1 1 1 14 14 14 14 14 14 1 1 1 1 1 1 1 1 1 1 1 1 1 1 1 14 14 14 14
1 1 1 1 1 1 1 1 1 1 1 1 1 16 1 1 1 1 16 1 1 1 1 1 1 1 1 1 1 14 14 14
1 1 1 1 1 1 1 1 1 1 1 1 16 9 16 1 1 16 9 16 1 1 1 1 1 1 1 1 1 1 1 1
14 1 1 1 1 16 16 16 1 1 1 1 16 9 16 1 1 16 9 16 1 1 1 1 16 16 16 1 1 1 1 1
14 1 1 1 16 9 9 9 16 1 1 1 16 14 16 1 1 16 14 16 1 1 1 16 9 9 9 16 1 1 1 1
14 14 1 1 16 14 14 9 9 16 1 1 16 14 16 16 16 16 14 16 1 1 16 9 9 14 14 16 1 1 1 1
1 14 14 1 16 14 14 14 9 16 1 16 9 9 9 9 9 9 9 9 16 1 16 9 14 14 14 16 1 1 1 1
1 1 1 1 1 16 14 14 9 9 16 9 9 9 9 9 9 9 9 9 9 16 9 9 14 14 16 1 1 1 1 1
1 1 1 1 1 16 14 14 14 9 14 14 14 9 9 9 9 9 9 14 14 14 9 14 14 14 16 1 1 1 1 1
1 1 1 1 1 1 16 16 14 14 14 14 14 14 9 9 9 9 14 14 14 14 14 14 16 16 1 1 14 14 14 14
1 1 1 1 1 1 1 1 16 14 4 4 14 14 14 9 9 14 14 14 4 4 14 16 1 1 1 14 14 14 14 14
1 1 1 1 1 1 1 1 16 4 4 14 4 14 14 9 9 14 14 4 14 4 4 16 1 1 14 14 14 14 14 14
1 1 1 1 1 1 1 16 14 4 14 4 4 14 9 9 9 9 14 4 4 14 4 14 16 1 14 14 14 14 14 14
1 14 14 1 1 1 1 16 7 4 14 14 4 14 16 16 16 16 14 4 14 14 4 7 16 1 1 1 1 1 1 1
14 14 14 14 1 1 1 16 7 7 4 4 14 16 9 9 9 9 16 14 4 4 7 7 16 1 1 1 1 1 1 1
14 14 14 14 14 1 1 16 14 14 14 14 16 9 16 9 9 16 9 16 14 14 14 14 16 1 1 1 1 1 1 1
1 1 1 1 1 1 1 1 16 14 14 14 16 9 9 9 9 9 9 16 14 14 14 16 1 1 1 1 1 1 1 1
1 1 1 1 1 1 1 1 1 16 14 14 14 16 9 9 9 9 16 14 14 14 16 1 1 1 1 1 1 1 1 1
1 1 1 1 1 1 1 1 1 1 16 16 14 14 16 16 16 16 17 6 16 16 1 1 1 1 14 14 14 1 1 1
1 1 1 1 1 1 1 1 1 1 1 1 16 14 14 14 14 6 6 17 6 1 1 1 1 14 14 14 14 1 1 6
1 1 1 1 1 1 1 1 1 1 1 1 16 9 9 14 14 14 6 17 6 1 1 1 1 1 1 1 1 1 1 1
1 1 1 1 1 1 1 1 1 14 1 1 16 9 9 9 14 9 9 6 6 1 1 1 1 1 1 1 1 1 1 1
17 1 1 1 1 6 1 1 1 1 1 1 16 9 9 9 14 9 9 16 1 1 1 1 1 1 1 1 1 1 17 17
17 17 1 1 6 6 6 6 1 1 1 1 16 9 9 14 14 14 9 16 1 1 1 6 6 1 1 1 1 17 17 6
6 17 17 1 1 6 6 6 1 1 1 1 16 9 14 14 9 14 14 16 1 1 6 6 6 6 1 1 1 17 6 6
6 6 17 1 1 1 1 1 6 1 1 1 16 14 14 9 9 9 14 16 1 1 1 6 1 1 1 17 17 17 17 17
17 17 17 17 17 17 17 1 1 1 1 1 16 14 9 9 9 9 14 16 1 1 1 1 1 1 17 17 6 6 6 17
6 6 17 17 17 6 17 17 1 1 1 1 16 14 14 9 9 14 14 16 1 1 1 1 1 17 17 6 6 6 6 6
6 17 6 17 6 6 6 17 1 1 1 1 16 9 14 14 14 14 9 16 1 1 1 1 1 1 17 17 17 17 17 17
6 6 6 17 17 17 17 17 17 17 1 1 16 9 9 14 14 9 9 16 1 1 1 1 1 17 17 6 6 6 17 6
17 6 6 17 17 6 6 6 17 17 17 1 16 9 14 14 14 9 9 16 1 1 1 17 17 17 6 17 6 17 6 6
---
1 1 1 1 1 1 1 1 1 17 17 17 16 16 16 16 16 16 16 16 1 1 1 1 1 1 1 1 1 1 9 9
1 1 1 1 1 1 1 17 17 17 17 17 17 16 16 16 16 16 16 1 1 1 1 1 1 1 1 1 9 9 9 9
1 1 1 1 1 1 1 1 1 1 1 1 1 14 16 16 16 16 14 1 1 1 1 1 1 1 1 1 1 9 9 9
1 1 1 1 1 1 1 1 1 1 1 1 14 16 14 16 16 14 16 14 1 1 1 1 1 1 1 1 1 1 1 1
9 1 1 1 1 14 14 14 1 1 1 1 14 16 14 16 16 14 16 14 1 1 1 1 14 14 14 1 1 1 1 1
9 1 1 1 14 17 17 17 14 1 1 1 14 14 14 16 16 14 14 14 1 1 1 14 17 17 17 14 1 1 1 1
9 9 1 1 14 1 1 17 17 14 1 1 14 14 14 14 14 14 14 14 1 1 14 17 17 1 1 14 1 1 1 1
1 9 9 1 14 1 1 1 17 14 1 14 6 6 6 6 6 6 6 6 14 1 14 17 1 1 1 14 1 1 1 1
1 1 1 1 1 14 1 1 17 17 14 6 6 6 6 6 6 6 6 6 6 14 17 17 1 1 14 1 1 1 1 1
1 1 1 1 1 14 1 1 1 17 1 1 1 6 6 6 6 6 6 1 1 1 17 1 1 1 14 1 1 1 1 1
1 1 1 1 1 1 14 14 1 1 1 1 1 1 6 6 6 6 1 1 1 1 1 1 14 14 1 1 9 9 9 9
1 1 1 1 1 1 1 1 14 1 9 9 1 1 1 6 6 1 1 1 9 9 1 14 1 1 1 9 9 9 9 9
1 1 1 1 1 1 1 1 14 9 9 1 9 1 1 6 6 1 1 9 1 9 9 14 1 1 9 9 9 9 9 9
1 1 1 1 1 1 1 14 1 9 1 9 9 1 6 6 6 6 1 9 9 1 9 1 14 1 9 9 9 9 9 9
1 9 9 1 1 1 1 14 1 9 1 1 9 1 1 1 1 1 1 9 1 1 9 1 14 1 1 16 16 16 16 16
9 9 9 9 1 1 7 14 1 1 9 9 1 1 14 14 14 14 1 1 9 9 1 1 14 1 1 16 16 16 16 16
9 9 9 9 9 7 7 14 1 1 1 1 1 14 1 14 14 1 14 1 1 1 1 1 14 1 1 16 16 16 16 16
6 6 6 6 6 7 7 14 14 1 1 1 1 14 14 14 14 14 14 1 1 1 1 14 14 1 16 4 4 4 16 16
6 6 6 6 6 6 7 14 14 14 1 1 1 1 14 14 14 14 1 1 1 1 14 14 14 4 4 4 4 4 4 4
17 17 17 17 17 17 17 14 14 14 14 14 1 1 1 1 1 1 16 16 14 14 14 14 14 4 9 9 9 4 4 4
17 17 17 17 17 17 17 17 14 14 14 14 1 1 9 9 9 16 16 16 16 14 14 14 14 9 9 9 9 4 4 4
17 17 17 17 17 17 17 17 14 14 14 14 1 6 6 9 9 9 16 16 16 14 14 14 14 4 4 4 4 4 4 4
16 16 16 16 16 16 16 16 14 14 14 14 1 6 6 6 9 1 1 16 16 14 14 14 14 16 16 16 16 16 16 16
1 16 16 16 16 17 16 16 14 14 14 14 1 6 6 6 9 1 1 1 14 14 14 14 14 16 16 16 16 16 1 1
1 1 16 16 17 17 17 17 14 14 14 14 1 6 6 9 9 9 1 1 14 14 14 17 17 16 16 16 16 1 1 1
1 1 1 16 16 17 17 17 14 14 14 14 1 6 9 9 1 9 9 1 14 14 17 17 17 17 16 16 16 1 1 1
1 1 1 16 16 16 16 16 17 14 14 14 1 9 9 1 1 1 9 1 14 14 14 17 16 16 16 1 1 1 1 1
1 1 1 1 1 1 1 16 14 14 14 14 1 9 1 1 1 1 9 1 14 14 14 14 16 16 1 1 1 1 1 1
1 1 1 1 1 1 1 1 14 14 14 14 1 9 9 1 1 9 9 1 14 14 14 14 16 1 1 1 1 1 1 1
1 1 1 1 1 1 1 1 14 14 14 14 1 1 9 9 9 9 6 1 14 14 14 14 16 16 1 1 1 1 1 1
1 1 1 1 1 1 1 1 1 1 14 14 1 1 1 9 9 6 6 1 14 14 14 14 16 1 1 1 1 1 1 1
1 1 1 1 1 1 1 1 1 1 1 14 1 1 9 9 9 6 6 1 14 14 14 1 1 1 1 1 1 1 1 1
