1 1 15 1 1 1 1 1 1 15 1 15 1 16 9 9 16 1
1 15 1 15 1 1 1 1 1 1 15 1 16 9 9 9 16 1
1 1 15 16 16 16 16 1 16 16 16 16 15 15 9 16 1 1
1 1 16 9 9 15 15 16 15 15 15 15 15 15 15 16 1 1
1 1 16 16 9 15 15 15 15 15 15 15 8 16 15 15 16 1
1 1 1 16 16 16 15 8 16 15 15 15 16 16 15 15 16 1
16 16 16 16 1 16 15 16 16 15 16 15 15 13 13 15 16 1
9 9 9 9 16 16 13 13 15 15 15 15 15 13 13 15 16 1
9 9 9 9 16 16 13 13 15 15 16 15 15 15 15 15 16 1
9 9 9 9 9 9 16 16 16 15 9 9 15 15 15 16 16 1
16 16 16 9 9 9 16 15 15 15 15 15 15 15 15 15 16 1
1 1 16 16 9 16 15 15 15 15 15 15 15 16 15 16 16 1
1 1 1 1 16 16 15 15 16 15 16 14 14 14 16 15 16 1
1 15 1 1 16 15 15 15 15 16 14 14 14 14 15 15 16 1
15 1 15 1 16 15 15 15 15 14 14 14 14 14 15 15 16 1
1 15 1 1 16 15 15 15 15 14 14 14 14 14 15 15 16 1
1 1 1 1 1 16 9 9 16 16 16 16 16 16 9 16 1 15
1 1 1 1 1 1 16 16 1 1 1 1 1 16 16 1 15 1
---
1 1 16 1 1 1 1 1 1 16 1 16 1 15 15 15 15 1
1 16 1 16 1 1 1 1 1 1 16 1 15 15 15 15 15 1
1 1 16 15 15 15 15 1 15 15 15 15 9 9 15 15 1 1
1 1 15 15 15 9 9 15 9 9 9 9 9 9 9 15 1 1
1 1 15 15 15 9 9 9 9 9 9 9 9 13 9 9 15 1
1 1 1 15 15 15 9 9 13 9 9 9 13 13 9 9 15 1
15 15 15 15 1 15 9 13 13 9 13 9 9 16 16 14 15 1
15 15 15 15 15 15 16 16 14 14 14 14 14 16 16 14 15 1
15 15 15 15 15 15 16 16 14 14 13 14 14 14 14 14 15 1
15 15 15 15 15 15 15 15 15 16 8 8 16 16 16 15 15 1
15 15 15 15 15 15 15 16 16 16 16 16 16 16 16 16 15 1
1 1 15 15 15 15 16 16 16 16 16 16 16 15 16 15 15 1
1 1 1 1 15 15 16 16 14 16 14 16 16 16 15 16 15 1
1 16 1 1 15 16 16 16 16 14 16 16 16 16 16 16 15 1
16 1 16 1 15 16 16 16 16 16 16 16 16 16 16 16 15 1
1 16 1 1 15 16 16 16 16 16 16 16 16 16 16 16 15 1
1 1 1 1 1 15 16 16 15 15 15 15 15 15 16 15 1 16
1 1 1 1 1 1 15 15 1 1 1 1 1 15 15 1 16 1
