0 11 0 0 0 0 0 0 2 2 2 2 2 0 0 0 0 0
11 10 11 0 0 0 2 2 14 14 14 14 14 2 2 0 0 0
0 11 0 0 0 2 14 14 14 15 15 15 15 14 14 2 0 0
0 0 0 0 2 15 15 15 15 15 15 15 15 15 14 14 2 0
0 0 0 2 15 15 15 15 15 15 15 15 15 15 15 15 15 2
0 0 0 2 15 15 15 15 15 15 15 15 2 2 2 15 15 2
0 0 2 15 9 15 15 15 15 15 9 2 0 0 0 2 2 2
0 0 2 9 15 15 15 15 15 9 2 0 0 11 0 0 0 0
0 0 2 9 15 15 15 15 15 9 2 0 11 10 11 0 0 0
0 0 2 9 9 15 15 15 15 9 2 0 0 11 0 0 0 0
0 0 2 15 11 11 11 15 15 9 2 0 0 0 0 0 0 0
10 0 0 11 11 10 11 15 15 15 9 2 0 0 0 2 2 2
0 0 0 11 11 10 10 11 11 11 15 15 2 2 2 9 9 2
0 0 0 0 10 15 15 10 11 11 15 15 15 15 9 9 2 0
0 0 11 11 10 10 15 10 11 11 15 9 15 9 9 16 0 0
0 0 11 10 10 10 10 10 10 15 9 15 9 16 16 0 0 0
0 0 11 11 11 10 10 11 11 2 16 2 16 0 0 0 11 0
0 0 0 0 0 0 11 11 11 0 0 0 0 0 0 0 0 0
---
0 9 0 0 0 0 0 0 15 15 15 15 15 0 0 0 0 0
9 2 9 0 0 0 15 15 15 15 15 15 15 15 15 0 0 0
0 9 0 0 0 15 15 15 15 2 2 2 2 15 15 15 0 0
0 0 0 0 15 2 2 2 2 2 2 2 2 2 15 15 15 0
0 0 0 15 2 2 2 2 2 2 2 2 2 2 2 2 2 15
0 0 0 15 2 2 2 2 2 2 2 2 15 15 15 2 2 15
0 0 15 2 15 2 2 2 2 2 14 15 0 0 0 15 15 15
0 0 15 15 11 11 11 11 11 14 15 0 0 16 0 0 0 0
0 0 15 15 11 11 11 11 11 14 15 0 16 2 16 0 0 0
0 0 15 15 15 11 11 11 11 14 15 0 0 16 0 0 0 0
0 0 15 9 9 9 9 11 11 14 15 0 0 0 0 0 0 0
16 0 0 9 9 15 9 11 11 11 14 15 0 0 0 15 15 15
0 0 0 9 9 15 15 9 9 9 11 11 15 15 15 10 10 15
0 0 0 0 15 11 11 15 9 9 11 11 11 11 10 10 15 0
0 0 14 14 15 15 11 15 9 9 11 10 11 10 10 10 0 0
0 0 14 15 15 15 15 15 15 11 10 11 10 10 10 0 0 0
0 0 14 14 14 15 15 10 10 11 11 11 10 0 0 0 10 0
0 0 0 0 0 0 10 10 10 0 0 0 0 0 0 0 0 0
