0 16 16 16 0 0 0 0 0 0 0 0 0 0 0 0 0 0
16 2 9 19 16 16 16 0 0 0 0 0 0 0 0 0 0 0
0 16 2 16 19 19 19 16 0 0 0 0 0 0 0 0 0 0
0 16 2 16 16 9 19 19 16 0 0 0 0 0 0 0 0 0
0 16 2 16 2 2 9 19 19 16 0 0 0 0 16 16 0 0
0 16 2 9 16 16 2 9 19 19 16 0 0 16 9 9 16 0
0 16 2 9 16 0 16 2 9 19 19 16 16 9 2 2 9 16
0 16 2 9 16 0 1 16 2 9 9 9 9 2 16 16 9 16
0 16 2 9 16 0 1 0 16 2 2 2 2 16 0 16 9 16
0 16 2 9 16 0 3 0 1 16 16 16 1 0 0 16 9 16
0 16 2 9 16 0 3 0 3 0 1 0 1 0 16 2 9 16
0 16 2 9 16 0 3 0 3 0 3 0 1 16 2 9 16 0
0 16 2 9 16 0 3 0 3 0 1 0 1 2 2 16 0 0
0 16 2 9 16 0 3 0 1 0 1 16 2 2 16 0 0 0
0 16 2 9 16 0 1 0 1 0 16 2 2 16 0 0 0 0
0 16 2 9 16 0 1 0 1 16 2 2 16 0 0 0 0 0
0 16 2 9 16 0 1 0 16 2 2 16 0 0 0 0 0 0
0 16 2 9 16 0 1 16 2 2 16 0 0 0 0 0 0 0
0 16 2 9 16 0 16 2 2 16 0 0 0 0 0 0 0 0
16 2 2 9 16 16 2 2 16 0 0 0 0 0 0 0 0 0
16 2 2 2 16 2 2 16 0 0 0 0 0 0 0 0 0 0
16 2 2 2 2 2 16 0 0 0 0 0 0 0 0 0 0 0
0 16 16 16 16 16 0 0 0 0 0 0 0 0 0 0 0 0
---
0 3 3 3 0 0 0 0 0 0 0 0 0 0 0 0 0 0
3 16 16 16 3 3 9 0 0 0 0 0 0 0 0 0 0 0
0 3 16 2 16 16 16 9 0 0 0 0 0 0 0 0 0 0
0 3 16 2 2 1 16 16 9 0 0 0 0 0 0 0 0 0
0 3 16 2 16 16 1 16 16 9 0 0 0 0 9 9 0 0
0 19 16 2 2 2 16 1 16 16 9 0 0 9 1 1 9 0
0 19 16 2 2 0 2 16 1 16 16 9 9 1 16 16 1 9
0 19 16 2 2 0 16 2 16 1 1 1 1 16 9 9 1 9
0 19 16 2 2 0 16 0 2 16 16 16 16 9 0 9 1 9
0 19 16 2 2 0 16 0 16 2 2 2 16 0 0 9 1 9
0 19 16 2 2 0 16 0 16 0 16 0 16 0 9 16 1 9
0 19 16 2 2 0 16 0 16 0 16 0 16 9 16 1 9 0
0 19 16 2 2 0 16 0 16 0 16 0 16 16 16 9 0 0
0 19 16 2 2 0 16 0 16 0 16 2 16 16 9 0 0 0
0 19 16 2 2 0 16 0 16 0 2 16 16 9 0 0 0 0
0 19 16 2 2 0 16 0 16 2 16 16 9 0 0 0 0 0
0 19 16 2 2 0 16 0 2 16 16 9 0 0 0 0 0 0
0 2 16 2 2 0 16 2 16 16 9 0 0 0 0 0 0 0
0 2 16 2 2 0 2 16 16 9 0 0 0 0 0 0 0 0
2 16 16 2 2 2 16 16 9 0 0 0 0 0 0 0 0 0
2 16 16 16 2 16 16 9 0 0 0 0 0 0 0 0 0 0
2 16 16 16 16 16 2 0 0 0 0 0 0 0 0 0 0 0
0 2 2 2 2 2 0 0 0 0 0 0 0 0 0 0 0 0
