0 0 0 0 0 0 0 0 0 0 0 0 0 0 0 0 0 0 0 0
0 0 0 0 0 0 0 0 0 0 0 0 0 0 0 0 0 0 0 0
0 0 0 0 0 0 0 0 0 0 0 0 0 0 0 0 0 0 0 0
0 0 0 0 0 0 0 0 0 0 0 0 0 0 0 0 0 0 0 0
0 0 0 0 10 0 0 0 10 0 0 10 0 0 0 0 0 0 0 0
0 0 0 0 0 10 0 0 10 0 0 10 0 0 0 10 0 0 0 0
0 0 0 0 0 0 0 0 0 0 0 0 0 0 10 0 0 0 0 0
0 12 0 12 0 0 0 12 12 12 12 12 12 0 0 0 12 0 12 0
12 10 12 10 12 0 12 8 8 8 8 8 8 12 0 12 10 12 10 12
0 12 10 10 10 12 8 8 8 8 8 8 8 8 12 10 10 10 12 0
0 12 10 12 10 8 12 12 8 8 8 8 12 12 8 10 12 10 12 0
0 0 12 0 12 8 8 8 12 8 8 12 8 8 8 12 0 12 0 0
0 0 0 0 12 8 8 7 7 7 7 7 7 8 8 12 0 0 0 0
0 0 0 0 12 8 8 8 7 13 13 7 8 8 8 12 0 0 0 0
0 0 0 0 0 12 8 8 8 8 8 8 8 8 12 0 0 0 0 0
0 0 0 12 0 0 12 12 7 7 7 7 12 12 0 0 0 0 0 0
0 0 12 8 12 0 12 8 8 8 8 8 12 0 0 0 0 0 0 0
0 0 12 8 8 12 8 8 8 8 8 8 12 0 0 0 0 0 0 0
0 0 0 12 8 8 8 8 8 8 8 8 12 0 0 0 0 0 0 0
0 0 0 0 12 7 8 7 8 7 7 8 12 0 0 0 0 0 0 0
---
0 0 0 0 0 0 0 0 0 0 0 0 0 0 0 0 0 0 0 0
0 0 0 0 0 0 0 0 0 0 0 0 0 0 0 0 0 0 0 0
0 0 0 0 0 0 0 0 0 0 0 0 0 0 0 0 0 0 0 0
0 0 0 0 0 0 0 0 0 0 0 0 0 0 0 0 0 0 0 0
0 0 0 0 7 0 0 0 8 0 0 13 0 0 0 0 0 0 0 0
0 0 0 0 0 7 0 0 8 0 0 13 0 0 0 10 0 0 0 0
0 0 0 0 0 0 0 0 0 0 0 0 0 0 10 0 0 0 0 0
0 8 0 8 0 0 0 8 8 8 8 8 8 0 0 0 8 0 8 0
8 7 8 7 8 0 8 10 10 10 10 10 10 8 0 8 7 8 7 8
0 8 7 7 7 8 10 10 10 10 10 10 10 10 8 7 7 7 8 0
0 8 7 8 7 12 8 8 10 10 10 10 8 8 12 7 8 7 8 0
0 0 8 0 8 12 12 12 8 10 10 8 12 12 12 8 0 8 0 0
0 0 0 0 8 12 12 8 8 8 8 8 8 12 12 8 0 0 0 0
0 0 0 0 8 12 12 12 8 8 8 8 12 12 12 8 0 0 0 0
0 0 0 0 0 8 12 12 12 12 12 12 12 12 8 0 0 0 0 0
0 0 0 8 0 0 8 8 12 12 12 12 8 8 0 0 0 0 0 0
0 0 8 12 8 0 8 12 12 12 12 12 8 0 0 0 0 0 0 0
0 0 8 12 12 8 12 12 12 12 12 12 8 0 0 0 0 0 0 0
0 0 0 8 12 12 12 12 12 12 12 12 8 0 0 0 0 0 0 0
0 0 0 0 8 8 12 12 12 12 12 12 8 0 0 0 0 0 0 0
