0 0 0 0 0 0 0 0 18 18 18 0 0 0 0 0 0 0 0
0 0 0 0 0 0 0 18 6 6 6 18 0 0 0 0 0 0 0
0 0 0 0 0 0 0 18 6 6 6 18 0 0 0 0 0 0 0
0 0 0 0 0 0 0 0 18 6 18 0 0 0 0 0 0 0 0
0 0 18 0 0 0 18 18 18 6 18 18 18 0 0 0 0 18 0
0 18 6 18 0 18 6 6 6 6 6 5 5 18 0 0 18 6 18
18 6 6 18 18 6 6 6 14 14 6 6 6 5 18 18 6 6 18
18 5 6 18 6 6 6 14 18 18 14 6 6 6 5 18 6 5 18
18 5 5 6 6 14 6 6 14 14 6 6 14 6 5 6 6 5 18
18 5 5 6 14 18 14 6 6 6 6 14 18 14 5 18 5 5 18
0 18 5 6 6 14 6 12 12 12 12 6 14 6 5 6 5 18 0
0 0 18 18 6 6 6 6 12 12 6 6 6 5 5 18 18 0 0
0 0 0 0 18 6 6 6 6 6 6 6 6 18 18 0 0 0 0
0 0 0 18 1 11 11 11 11 11 11 11 11 1 1 18 0 0 0
0 0 18 1 1 1 1 1 1 1 15 15 1 1 1 1 18 0 0
0 18 6 6 18 11 1 1 1 1 15 1 11 11 18 1 6 18 0
0 18 18 6 18 18 11 11 11 11 11 11 1 1 18 6 6 18 0
0 0 18 18 18 1 1 1 1 1 1 1 1 1 18 18 18 0 0
0 0 0 0 18 1 1 18 18 18 18 18 1 1 18 0 0 0 0
0 0 0 18 4 4 4 4 18 0 18 4 4 4 4 18 0 0 0
0 0 0 0 18 18 18 18 0 0 0 18 18 18 18 0 0 0 0
---
0 0 0 0 0 0 0 0 1 1 1 0 0 0 0 0 0 0 0
0 0 0 0 0 0 0 1 1 1 1 1 0 0 0 0 0 0 0
0 0 0 0 0 0 0 1 1 1 1 1 0 0 0 0 0 0 0
0 0 0 0 0 0 0 0 1 1 1 0 0 0 0 0 0 0 0
0 0 6 0 0 0 6 6 1 1 1 6 6 0 0 0 0 6 0
0 6 18 6 0 6 1 1 1 1 1 11 11 6 0 0 6 18 6
6 18 18 6 6 1 1 1 18 18 1 1 1 11 6 6 18 18 6
6 18 18 6 1 1 5 18 15 15 18 1 1 1 11 6 18 18 6
6 18 18 5 5 18 5 5 18 18 5 5 18 11 11 18 18 18 6
6 18 18 5 18 12 18 5 5 5 5 18 12 18 11 18 18 18 6
0 6 18 5 5 18 5 18 18 18 18 11 18 11 11 18 18 6 0
0 0 6 6 5 5 5 5 18 18 11 11 11 11 11 6 6 0 0
0 0 0 0 6 5 12 12 12 12 15 11 11 6 6 0 0 0 0
0 0 0 6 18 4 4 4 4 4 4 4 4 18 18 6 0 0 0
0 0 6 18 18 18 18 18 18 18 18 18 18 18 18 18 6 0 0
0 6 14 14 6 18 18 18 18 18 18 18 18 18 6 18 14 6 0
0 6 6 14 6 6 18 18 18 18 18 18 18 18 6 14 14 6 0
0 0 6 6 6 18 18 18 18 18 18 18 18 18 6 6 6 0 0
0 0 0 0 6 18 18 6 6 6 6 6 18 18 6 0 0 0 0
0 0 0 6 14 14 14 14 6 0 6 14 14 14 14 6 0 0 0
0 0 0 0 6 6 6 6 0 0 0 6 6 6 6 0 0 0 0
