0 0 0 0 4 4 4 4 4 4 0 0 0 0
0 0 4 4 1 1 1 1 1 1 4 4 0 0
0 4 4 1 1 1 1 1 1 1 1 4 4 0
0 4 13 13 1 1 1 1 1 1 13 13 4 0
13 13 14 14 13 1 1 1 1 13 14 14 13 13
13 3 14 14 14 13 1 1 13 14 14 14 3 13
13 3 14 14 14 14 13 13 14 14 14 14 3 13
13 3 3 14 3 13 4 4 13 3 14 3 3 13
13 13 3 3 13 1 1 1 1 13 3 3 13 13
0 4 13 13 1 1 1 1 1 1 13 13 4 0
0 4 4 4 1 1 1 1 1 1 4 4 4 0
0 0 4 4 4 1 1 1 1 4 4 4 0 0
0 0 0 4 4 4 4 4 4 4 4 0 0 0
0 0 0 0 0 4 4 4 4 0 0 0 0 0
---
0 0 0 0 13 13 13 13 13 13 0 0 0 0
0 0 13 13 4 4 4 4 4 4 13 13 0 0
0 13 13 4 4 4 4 4 4 4 4 13 13 0
0 13 1 1 4 4 4 4 4 4 1 1 13 0
1 1 13 13 1 4 4 4 4 1 4 4 1 1
1 14 13 13 13 1 4 4 1 4 4 4 14 1
1 14 13 13 13 13 1 1 4 4 4 4 14 1
1 14 14 13 14 1 1 1 1 14 4 14 14 1
1 1 14 14 1 4 4 4 4 1 14 14 1 1
0 1 1 1 4 4 13 13 4 4 1 1 1 0
0 3 1 1 14 14 13 13 14 14 1 1 3 0
0 0 3 3 1 14 13 13 14 1 3 3 0 0
0 0 0 3 3 1 1 1 1 3 3 0 0 0
0 0 0 0 0 3 3 3 3 0 0 0 0 0
