0 0 0 0 0 0 0 0 0 0 0 0 0 0 0 0 0 0 16 0 16 0 0 0 0
0 0 0 0 0 0 0 0 0 0 0 0 0 0 0 0 0 16 6 16 6 16 0 0 0
0 0 0 0 0 0 0 0 0 0 0 0 0 0 0 0 0 16 6 6 6 16 0 0 0
0 16 16 16 16 16 16 16 16 16 16 16 0 16 16 16 16 16 6 6 6 16 16 16 0
16 2 2 2 2 2 2 2 2 2 2 2 16 2 2 2 2 16 6 6 6 16 2 2 16
16 2 14 14 14 14 14 14 14 14 14 3 16 3 14 14 14 14 14 14 14 14 14 2 16
16 2 14 14 14 14 14 14 14 14 14 3 16 3 14 14 14 14 14 14 14 14 14 2 16
16 2 14 17 17 17 17 17 17 17 17 3 16 3 17 17 17 17 17 17 17 17 14 2 16
16 2 14 14 14 14 14 14 14 3 3 15 15 9 3 14 14 14 14 14 14 14 14 2 16
16 2 14 14 14 14 14 14 14 14 3 3 16 3 14 14 14 14 14 14 14 14 14 2 16
16 2 14 17 17 17 17 17 17 17 17 3 16 3 17 17 17 17 17 17 17 17 14 2 16
16 2 14 14 14 14 14 14 14 3 3 15 15 9 3 14 14 14 14 14 14 14 14 2 16
16 2 14 14 14 14 14 14 14 14 3 3 16 3 14 14 14 14 14 14 14 14 14 2 16
16 2 14 17 17 17 17 17 17 17 17 3 16 3 17 17 17 17 17 17 17 17 14 2 16
16 2 14 14 14 14 14 14 14 3 3 15 15 9 3 14 14 14 14 14 14 14 14 2 16
16 2 14 14 14 14 14 14 14 14 3 3 16 3 14 14 14 14 14 14 14 14 14 2 16
16 2 14 17 17 17 17 17 17 17 17 3 16 3 17 17 17 17 17 17 17 17 14 2 16
16 2 14 14 14 14 14 14 14 3 3 15 15 9 3 14 14 14 14 14 14 14 14 2 16
16 2 14 14 14 14 14 14 14 14 3 3 16 3 14 14 14 14 14 14 14 14 14 2 16
16 2 14 17 17 17 17 17 17 17 17 3 16 3 17 17 17 17 17 17 17 17 14 2 16
16 2 14 14 14 14 14 14 14 3 3 15 15 9 3 14 14 14 14 14 14 14 14 2 16
16 2 14 14 14 14 14 14 14 14 3 3 16 3 14 14 14 14 14 14 14 14 14 2 16
16 2 2 2 2 2 2 2 2 2 2 2 16 2 2 2 2 2 2 2 2 2 2 2 16
0 16 16 16 16 16 16 16 16 16 16 16 0 16 16 16 16 16 16 16 16 16 16 16 0
---
0 0 0 0 0 0 0 0 0 0 0 0 0 0 0 0 0 0 14 0 14 0 0 0 0
0 0 0 0 0 0 0 0 0 0 0 0 0 0 0 0 0 14 14 14 14 14 0 0 0
0 0 0 0 0 0 0 0 0 0 0 0 0 0 0 0 0 14 14 14 14 14 0 0 0
0 14 14 14 14 14 14 14 14 14 14 14 0 14 14 14 14 14 14 14 14 14 14 14 0
14 3 3 3 3 3 3 3 3 3 3 3 14 14 14 14 14 14 14 14 14 14 14 14 14
14 3 17 17 17 17 17 17 17 17 17 16 14 16 2 2 2 2 2 2 2 2 2 17 14
14 3 17 17 17 17 17 17 17 17 17 16 14 16 2 2 2 2 2 2 2 2 2 17 14
14 3 17 14 14 14 14 14 14 14 14 16 14 16 14 14 14 14 14 14 14 14 2 17 14
14 3 17 17 17 17 17 17 17 16 16 14 14 14 16 2 2 2 2 2 2 2 2 17 14
14 3 17 17 17 17 17 17 17 17 16 16 14 16 2 2 2 2 2 2 2 2 2 17 14
14 3 17 14 14 14 14 14 14 14 14 16 14 16 14 14 14 14 14 14 14 14 2 17 14
14 3 17 17 17 17 17 17 17 16 16 14 14 14 16 2 2 2 2 2 2 2 2 17 14
14 3 17 17 17 17 17 17 17 17 16 16 14 16 2 2 2 2 2 2 2 2 2 17 14
14 3 17 14 14 14 14 14 14 14 14 16 14 16 14 14 14 14 14 14 14 14 2 17 14
14 3 17 16 16 16 16 16 16 16 16 14 14 14 16 2 2 2 2 2 2 2 2 17 14
14 3 16 16 16 16 16 16 16 16 16 16 14 16 2 2 2 2 2 2 2 2 2 17 14
14 3 16 14 14 14 14 14 14 14 14 16 14 16 16 16 16 16 16 16 16 16 2 17 14
14 3 16 16 16 16 16 16 16 16 16 14 14 14 16 16 16 16 16 16 16 16 16 17 14
14 3 16 16 16 16 16 16 16 16 16 16 14 16 16 16 16 16 16 16 16 16 16 17 14
14 3 16 14 14 14 14 14 14 14 14 16 14 16 14 14 14 14 14 14 14 14 16 17 14
14 3 3 3 3 3 3 15 15 16 16 14 14 14 16 6 6 9 9 9 9 9 16 17 14
14 3 15 15 15 15 15 15 15 15 16 16 14 16 6 6 6 6 6 6 6 6 6 17 14
14 3 3 3 3 3 3 3 3 3 3 3 14 17 17 17 17 17 17 17 17 17 17 17 14
0 14 14 14 14 14 14 14 14 14 14 14 0 14 14 14 14 14 14 14 14 14 14 14 0
