0 0 0 0 0 0 0 0 17 17 0 0 0 17 17 0 0 9 0 0 0 0 0 0
0 0 0 0 16 16 0 17 6 5 17 0 17 6 5 17 9 15 9 0 0 0 0 0
0 0 0 16 9 13 16 17 6 5 5 17 6 5 16 15 14 15 9 10 0 0 0 0
0 0 17 17 17 13 17 17 5 5 10 10 5 16 13 16 15 17 17 7 17 17 17 0
0 17 6 14 6 17 6 5 17 17 7 7 17 17 17 17 17 6 6 17 6 6 6 17
0 17 5 6 6 5 5 5 5 17 7 17 6 6 6 5 17 17 6 5 6 6 5 17
0 0 17 5 5 5 5 9 5 17 17 6 6 6 5 5 5 17 5 5 5 5 17 0
0 17 6 14 6 5 9 14 9 5 10 10 5 5 16 16 5 5 17 9 9 5 6 17
0 17 5 6 6 6 9 15 15 9 7 7 10 16 9 13 16 5 17 15 15 9 5 17
0 4 17 17 17 5 9 15 15 15 16 7 16 9 14 13 13 16 15 15 17 17 17 0
4 14 14 14 14 17 9 15 15 16 13 16 16 13 13 13 16 5 4 17 3 1 3 4
0 4 4 3 3 14 17 17 17 4 4 4 4 4 4 4 17 17 17 1 1 4 4 0
0 0 4 1 3 3 3 3 3 3 3 3 3 3 3 3 3 1 1 1 3 4 0 0
0 0 4 1 1 1 1 1 1 1 1 1 1 1 1 1 1 1 1 1 3 4 0 0
0 0 0 4 3 3 3 3 3 3 1 1 1 1 1 1 1 1 1 3 4 0 0 0
0 0 0 4 3 3 3 3 3 1 1 1 1 1 1 1 1 1 1 3 4 0 0 0
0 0 0 0 4 3 3 1 1 1 1 1 1 1 1 1 1 1 3 4 0 0 0 0
0 0 0 0 0 4 4 1 1 1 1 1 1 1 1 1 3 4 4 0 0 0 0 0
0 0 0 0 0 0 0 4 4 4 1 1 1 1 4 4 4 0 0 0 0 0 0 0
0 0 0 0 0 0 0 0 0 0 4 4 4 4 0 0 0 0 0 0 0 0 0 0
---
0 0 0 0 0 0 0 0 1 1 0 0 0 1 1 0 0 17 0 0 0 0 0 0
0 0 0 0 7 7 0 1 17 17 1 0 1 17 17 1 17 17 17 0 0 0 0 0
0 0 0 7 7 7 7 1 17 17 17 1 17 17 17 17 17 17 17 17 0 0 0 0
0 0 1 1 1 7 1 1 17 17 17 17 17 17 17 17 17 1 1 17 1 1 1 0
0 1 17 17 17 1 17 17 1 1 17 17 1 1 1 1 1 4 4 1 17 17 17 1
0 1 17 17 17 17 17 17 17 1 17 1 17 17 17 4 1 1 4 4 17 17 4 1
0 0 1 17 17 17 17 16 17 1 1 17 17 17 4 4 4 1 4 4 4 4 1 0
0 1 16 16 16 17 16 16 16 17 5 5 4 4 5 5 4 4 1 5 5 4 5 1
0 1 16 16 16 16 16 5 5 16 5 5 5 5 5 5 5 4 1 5 5 5 4 1
0 3 1 1 1 16 16 5 5 5 5 5 5 5 5 5 5 5 5 5 1 1 1 0
3 3 3 3 3 1 16 5 5 5 16 5 5 5 5 5 5 1 1 1 1 1 1 3
0 3 3 15 15 3 1 1 1 16 10 10 10 10 10 10 1 1 1 6 6 3 3 0
0 0 3 6 15 15 15 15 15 15 15 15 15 15 15 15 15 6 6 6 4 3 0 0
0 0 3 6 6 6 6 6 6 6 6 6 6 6 6 6 6 6 6 6 4 3 0 0
0 0 0 3 4 4 4 4 4 4 14 14 14 6 6 6 6 6 6 4 3 0 0 0
0 0 0 3 4 4 4 4 4 14 14 14 14 14 14 14 13 13 13 4 3 0 0 0
0 0 0 0 3 4 4 9 9 9 9 13 13 13 13 13 13 13 4 3 0 0 0 0
0 0 0 0 0 3 3 9 9 9 9 9 9 9 9 9 4 3 3 0 0 0 0 0
0 0 0 0 0 0 0 3 3 3 9 9 9 9 3 3 3 0 0 0 0 0 0 0
0 0 0 0 0 0 0 0 0 0 3 3 3 3 0 0 0 0 0 0 0 0 0 0
