0 0 0 0 16 16 16 0 0 0 0
0 0 16 16 11 11 11 16 16 0 0
0 16 11 11 14 14 11 11 11 16 0
0 16 11 14 11 11 11 11 11 16 0
16 11 11 11 11 11 11 11 11 11 16
16 11 11 16 11 11 11 16 11 11 16
0 16 16 9 16 11 16 9 16 16 0
0 16 9 9 9 16 9 15 15 16 0
0 0 16 15 15 15 15 15 16 0 0
0 0 16 9 15 15 15 15 16 0 0
0 0 0 16 15 15 15 16 0 0 0
0 0 0 16 9 15 15 16 0 0 0
0 0 0 0 16 9 16 0 0 0 0
0 0 0 0 0 16 0 0 0 0 0
---
0 0 0 0 16 16 16 0 0 0 0
0 0 16 16 11 11 11 16 16 0 0
0 16 11 11 14 14 11 11 11 16 0
0 16 11 14 11 11 11 11 11 16 0
16 11 11 11 11 11 11 11 11 11 16
16 11 11 16 9 9 9 16 11 11 16
0 15 16 11 16 9 16 9 15 15 0
0 15 11 11 11 16 9 16 16 15 0
0 0 15 16 16 16 16 16 15 0 0
0 0 15 9 16 16 16 16 15 0 0
0 0 0 15 16 16 16 15 0 0 0
0 0 0 15 9 16 16 15 0 0 0
0 0 0 0 15 9 15 0 0 0 0
0 0 0 0 0 15 0 0 0 0 0
