0 0 0 0 0 0 18 18 18 0 0 0 0 0 0
0 0 0 18 18 18 13 13 13 18 18 18 0 0 0
0 0 18 13 13 13 13 13 13 13 13 13 18 0 0
0 18 13 15 15 13 13 13 13 13 15 15 13 18 0
0 18 13 15 15 13 13 13 13 13 15 15 13 18 0
0 18 13 15 15 15 13 13 13 15 15 15 13 18 0
18 13 18 15 15 15 15 15 15 15 15 15 18 13 18
18 13 18 18 18 18 18 18 18 18 18 18 18 13 18
18 13 15 14 14 14 18 18 18 14 14 14 15 13 18
18 13 15 15 15 15 15 15 15 15 15 15 15 13 18
0 18 13 15 15 15 15 15 15 15 15 15 13 18 0
0 18 13 15 15 15 15 15 15 15 15 15 13 18 0
0 0 18 13 15 18 18 18 18 18 15 13 18 0 0
0 0 0 18 18 15 15 15 15 15 18 18 0 0 0
0 0 0 0 18 13 13 13 13 13 18 0 0 0 0
0 0 0 0 0 18 18 18 18 18 0 0 0 0 0
---
0 0 0 0 0 0 13 13 13 0 0 0 0 0 0
0 0 0 14 14 14 15 15 15 14 14 14 0 0 0
0 0 13 15 15 15 15 15 15 15 15 15 13 0 0
0 13 15 18 18 15 15 15 15 15 18 18 15 13 0
0 13 15 18 18 15 15 15 15 15 18 18 15 13 0
0 13 15 18 18 18 15 15 15 18 18 18 15 13 0
13 15 13 18 18 18 18 18 18 18 18 18 13 15 13
13 15 13 13 13 13 13 13 13 13 13 13 13 15 13
13 15 18 13 13 13 13 13 13 13 13 13 18 15 13
13 15 18 18 18 18 18 18 18 18 18 18 18 15 13
0 13 15 18 18 18 18 18 18 18 18 18 15 13 0
0 13 15 18 18 18 18 18 18 18 18 18 15 13 0
0 0 15 15 18 13 13 13 13 13 18 15 15 0 0
0 0 0 15 15 18 18 18 18 18 15 15 0 0 0
0 0 0 0 15 18 15 15 15 18 15 0 0 0 0
0 0 0 0 0 15 15 15 15 15 0 0 0 0 0
