0 0 0 0 0 0 0 0 0 0 0 0 0 0 0 0 0 0 0 18 18 18 18 0
0 0 18 18 18 18 18 18 18 0 0 0 0 0 0 0 0 0 18 1 1 1 1 18
0 18 15 15 15 15 15 15 15 18 0 0 0 0 0 0 0 18 1 1 1 1 14 18
18 15 9 9 9 9 9 9 15 15 18 0 0 0 0 0 18 1 1 1 1 14 18 0
18 9 9 18 18 18 18 18 9 9 18 0 0 0 0 18 1 1 1 1 14 18 0 0
18 9 9 18 0 0 0 18 9 9 18 0 0 0 18 1 1 1 1 14 18 0 0 0
18 9 9 18 18 18 18 18 9 9 18 0 0 18 1 1 1 1 14 18 0 0 0 0
18 9 9 15 15 15 15 9 9 9 18 0 18 1 1 1 1 14 18 0 0 0 0 0
0 18 9 9 9 9 9 9 9 18 1 18 1 1 1 1 14 18 0 0 0 0 0 0
0 0 18 18 18 18 18 18 18 1 4 4 18 4 14 14 18 0 0 0 0 0 0 0
0 0 0 0 0 0 0 0 0 18 4 18 1 18 18 18 0 0 0 0 0 0 0 0
0 0 18 18 18 18 18 18 18 1 1 1 18 1 14 14 18 0 0 0 0 0 0 0
0 18 15 15 15 15 15 15 15 18 1 18 1 1 1 14 14 18 0 0 0 0 0 0
18 15 9 9 9 9 9 9 15 15 18 0 18 1 1 1 14 14 18 0 0 0 0 0
18 9 9 18 18 18 18 18 9 9 18 0 0 18 1 1 1 14 14 18 0 0 0 0
18 9 9 18 0 0 0 18 9 9 18 0 0 0 18 1 1 1 14 14 18 0 0 0
18 9 9 18 18 18 18 18 9 9 18 0 0 0 0 18 1 1 1 14 14 18 0 0
18 9 9 15 15 15 15 9 9 9 18 0 0 0 0 0 18 1 1 1 14 14 18 0
0 18 9 9 9 9 9 9 9 18 0 0 0 0 0 0 0 18 1 1 1 14 14 18
0 0 18 18 18 18 18 18 18 0 0 0 0 0 0 0 0 0 18 1 1 1 1 18
0 0 0 0 0 0 0 0 0 0 0 0 0 0 0 0 0 0 0 18 18 18 18 0
---
0 0 0 0 0 0 0 0 0 0 0 0 0 0 0 0 0 0 0 9 9 9 9 0
0 0 1 1 1 1 1 1 1 0 0 0 0 0 0 0 0 0 9 18 18 18 18 9
0 1 9 9 9 9 9 9 9 1 0 0 0 0 0 0 0 9 18 18 18 18 18 9
1 9 18 18 18 18 18 18 9 9 1 0 0 0 0 0 9 18 18 18 18 18 9 0
1 18 18 15 15 15 15 15 18 18 1 0 0 0 0 9 18 18 18 18 18 9 0 0
1 18 18 15 0 0 0 15 18 18 1 0 0 0 9 18 18 18 18 18 9 0 0 0
1 18 18 15 15 15 15 15 18 18 1 0 0 9 18 18 18 18 18 9 0 0 0 0
1 18 18 18 18 18 18 18 18 18 1 0 1 18 18 18 18 18 9 0 0 0 0 0
0 1 18 18 18 18 18 18 18 1 18 1 18 18 18 18 18 9 0 0 0 0 0 0
0 0 1 1 1 1 1 1 1 18 15 15 1 15 18 18 9 0 0 0 0 0 0 0
0 0 0 0 0 0 0 0 0 1 15 1 18 1 9 9 0 0 0 0 0 0 0 0
0 0 1 1 1 1 1 1 1 18 18 18 1 18 18 18 9 0 0 0 0 0 0 0
0 1 9 9 9 9 9 9 9 1 18 1 18 18 18 18 18 9 0 0 0 0 0 0
1 9 14 18 18 18 18 18 9 9 1 0 1 18 18 18 18 18 9 0 0 0 0 0
1 14 14 15 15 15 15 15 14 14 1 0 0 9 18 18 18 18 18 9 0 0 0 0
1 14 14 15 0 0 0 15 14 14 1 0 0 0 9 18 18 18 18 18 9 0 0 0
1 14 14 15 15 15 15 15 14 14 1 0 0 0 0 9 18 18 18 18 18 9 0 0
1 14 14 4 4 4 4 14 14 14 1 0 0 0 0 0 9 18 18 18 18 18 9 0
0 1 14 14 14 14 14 14 14 1 0 0 0 0 0 0 0 9 18 18 18 18 18 9
0 0 1 1 1 1 1 1 1 0 0 0 0 0 0 0 0 0 9 18 18 18 18 9
0 0 0 0 0 0 0 0 0 0 0 0 0 0 0 0 0 0 0 9 9 9 9 0
