0 0 0 0 0 0 0 0 0 0 0 16 16 16 16 16 16 16 0 17 17 17 0 0 0 0 0 0
0 0 0 0 0 0 0 0 0 0 16 9 9 9 9 9 9 9 16 17 6 6 17 0 0 0 0 0
0 0 0 17 17 17 17 0 0 16 9 2 2 2 2 2 2 2 2 16 5 5 17 0 0 0 0 0
0 0 17 17 6 6 17 17 16 16 2 2 2 2 2 19 19 9 19 2 16 5 17 17 17 17 17 0
0 0 17 6 5 5 6 6 16 9 2 2 2 2 19 19 19 9 19 19 2 16 17 6 6 6 17 0
0 16 16 5 5 5 5 16 9 2 2 2 2 19 19 19 19 9 19 19 2 16 5 5 5 5 6 17
16 16 14 16 5 5 5 16 2 2 2 2 19 19 19 19 19 9 19 19 19 2 16 5 6 5 6 17
16 14 14 16 16 16 16 2 2 2 2 2 19 19 19 19 19 14 19 19 19 2 16 5 5 17 17 0
16 16 14 14 14 16 2 2 17 2 17 17 19 19 19 9 14 14 14 9 19 19 16 5 17 6 17 0
0 16 14 8 17 17 17 17 6 17 6 6 17 9 9 19 19 9 19 19 9 16 5 5 5 5 17 0
16 8 8 16 17 5 5 5 5 5 6 17 19 19 19 19 19 19 19 19 19 16 17 17 17 17 0 0
0 16 16 16 1 18 18 18 18 18 18 18 18 18 18 18 18 18 18 18 18 3 3 18 0 0 0 0
0 0 18 1 1 1 1 3 3 3 3 3 3 3 3 3 3 3 3 3 3 3 18 0 0 0 0 0
0 0 0 18 18 1 1 1 1 1 1 1 3 3 3 3 3 3 3 3 18 18 0 0 0 0 0 0
0 0 0 0 0 18 18 18 18 4 4 4 4 4 1 1 18 18 18 18 0 0 0 0 0 0 0 0
0 0 0 0 0 0 0 0 0 18 18 18 18 18 18 18 0 0 0 0 0 0 0 0 0 0 0 0
---
0 0 0 0 0 0 0 0 0 0 0 19 19 19 19 19 19 19 0 2 2 2 0 0 0 0 0 0
0 0 0 0 0 0 0 0 0 0 19 5 5 5 5 5 5 5 19 2 2 2 2 0 0 0 0 0
0 0 0 5 5 5 5 0 0 19 5 18 18 18 18 18 18 18 18 19 2 2 2 0 0 0 0 0
0 0 5 5 3 3 5 5 19 19 18 18 18 18 18 4 4 6 19 18 19 2 2 2 2 2 2 0
0 0 5 3 3 3 3 3 19 5 18 18 18 18 4 4 4 6 19 19 18 19 2 9 9 9 2 0
0 19 19 3 3 3 3 19 5 18 18 18 18 1 1 1 1 6 19 19 18 19 9 9 9 9 9 2
19 19 3 19 3 3 3 19 18 18 18 18 1 1 1 1 1 6 14 14 14 18 19 9 9 9 9 2
19 3 3 19 19 19 19 18 18 18 18 18 1 1 1 1 1 6 14 14 14 18 19 9 9 2 2 0
19 19 3 3 3 19 18 18 5 18 5 5 6 6 6 6 6 6 6 6 14 14 19 9 2 9 2 0
0 19 3 3 5 5 5 5 3 5 8 8 5 6 6 6 2 6 14 14 6 19 9 9 9 9 2 0
19 3 3 19 5 16 16 16 16 16 8 5 2 2 2 2 2 2 2 2 14 19 2 2 2 2 0 0
0 19 19 19 17 16 16 16 16 16 16 16 16 16 16 16 16 16 16 16 16 17 17 16 0 0 0 0
0 0 16 17 17 17 17 17 17 17 17 17 17 17 17 17 17 17 17 17 17 17 16 0 0 0 0 0
0 0 0 16 16 17 17 17 17 17 17 17 17 17 17 17 17 17 17 17 16 16 0 0 0 0 0 0
0 0 0 0 0 16 16 16 16 17 17 17 17 17 17 17 16 16 16 16 0 0 0 0 0 0 0 0
0 0 0 0 0 0 0 0 0 16 16 16 16 16 16 16 0 0 0 0 0 0 0 0 0 0 0 0
