0 0 0 0 0 13 13 0 0 0 0 0
0 0 0 0 13 5 13 13 0 0 0 0
0 0 7 7 13 13 13 13 7 7 0 0
0 7 7 9 7 7 2 7 2 7 7 0
9 7 9 9 7 2 7 2 2 2 7 2
9 9 9 9 9 2 2 2 2 2 2 2
4 1 1 1 1 1 1 1 4 1 4 4
0 4 4 1 1 1 1 4 4 4 4 0
0 0 4 4 1 1 4 4 1 4 0 0
0 0 0 0 4 1 4 1 0 0 0 0
0 0 0 0 0 1 4 0 0 0 0 0
0 0 0 0 0 1 4 0 0 0 0 0
0 0 0 4 1 1 1 4 4 0 0 0
---
0 0 0 0 0 1 1 0 0 0 0 0
0 0 0 0 1 4 1 1 0 0 0 0
0 0 1 1 1 1 1 1 1 1 0 0
0 1 1 13 1 1 4 1 4 1 4 0
13 1 13 13 1 4 1 4 4 4 4 4
13 13 13 13 13 4 4 4 4 4 4 4
2 2 2 2 4 4 4 4 7 4 7 7
0 2 2 2 2 2 2 7 7 7 7 0
0 0 2 2 2 9 7 7 9 7 0 0
0 0 0 0 2 9 7 9 0 0 0 0
0 0 0 0 0 9 7 0 0 0 0 0
0 0 0 0 0 9 7 0 0 0 0 0
0 0 0 5 9 9 9 7 7 0 0 0
