0 0 0 0 0 0 0 0 0 0 0 0 0 0 18 18 18 0 0 0 0 0 0 0 0
0 0 0 0 0 0 0 0 0 0 0 0 0 18 13 13 13 18 0 0 0 0 0 0 0
0 0 0 0 0 0 0 0 0 0 0 0 18 13 13 13 14 13 18 0 0 0 0 0 0
0 18 18 0 0 0 0 0 0 0 0 18 13 13 13 13 13 13 18 0 0 0 0 0 0
18 8 8 18 0 0 0 0 0 0 0 18 13 13 13 13 13 13 18 0 0 0 0 0 0
18 8 2 18 0 0 0 0 0 0 0 18 18 18 13 13 13 18 14 18 0 0 0 0 0
0 18 2 8 18 0 0 0 0 0 18 14 14 14 18 18 18 14 14 14 18 0 0 0 0
0 18 8 2 18 0 0 0 0 18 14 14 14 14 14 14 14 14 14 14 18 0 0 0 0
0 0 18 2 8 18 0 0 0 18 14 14 14 14 14 14 14 14 14 14 18 0 0 0 0
0 0 18 8 2 18 0 0 18 14 14 14 14 14 14 14 14 14 14 14 18 0 0 0 0
0 0 0 18 2 8 18 0 18 14 14 14 14 14 18 18 14 14 14 14 18 0 0 0 0
0 0 0 18 8 8 18 0 18 18 14 14 14 18 7 7 18 14 14 18 18 18 0 0 0
0 0 0 0 18 8 8 18 7 7 18 14 14 18 7 7 7 18 18 7 7 7 18 0 0
0 0 0 0 18 8 18 7 7 7 18 14 18 7 7 7 7 7 7 7 7 7 18 0 0
0 0 0 0 0 18 7 7 7 7 7 18 18 7 7 7 7 7 7 7 7 7 7 18 18
0 0 0 0 18 7 7 7 7 7 7 7 7 7 7 7 7 7 7 7 7 7 7 7 18
0 0 0 18 7 7 7 7 7 7 7 7 7 7 7 7 7 7 7 7 7 7 7 7 18
0 0 18 7 7 7 7 7 7 7 7 7 7 7 7 7 7 7 7 7 7 7 7 7 18
0 0 18 18 18 7 7 7 7 7 7 7 7 7 7 7 7 7 7 7 7 7 18 18 18
0 0 18 3 3 18 18 18 7 7 7 7 7 7 7 7 7 7 7 18 18 18 3 3 18
0 0 18 3 3 3 3 3 18 18 18 18 18 18 18 18 18 18 18 3 3 3 3 3 18
0 0 18 3 3 3 3 3 3 3 3 3 3 3 3 3 3 3 3 3 3 3 3 3 18
0 0 0 18 18 3 3 3 3 3 3 3 3 3 3 3 3 3 3 3 3 3 3 18 0
0 0 0 0 0 18 18 3 3 3 3 3 3 3 3 3 3 3 3 3 3 18 18 0 0
0 0 0 0 0 0 0 18 18 3 3 3 3 3 3 3 3 3 3 18 18 0 0 0 0
0 0 0 0 0 0 0 0 0 18 18 3 3 3 3 3 3 18 18 0 0 0 0 0 0
0 0 0 0 0 0 0 0 0 0 0 18 18 18 18 18 18 0 0 0 0 0 0 0 0
0 0 0 0 0 0 0 0 0 0 0 0 0 18 3 3 18 0 0 0 0 0 0 0 0
0 0 0 0 0 0 0 0 0 0 0 18 18 18 3 3 18 18 18 0 0 0 0 0 0
0 0 0 0 0 0 0 0 0 18 18 3 3 3 3 3 3 3 3 18 18 0 0 0 0
0 0 0 0 0 0 0 0 18 3 3 3 3 3 3 3 3 3 3 3 3 18 0 0 0
0 0 0 0 0 0 0 0 18 3 3 3 3 3 3 3 3 3 3 3 3 18 0 0 0
0 0 0 0 0 0 0 0 0 18 18 3 3 3 3 3 3 3 3 18 18 0 0 0 0
0 0 0 0 0 0 0 0 0 0 0 18 18 18 18 18 18 18 18 0 0 0 0 0 0
---
0 0 0 0 0 0 0 0 0 0 0 0 0 0 18 18 18 0 0 0 0 0 0 0 0
0 0 0 0 0 0 0 0 0 0 0 0 0 18 2 13 13 18 0 0 0 0 0 0 0
0 0 0 0 0 0 0 0 0 0 0 0 18 8 8 8 13 18 18 0 0 0 0 0 0
0 18 18 0 0 0 0 0 0 0 0 18 8 8 8 8 8 8 18 0 0 0 0 0 0
18 13 13 18 0 0 0 0 0 0 0 18 8 8 2 2 8 8 18 0 0 0 0 0 0
18 13 13 18 0 0 0 0 0 0 0 18 18 18 2 2 2 14 14 18 0 0 0 0 0
0 18 13 13 18 0 0 0 0 0 18 7 7 7 18 18 18 14 14 14 18 0 0 0 0
0 18 13 13 18 0 0 0 0 18 7 7 7 7 14 14 14 14 14 14 18 0 0 0 0
0 0 18 13 13 18 0 0 0 18 7 7 7 7 14 14 14 14 14 14 18 0 0 0 0
0 0 18 13 13 18 0 0 18 7 7 7 7 7 14 14 14 14 14 14 18 0 0 0 0
0 0 0 18 13 13 18 0 18 7 7 7 7 7 18 18 14 14 14 14 18 0 0 0 0
0 0 0 18 13 13 18 0 18 18 7 7 7 18 14 14 18 14 14 18 18 18 0 0 0
0 0 0 0 18 13 13 18 14 14 18 7 7 18 14 14 14 18 18 14 14 14 18 0 0
0 0 0 0 18 13 18 14 14 14 18 7 18 14 14 14 14 14 14 14 14 14 18 0 0
0 0 0 0 0 18 14 14 14 14 14 18 18 7 7 7 7 7 3 3 3 3 3 18 18
0 0 0 0 18 7 7 7 7 7 7 7 7 7 7 7 7 7 7 7 3 3 3 3 18
0 0 0 18 7 7 7 7 7 7 7 7 7 7 7 7 7 7 7 7 3 3 3 3 18
0 0 18 7 7 7 7 7 7 7 7 7 7 7 7 7 7 7 7 7 3 3 3 3 18
0 0 18 18 3 7 7 7 7 7 7 7 7 7 7 7 7 7 7 7 3 3 18 18 18
0 0 18 3 3 3 3 3 7 7 7 7 7 7 7 7 7 7 7 18 18 18 18 18 18
0 0 18 3 3 3 3 3 3 3 3 3 3 3 3 3 3 3 3 18 18 18 18 18 18
0 0 18 3 3 3 3 3 3 3 3 3 3 3 3 3 3 3 3 3 18 18 18 18 18
0 0 0 18 18 3 3 3 3 3 3 3 3 3 3 3 3 3 3 3 18 18 18 18 0
0 0 0 0 0 18 18 3 3 3 3 3 3 3 3 3 3 3 3 3 18 18 18 0 0
0 0 0 0 0 0 0 18 18 3 3 3 3 3 3 3 3 3 3 18 18 0 0 0 0
0 0 0 0 0 0 0 0 0 18 18 3 3 3 3 3 3 18 18 0 0 0 0 0 0
0 0 0 0 0 0 0 0 0 0 0 18 18 18 18 18 18 0 0 0 0 0 0 0 0
0 0 0 0 0 0 0 0 0 0 0 0 0 18 7 7 18 0 0 0 0 0 0 0 0
0 0 0 0 0 0 0 0 0 0 0 18 18 18 7 7 18 18 18 0 0 0 0 0 0
0 0 0 0 0 0 0 0 0 18 18 3 3 3 3 7 7 7 7 18 18 0 0 0 0
0 0 0 0 0 0 0 0 18 3 3 3 3 3 3 3 7 7 7 7 7 18 0 0 0
0 0 0 0 0 0 0 0 18 3 3 3 3 3 3 3 3 7 7 7 7 18 0 0 0
0 0 0 0 0 0 0 0 0 18 18 3 3 3 3 3 3 7 7 18 18 0 0 0 0
0 0 0 0 0 0 0 0 0 0 0 18 18 18 18 18 18 18 18 0 0 0 0 0 0
