0 0 0 0 0 0 0 0 0 0 0 18 18 18 18 0 0 0 0
0 0 0 0 0 0 0 0 0 0 18 10 7 7 7 18 0 0 0
0 0 0 0 0 0 0 0 0 18 14 14 10 7 7 7 18 0 0
0 0 0 0 0 0 0 0 18 3 14 14 14 10 7 7 7 18 0
0 0 0 0 0 0 0 18 9 9 3 14 14 14 10 7 7 10 18
0 0 0 0 0 0 18 9 9 9 2 3 14 14 14 10 7 10 18
0 0 0 0 0 18 9 9 9 2 9 2 3 14 14 14 10 10 18
0 0 0 0 18 9 9 9 2 9 9 9 2 3 14 3 3 18 0
0 0 0 18 9 9 9 2 9 9 9 2 9 2 3 3 18 0 0
0 0 18 9 9 9 2 9 9 9 2 9 9 2 2 18 0 0 0
0 0 18 9 18 18 9 9 9 2 9 9 2 2 18 0 0 0 0
0 0 18 18 8 18 9 9 2 9 9 2 2 18 0 0 0 0 0
0 18 8 8 8 18 18 18 9 9 2 2 18 0 0 0 0 0 0
0 18 8 8 8 8 8 18 9 2 2 18 0 0 0 0 0 0 0
18 8 8 8 8 8 8 18 2 18 18 0 0 0 0 0 0 0 0
18 18 18 8 8 8 18 18 18 0 0 0 0 0 0 0 0 0 0
18 18 18 8 18 18 0 0 0 0 0 0 0 0 0 0 0 0 0
18 18 18 18 0 0 0 0 0 0 0 0 0 0 0 0 0 0 0
---
0 0 0 0 0 0 0 0 0 0 0 9 9 9 9 0 0 0 0
0 0 0 0 0 0 0 0 0 0 9 2 18 18 18 9 0 0 0
0 0 0 0 0 0 0 0 0 9 18 18 2 18 18 18 9 0 0
0 0 0 0 0 0 0 0 9 10 18 18 18 2 18 18 18 9 0
0 0 0 0 0 0 0 9 3 3 10 18 18 18 2 18 18 2 9
0 0 0 0 0 0 9 3 3 3 18 10 18 18 18 2 18 2 9
0 0 0 0 0 9 3 3 3 18 14 18 10 18 18 18 2 2 9
0 0 0 0 9 8 8 3 18 14 14 14 18 10 18 10 10 9 0
0 0 0 9 8 8 8 18 14 14 14 18 8 7 10 10 9 0 0
0 0 9 8 8 8 18 14 14 14 18 8 8 7 7 9 0 0 0
0 0 9 8 9 9 14 14 14 18 8 8 7 7 9 0 0 0 0
0 0 9 9 18 9 14 14 18 8 8 7 7 9 0 0 0 0 0
0 9 18 18 18 9 9 9 8 8 7 7 9 0 0 0 0 0 0
0 2 18 18 18 18 18 9 8 7 7 9 0 0 0 0 0 0 0
2 18 18 18 18 18 18 9 7 9 9 0 0 0 0 0 0 0 0
2 2 2 18 18 18 9 9 9 0 0 0 0 0 0 0 0 0 0
2 2 2 18 2 2 0 0 0 0 0 0 0 0 0 0 0 0 0
2 2 2 2 0 0 0 0 0 0 0 0 0 0 0 0 0 0 0
