0 0 0 0 0 0 18 18 18 18 18 18 0 0 0 0 0
0 0 0 0 18 18 13 13 14 13 13 13 18 18 0 0 0
0 0 0 18 13 13 13 13 13 13 18 18 14 14 18 0 0
0 0 18 13 14 13 13 14 13 18 14 14 14 14 18 0 0
0 18 13 13 13 13 13 13 18 14 14 14 14 18 0 0 0
0 18 13 13 13 14 13 18 14 14 14 18 18 0 0 0 0
0 18 13 13 13 13 18 14 14 14 18 0 0 0 0 0 0
18 13 14 13 13 13 18 14 14 18 0 0 0 18 18 18 0
18 13 13 13 14 13 18 14 14 14 18 18 18 14 14 14 18
0 18 13 13 13 13 13 18 14 14 14 14 14 14 14 14 18
0 0 18 13 14 13 13 18 14 14 14 14 14 14 18 18 0
0 0 18 13 13 13 13 14 18 18 18 18 18 18 0 0 0
0 0 0 18 18 14 13 13 13 13 14 13 18 0 0 0 0
0 0 0 0 0 18 18 18 18 18 18 18 0 0 0 0 0
0 0 0 0 0 0 18 5 6 18 0 0 0 0 0 0 0
0 0 0 0 0 0 18 5 6 18 0 0 0 0 0 0 0
0 0 18 18 18 0 18 5 6 18 0 18 18 18 0 0 0
0 0 18 6 6 18 18 5 6 18 18 6 6 18 0 0 0
0 0 18 5 5 18 5 5 5 6 18 5 5 18 0 0 0
0 0 0 18 5 5 5 5 5 5 5 5 18 0 0 0 0
0 0 0 0 18 18 18 18 18 18 18 18 0 0 0 0 0
---
0 0 0 0 0 0 13 13 13 13 13 13 0 0 0 0 0
0 0 0 0 13 13 18 18 6 18 18 18 13 13 0 0 0
0 0 0 13 18 18 18 18 18 18 13 13 18 18 13 0 0
0 0 13 18 6 18 18 6 18 13 18 18 18 18 13 0 0
0 13 18 18 18 18 18 18 13 18 18 18 18 13 0 0 0
0 13 18 18 18 6 18 13 18 18 18 13 13 0 0 0 0
0 13 18 18 14 14 13 18 18 18 13 0 0 0 0 0 0
13 18 6 14 14 14 13 18 18 13 0 0 0 13 13 13 0
13 5 5 5 6 14 13 18 18 18 13 13 13 18 18 18 13
0 13 5 5 5 5 5 13 18 18 18 18 18 18 18 18 13
0 0 13 5 6 5 5 13 18 18 18 18 18 18 13 13 0
0 0 13 5 5 5 5 18 13 13 13 13 13 13 0 0 0
0 0 0 13 14 6 5 5 5 5 6 14 14 0 0 0 0
0 0 0 0 0 14 14 14 14 14 14 14 0 0 0 0 0
0 0 0 0 0 0 14 18 18 14 0 0 0 0 0 0 0
0 0 0 0 0 0 14 18 18 14 0 0 0 0 0 0 0
0 0 14 14 14 0 14 18 18 14 0 14 14 14 0 0 0
0 0 14 18 18 14 14 18 18 14 14 18 18 14 0 0 0
0 0 14 18 18 14 18 18 18 18 14 18 18 14 0 0 0
0 0 0 14 18 18 18 18 18 18 18 18 14 0 0 0 0
0 0 0 0 14 14 14 14 14 14 14 14 0 0 0 0 0
