0 0 0 15 15 15 0 0 0
0 0 15 0 0 0 15 0 0
0 0 15 0 0 9 15 0 0
0 0 15 0 0 9 0 0 0
0 0 0 15 15 15 0 0 0
0 0 0 0 9 0 0 0 0
0 15 15 15 9 15 15 15 0
15 13 13 13 9 13 14 13 15
15 13 10 10 14 10 14 13 15
15 13 10 10 10 14 10 13 15
15 13 13 10 10 10 10 13 15
0 15 13 13 10 10 13 15 0
0 0 15 13 13 13 15 0 0
0 0 0 15 15 15 0 0 0
---
0 0 0 13 13 13 0 0 0
0 0 13 0 0 0 13 0 0
0 0 13 0 0 15 13 0 0
0 0 13 0 0 15 0 0 0
0 0 0 13 13 13 0 0 0
0 0 0 0 13 0 0 0 0
0 14 14 14 13 9 9 9 0
14 15 15 15 13 10 13 15 9
10 15 15 15 13 15 13 15 9
10 15 15 15 15 13 15 15 10
10 15 15 15 15 15 15 15 10
0 10 15 15 15 15 15 10 0
0 0 10 15 15 15 10 0 0
0 0 0 10 10 10 0 0 0
