0 0 0 0 0 0 0 0 0 11 11 11 11 11 11 11 0 0 0 0 0 0 0 0
0 0 0 0 0 0 0 0 11 1 1 15 15 3 3 3 11 11 0 0 0 0 0 0
0 0 0 0 0 0 11 11 7 1 15 15 3 3 3 14 14 14 11 0 0 0 0 0
0 0 0 0 0 11 7 7 1 15 15 3 3 3 14 11 11 11 11 0 0 0 0 0
0 0 0 0 11 7 7 7 1 15 15 3 3 14 11 0 0 0 0 0 0 0 0 0
0 0 0 0 11 7 7 1 15 15 3 3 3 14 11 0 0 0 0 0 11 11 11 0
0 0 0 11 15 7 11 14 15 15 3 3 14 11 19 11 0 0 0 11 3 3 3 11
0 0 11 15 15 4 14 11 14 15 3 3 14 11 19 19 11 0 11 3 3 3 11 0
11 11 15 15 15 4 4 11 14 10 3 3 14 11 11 19 19 11 3 3 11 11 0 0
0 0 11 15 15 7 11 14 10 10 3 3 3 14 11 19 19 11 3 11 0 0 0 0
0 0 0 11 15 7 10 10 10 10 3 3 3 14 11 19 19 11 1 1 11 0 0 0
0 0 0 0 11 7 7 10 10 15 15 3 14 11 19 19 11 0 11 1 11 0 0 0
0 0 0 0 11 7 7 1 1 15 15 3 14 11 19 11 0 0 0 11 11 0 0 0
0 0 0 0 0 11 7 7 1 15 15 15 3 14 11 0 0 0 0 0 0 0 0 0
0 0 0 0 0 0 11 11 1 1 15 15 3 3 14 11 11 0 0 0 0 0 0 0
0 0 0 0 0 11 7 7 11 11 11 15 15 3 3 14 14 11 0 0 0 0 0 0
0 0 0 0 0 11 7 11 0 11 1 11 11 11 11 11 11 0 0 0 0 0 0 0
0 0 0 0 0 11 7 11 0 11 1 1 11 0 0 0 0 0 0 0 0 0 0 0
0 0 0 0 0 0 11 0 0 0 11 1 11 0 0 0 0 0 0 0 0 0 0 0
0 0 0 0 0 0 0 0 0 0 0 11 0 0 0 0 0 0 0 0 0 0 0 0
---
0 0 0 0 0 0 0 0 0 15 15 15 15 15 15 15 0 0 0 0 0 0 0 0
0 0 0 0 0 0 0 0 15 11 11 11 11 11 11 11 15 3 0 0 0 0 0 0
0 0 0 0 0 0 15 15 14 11 11 11 11 11 11 11 11 11 3 0 0 0 0 0
0 0 0 0 0 15 14 14 11 11 11 11 11 11 11 3 3 3 3 0 0 0 0 0
0 0 0 0 1 14 14 14 11 11 11 11 11 11 3 0 0 0 0 0 0 0 0 0
0 0 0 0 1 14 14 11 11 11 11 11 11 11 3 0 0 0 0 0 3 3 3 0
0 0 0 1 7 14 7 1 11 11 11 11 11 3 11 3 0 0 0 3 19 19 19 3
0 0 1 10 7 7 1 7 1 11 11 11 11 3 11 11 3 0 3 19 19 19 3 0
1 1 10 10 7 7 7 7 1 7 11 11 11 3 3 11 11 3 19 19 3 3 0 0
0 0 1 10 7 14 7 1 7 7 11 11 11 11 3 11 11 3 19 3 0 0 0 0
0 0 0 1 7 14 7 7 7 7 11 11 11 11 3 11 11 3 19 19 3 0 0 0
0 0 0 0 1 14 14 7 7 11 11 11 11 3 11 11 3 0 3 19 3 0 0 0
0 0 0 0 1 14 14 14 14 11 11 11 11 3 11 3 0 0 0 3 3 0 0 0
0 0 0 0 0 1 14 14 14 11 11 11 11 11 3 0 0 0 0 0 0 0 0 0
0 0 0 0 0 0 1 1 14 14 11 11 11 11 11 3 3 0 0 0 0 0 0 0
0 0 0 0 0 15 4 10 15 15 15 11 11 11 11 11 11 3 0 0 0 0 0 0
0 0 0 0 0 15 4 15 0 15 10 15 15 15 15 15 15 0 0 0 0 0 0 0
0 0 0 0 0 15 4 15 0 15 10 10 15 0 0 0 0 0 0 0 0 0 0 0
0 0 0 0 0 0 15 0 0 0 15 10 15 0 0 0 0 0 0 0 0 0 0 0
0 0 0 0 0 0 0 0 0 0 0 15 0 0 0 0 0 0 0 0 0 0 0 0
