0 0 18 18 18 0 0 0 0 18 18 18 0 0
0 18 13 13 13 18 0 0 18 10 10 13 18 0
18 13 10 14 10 13 18 18 13 10 13 13 13 18
18 13 14 10 10 10 10 10 10 13 13 13 13 18
18 13 10 10 10 13 13 13 13 13 13 13 13 18
18 13 13 10 13 13 13 13 13 13 13 13 13 18
0 18 13 13 10 13 13 13 13 13 13 13 18 0
0 0 18 13 13 10 13 13 13 13 13 18 0 0
0 0 0 18 13 13 10 13 13 13 18 0 0 0
0 0 0 0 18 13 13 13 13 18 0 0 0 0
0 0 0 0 0 18 13 13 18 0 0 0 0 0
0 0 0 0 0 18 18 18 18 0 0 0 0 0
0 0 0 0 0 18 15 9 18 0 0 0 0 0
0 0 0 0 0 18 15 9 18 0 0 0 0 0
0 0 0 0 0 18 15 9 18 0 0 0 0 0
0 0 0 0 0 18 15 9 18 18 18 18 0 0
0 0 0 0 0 18 15 9 2 15 15 18 0 0
0 0 0 0 0 18 15 9 2 9 18 0 0 0
0 0 0 0 0 18 15 9 2 9 9 18 0 0
0 0 0 0 0 18 15 9 18 18 18 18 0 0
0 0 0 0 0 18 9 9 18 0 0 0 0 0
0 0 0 0 0 0 18 18 0 0 0 0 0 0
---
0 0 13 13 13 0 0 0 0 13 13 13 0 0
0 13 18 18 18 13 0 0 13 18 18 10 13 0
13 18 18 13 18 18 13 13 18 18 10 10 10 13
13 18 13 18 18 18 18 18 18 10 10 10 10 13
13 18 18 18 18 18 10 10 10 10 10 10 10 13
13 18 18 18 9 10 10 10 14 15 15 15 15 13
0 13 18 18 18 9 9 9 14 15 15 15 13 0
0 0 13 18 18 18 9 9 2 15 15 13 0 0
0 0 0 13 18 9 18 9 2 15 13 0 0 0
0 0 0 0 13 9 9 9 2 13 0 0 0 0
0 0 0 0 0 13 9 9 13 0 0 0 0 0
0 0 0 0 0 13 13 13 13 0 0 0 0 0
0 0 0 0 0 13 18 18 13 0 0 0 0 0
0 0 0 0 0 13 18 18 13 0 0 0 0 0
0 0 0 0 0 13 18 18 13 0 0 0 0 0
0 0 0 0 0 13 18 18 13 13 13 13 0 0
0 0 0 0 0 13 18 18 18 18 18 13 0 0
0 0 0 0 0 13 18 18 18 18 13 0 0 0
0 0 0 0 0 13 18 18 18 18 18 13 0 0
0 0 0 0 0 13 18 18 13 13 13 13 0 0
0 0 0 0 0 13 18 18 13 0 0 0 0 0
0 0 0 0 0 0 13 13 0 0 0 0 0 0
