4 4 4 4 4 4 4 4 4 4 4 4 4 4 4 4 4 4
4 4 1 1 1 1 1 1 1 1 1 1 1 1 1 1 4 4
1 1 1 1 1 1 1 16 16 16 16 16 1 1 1 3 1 1
1 3 1 1 1 1 16 8 8 16 16 16 16 1 3 1 3 1
1 1 1 1 1 16 8 8 8 8 8 16 16 1 1 3 1 1
1 1 1 1 1 16 8 16 8 16 8 16 16 1 1 1 1 1
1 1 3 1 1 16 8 16 8 16 8 16 16 16 1 1 1 1
1 1 3 1 1 16 8 8 8 8 8 16 16 16 1 3 1 1
3 3 1 3 1 16 8 8 8 8 8 16 16 16 1 1 1 1
1 1 3 1 1 16 4 8 8 8 9 16 16 16 1 1 3 1
1 1 3 1 1 16 4 4 9 9 4 16 4 16 1 3 1 3
1 1 1 1 1 4 4 9 8 8 9 16 4 16 1 1 3 1
1 1 1 1 1 4 5 8 8 8 9 5 4 4 1 1 3 1
1 1 1 1 4 4 5 8 8 8 5 4 4 4 18 1 1 1
1 3 1 4 4 4 4 5 5 5 4 4 4 4 4 18 1 1
1 1 1 18 4 18 4 4 4 4 4 4 4 18 4 18 1 1
1 1 18 18 4 4 18 4 4 4 4 4 18 4 4 4 18 1
1 1 18 4 8 8 9 4 4 18 18 18 18 4 4 4 18 1
---
16 16 16 16 16 16 16 16 16 16 16 16 16 16 16 16 16 16
16 16 4 4 4 4 4 4 4 4 4 4 4 4 4 4 16 16
8 4 4 4 4 4 4 1 1 1 1 1 4 4 4 3 4 4
8 16 4 4 4 4 1 1 1 1 1 1 1 4 3 4 3 4
8 8 8 8 8 1 1 1 1 1 1 1 1 4 4 3 4 4
8 8 8 8 8 1 1 18 1 18 1 1 1 4 4 4 4 4
8 8 18 8 8 1 1 18 1 18 1 1 1 1 4 4 4 4
8 8 18 8 8 1 1 1 1 1 1 1 1 1 4 9 4 4
18 18 8 18 8 1 1 1 1 1 1 1 1 1 4 4 4 4
8 8 18 8 8 1 1 1 1 1 18 1 1 1 4 4 5 4
8 8 18 8 8 1 1 1 18 18 1 1 1 1 4 5 4 5
8 8 8 8 8 1 1 18 3 3 18 1 1 1 4 4 5 4
16 16 16 16 8 1 3 3 3 3 18 3 1 1 4 4 5 4
16 16 16 16 1 1 3 3 3 3 3 1 1 1 1 4 4 4
16 16 16 1 1 1 1 3 3 3 1 1 1 1 1 1 4 4
16 16 16 9 1 5 1 1 1 1 1 1 1 1 1 1 4 4
16 16 9 9 1 1 5 1 1 1 1 1 1 1 1 1 1 4
16 16 9 1 9 9 1 1 1 1 1 1 1 1 1 1 1 4
