0 0 0 0 18 18 18 18 18 18 0 0 0 0
0 0 18 18 6 6 6 6 6 6 18 18 0 0
0 18 6 6 6 6 14 14 6 6 6 6 18 0
0 18 6 6 5 14 14 14 14 5 6 6 18 0
0 18 5 5 6 6 6 6 6 6 5 5 18 0
18 8 2 2 8 18 8 8 18 8 2 2 8 18
18 10 2 8 8 18 10 10 18 8 8 2 10 18
0 18 8 8 18 8 8 8 8 18 8 8 18 0
0 0 18 8 8 18 18 18 18 8 8 18 0 0
0 0 18 18 8 8 8 8 8 8 18 18 0 0
0 18 6 6 1 1 6 6 1 1 6 6 18 0
18 14 14 1 15 15 1 1 15 15 1 14 14 18
18 14 14 1 1 15 1 1 15 1 1 14 14 18
0 18 18 1 1 1 1 1 1 1 1 18 18 0
0 0 18 1 1 4 4 4 4 1 1 18 0 0
0 0 18 1 1 1 18 18 1 1 1 18 0 0
0 18 2 2 2 18 0 0 18 2 2 2 18 0
0 18 18 18 18 18 0 0 18 18 18 18 18 0
---
0 0 0 0 6 6 6 6 6 6 0 0 0 0
0 0 6 6 18 18 18 18 18 18 6 6 0 0
0 6 18 18 18 18 18 18 18 18 18 18 6 0
0 6 18 18 18 18 18 18 18 18 18 18 6 0
0 6 18 18 18 18 18 18 18 18 18 18 6 0
6 1 1 1 1 14 14 14 14 1 1 1 1 6
6 4 1 1 1 14 14 14 14 1 1 1 4 6
0 6 1 1 14 1 1 1 1 14 1 1 6 0
0 0 6 1 1 14 14 14 14 1 1 6 0 0
0 0 6 6 1 1 1 1 1 1 6 6 0 0
0 6 2 2 18 18 4 4 18 18 2 2 6 0
8 2 2 18 5 5 18 18 5 5 18 2 2 8
8 2 2 18 18 5 18 18 5 18 18 2 2 8
0 8 8 18 18 18 18 18 18 18 18 8 8 0
0 0 8 18 18 10 10 10 10 18 18 8 0 0
0 0 8 18 18 18 8 8 18 18 18 8 0 0
0 8 15 15 15 8 0 0 8 15 15 15 8 0
0 8 8 8 8 8 0 0 8 8 8 8 8 0
