0 0 0 0 0 0 0 0 0 0 0 0 0 0 10 0 10 0
0 0 0 0 0 0 0 1 1 1 1 0 0 10 10 10 10 10
0 0 0 0 0 1 1 1 1 1 1 1 0 0 10 10 10 0
0 0 0 0 0 1 1 14 14 1 1 1 1 0 0 10 0 0
0 0 0 0 0 1 14 1 1 14 1 1 1 0 0 0 0 0
0 0 0 0 0 1 14 1 1 14 1 9 9 9 0 0 0 0
0 0 0 0 0 1 1 14 14 1 1 9 1 0 0 1 0 0
0 0 0 0 1 1 1 1 1 1 1 1 1 0 1 1 1 0
0 0 0 1 1 1 1 1 1 14 1 14 1 1 4 1 1 0
1 1 1 1 1 1 4 1 14 14 14 14 14 4 4 4 0 0
0 1 4 1 1 1 4 1 14 14 14 14 14 4 4 0 0 0
0 0 1 4 1 1 4 4 1 14 14 14 1 0 0 0 0 0
0 0 0 0 4 4 9 4 4 4 1 1 0 0 0 0 0 0
0 0 0 0 0 0 9 0 0 9 0 0 0 0 0 0 0 0
2 16 2 16 9 9 9 16 9 9 9 9 16 16 16 2 16 0
2 2 16 16 16 16 16 16 16 16 16 16 16 16 2 16 2 0
---
0 0 0 0 0 0 0 0 0 0 0 0 0 0 1 0 1 0
0 0 0 0 0 0 0 10 10 10 10 0 0 1 1 1 1 1
0 0 0 0 0 10 10 10 10 10 10 10 0 0 1 1 1 0
0 0 0 0 0 16 16 1 1 16 16 16 16 0 0 1 0 0
0 0 0 0 0 16 1 16 16 1 16 16 16 0 0 0 0 0
0 0 0 0 0 16 1 16 16 1 16 1 1 1 0 0 0 0
0 0 0 0 0 16 16 1 1 16 16 1 9 0 0 2 0 0
0 0 0 0 14 9 9 9 9 9 9 9 9 0 2 2 2 0
0 0 0 14 14 14 14 14 14 4 9 4 9 2 1 2 2 0
14 14 14 14 14 14 1 14 4 4 4 4 4 1 1 1 0 0
0 14 1 14 14 14 1 14 4 4 4 4 4 4 4 0 0 0
0 0 14 1 14 14 1 1 14 4 4 4 9 0 0 0 0 0
0 0 0 0 1 1 1 1 1 1 9 9 0 0 0 0 0 0
0 0 0 0 0 0 1 0 0 1 0 0 0 0 0 0 0 0
1 1 1 1 1 1 1 1 1 1 1 1 1 1 1 1 1 0
1 1 1 1 1 1 1 1 1 1 1 1 1 1 1 1 1 0
