0 0 0 0 0 16 16 16 0 0 0 0 0 0
0 0 0 0 16 7 13 13 16 0 0 0 0 0
0 17 17 0 16 13 13 13 16 0 0 16 16 0
0 17 5 17 16 13 13 13 16 0 16 7 13 16
0 17 5 5 17 16 16 16 17 0 16 13 13 16
0 17 5 5 17 0 0 17 17 17 5 16 16 0
0 17 5 5 17 17 17 17 0 5 5 5 17 0
0 0 17 17 17 16 16 16 0 17 5 5 17 0
0 17 17 0 16 7 13 13 16 0 17 17 17 0
17 17 0 0 16 13 13 13 16 0 0 0 0 0
17 0 0 0 16 13 13 13 16 0 0 0 0 0
0 0 0 0 0 16 16 16 0 0 0 0 0 0
---
0 0 0 0 0 5 5 5 0 0 0 0 0 0
0 0 0 0 5 7 16 16 5 0 0 0 0 0
0 17 17 0 5 16 16 16 5 0 0 16 16 0
0 17 13 17 5 16 16 16 5 0 16 7 17 16
0 17 13 13 17 5 5 5 17 0 16 17 17 16
0 17 13 13 17 0 0 17 17 17 17 16 16 0
0 17 13 13 17 17 17 17 0 5 17 17 17 0
0 0 16 16 16 13 13 13 0 17 17 17 17 0
0 16 16 0 13 7 16 16 13 0 17 17 17 0
16 16 0 0 13 16 16 16 13 0 0 0 0 0
16 0 0 0 13 16 16 16 13 0 0 0 0 0
0 0 0 0 0 13 13 13 0 0 0 0 0 0
