0 0 0 0 0 0 0 18 18 18 18 18 18 0 0 0 0 0 0 0
0 0 0 0 0 0 18 15 15 15 15 15 15 18 0 0 0 0 0 0
0 0 0 0 0 18 15 9 18 18 18 18 9 15 18 0 0 0 0 0
0 0 0 0 18 15 9 18 0 0 0 0 18 9 15 18 0 0 0 0
0 0 0 0 18 15 18 0 0 0 0 0 0 18 15 18 0 0 0 0
0 0 0 0 18 15 18 0 0 0 0 0 0 18 15 18 0 0 0 0
0 0 0 18 18 18 18 18 0 0 0 0 18 18 18 18 18 0 0 0
0 0 18 7 7 7 7 7 18 0 0 18 7 7 7 7 7 18 0 0
0 18 7 14 7 7 7 7 7 18 18 7 7 7 7 7 7 7 18 0
18 7 14 14 7 18 18 18 18 7 7 18 18 18 18 7 7 7 10 18
18 7 7 7 18 13 13 13 13 18 18 13 13 13 13 18 7 7 10 18
18 7 7 18 13 13 14 13 13 13 13 13 13 13 13 13 18 7 10 18
18 7 7 18 13 14 13 13 13 18 18 13 13 13 13 13 18 7 10 18
18 7 7 18 13 13 13 13 18 18 18 18 13 13 13 13 18 7 10 18
18 10 7 7 18 13 13 13 18 18 18 18 13 13 13 18 7 10 10 18
0 18 10 7 18 13 13 13 13 18 18 13 13 13 13 18 7 10 18 0
0 18 10 7 7 18 13 13 13 18 18 13 13 13 18 7 7 10 18 0
0 0 18 10 7 7 18 13 13 13 13 13 13 18 7 7 10 18 0 0
0 0 0 18 10 7 7 18 18 13 13 18 18 7 7 10 18 0 0 0
0 0 0 0 18 10 7 7 7 18 18 7 7 7 10 18 0 0 0 0
0 0 0 0 0 18 10 7 7 7 7 7 7 10 18 0 0 0 0 0
0 0 0 0 0 0 18 18 10 10 10 10 18 18 0 0 0 0 0 0
0 0 0 0 0 0 0 0 18 18 18 18 0 0 0 0 0 0 0 0
---
0 0 0 0 0 0 0 15 15 15 15 15 15 0 0 0 0 0 0 0
0 0 0 0 0 0 15 7 7 7 7 7 7 15 0 0 0 0 0 0
0 0 0 0 0 15 7 10 10 10 10 10 10 7 15 0 0 0 0 0
0 0 0 0 15 7 10 10 0 0 0 0 10 10 7 15 0 0 0 0
0 0 0 0 15 7 10 0 0 0 0 0 0 10 7 15 0 0 0 0
0 0 0 0 18 7 10 0 0 0 0 0 0 10 7 14 0 0 0 0
0 0 0 9 9 10 10 10 0 0 0 0 10 10 10 14 14 0 0 0
0 0 9 18 18 18 18 18 10 0 0 10 18 18 18 18 18 14 0 0
0 9 18 18 18 18 18 18 18 10 10 18 18 18 18 18 18 18 14 0
13 18 18 18 18 13 13 13 13 18 18 13 13 13 13 18 18 18 18 13
13 18 18 18 13 18 7 7 7 13 13 7 7 7 18 13 18 18 18 13
13 18 18 13 18 18 18 7 7 7 7 7 7 7 18 18 13 18 18 13
13 18 18 13 18 18 7 7 7 7 7 7 7 7 18 18 13 18 18 13
13 18 18 13 18 18 7 7 7 7 7 7 7 7 18 18 13 18 18 13
13 18 18 18 13 18 7 7 7 7 7 7 7 7 18 13 18 18 18 13
0 13 18 18 13 18 7 7 7 7 7 7 7 7 18 13 18 18 13 0
0 13 18 18 18 13 7 7 7 7 7 7 7 7 13 18 18 18 13 0
0 0 13 18 18 18 13 7 7 7 7 7 7 13 18 18 18 13 0 0
0 0 0 13 18 18 18 13 13 18 18 13 13 18 18 18 13 0 0 0
0 0 0 0 13 18 18 18 18 13 13 18 18 18 18 13 0 0 0 0
0 0 0 0 0 13 18 18 18 18 18 18 18 18 13 0 0 0 0 0
0 0 0 0 0 0 13 13 18 18 18 18 13 13 0 0 0 0 0 0
0 0 0 0 0 0 0 0 13 13 13 13 0 0 0 0 0 0 0 0
