0 0 0 0 0 0 0 0 0 0 11 11 0 0 0 0
0 0 11 11 11 0 0 0 0 11 14 11 0 0 0 0
0 0 11 14 14 11 11 0 11 14 14 11 0 0 0 0
0 0 11 14 14 14 14 11 14 10 14 11 0 0 0 0
0 0 0 11 14 10 14 7 7 10 14 14 11 11 0 0
0 0 0 0 11 14 10 7 12 7 7 7 14 14 11 0
0 0 11 11 14 7 7 12 12 12 10 10 14 14 14 11
0 11 14 14 7 10 10 7 12 7 14 14 11 11 11 0
11 14 14 14 14 7 7 10 7 10 7 11 0 0 0 0
11 11 11 11 14 14 10 7 7 7 10 14 11 0 0 0
0 0 0 0 11 14 14 14 11 14 7 14 11 0 0 0
0 0 0 0 11 14 11 11 0 11 14 14 11 0 0 0
0 0 0 0 11 11 11 0 17 0 11 11 11 0 0 0
0 0 0 0 0 0 0 0 5 0 0 0 0 0 0 0
0 0 5 5 5 0 0 5 5 0 17 5 5 5 5 0
0 0 0 17 5 5 0 5 17 17 17 17 17 5 0 0
0 0 0 0 17 17 17 17 17 17 17 17 0 0 0 0
0 0 0 0 0 0 17 17 0 0 0 0 0 0 0 0
0 0 0 0 0 17 17 0 0 0 0 0 0 0 0 0
0 0 0 0 0 17 0 0 0 0 0 0 0 0 0 0
---
0 0 0 0 0 0 0 0 0 0 7 7 0 0 0 0
0 0 7 7 7 0 0 0 0 7 5 7 0 0 0 0
0 0 7 11 11 7 7 0 7 5 5 7 0 0 0 0
0 0 7 11 11 11 11 7 5 11 5 7 0 0 0 0
0 0 0 7 11 11 11 11 11 11 5 5 7 10 0 0
0 0 0 0 7 11 11 11 11 11 11 11 5 5 10 0
0 0 17 7 11 11 11 11 11 11 11 11 5 5 5 10
0 17 11 11 11 11 11 11 11 11 5 5 10 10 10 0
17 17 17 17 17 11 11 11 11 11 11 10 0 0 0 0
17 17 17 17 17 17 11 11 11 11 11 12 10 0 0 0
0 0 0 0 17 17 17 17 14 12 11 12 10 0 0 0
0 0 0 0 17 17 14 14 0 14 12 12 10 0 0 0
0 0 0 0 17 17 14 0 14 0 14 10 10 0 0 0
0 0 0 0 0 0 0 0 14 0 0 0 0 0 0 0
0 0 14 14 14 0 0 14 14 0 14 14 14 14 14 0
0 0 0 14 14 14 0 14 14 14 14 14 14 14 0 0
0 0 0 0 14 14 14 14 14 14 14 14 0 0 0 0
0 0 0 0 0 0 14 14 0 0 0 0 0 0 0 0
0 0 0 0 0 14 14 0 0 0 0 0 0 0 0 0
0 0 0 0 0 14 0 0 0 0 0 0 0 0 0 0
