0 0 0 0 0 0 0 0 0 0 0 0 0 0 0 0 0 0 0 0 0 0 0 0 0 0 16 16 0 0
0 0 0 0 0 0 0 0 0 0 0 0 0 0 0 0 0 0 0 0 0 0 0 0 16 16 14 14 0 0
0 0 0 0 0 0 0 0 0 0 0 0 0 0 0 0 0 0 0 0 0 0 16 16 0 14 14 14 0 0
0 0 0 0 0 0 0 0 0 0 0 0 0 0 0 0 0 0 16 16 16 16 14 14 0 0 14 0 0 0
0 0 0 0 0 0 0 0 0 0 0 0 0 0 0 0 16 16 14 14 0 14 14 14 0 0 14 0 0 0
0 0 0 0 0 0 0 0 0 0 0 0 0 0 16 16 12 14 14 14 12 0 14 0 0 0 0 0 0 0
0 0 0 0 0 0 0 0 0 0 0 0 16 16 14 14 12 12 14 12 12 12 14 0 0 0 0 0 0 0
0 0 0 0 0 0 0 0 0 0 16 16 12 14 14 14 9 9 14 9 9 12 12 12 12 0 0 0 0 0
0 0 0 0 0 0 0 0 16 16 14 14 12 12 14 9 9 9 9 9 9 9 9 12 12 12 12 0 0 0
0 0 0 0 0 0 16 16 12 14 14 14 9 9 14 9 9 19 19 19 19 9 9 9 9 12 12 12 12 0
0 0 0 0 16 16 14 14 12 12 14 9 9 9 9 19 19 19 19 19 19 19 19 9 9 9 9 12 12 12
0 0 16 16 12 14 14 14 9 9 14 9 9 19 19 19 19 19 19 19 19 19 19 19 19 9 9 9 9 12
0 0 2 2 12 12 14 9 9 9 9 19 19 19 19 19 19 19 19 19 19 19 19 19 19 19 19 9 9 12
0 0 2 2 2 2 14 9 9 19 19 19 19 19 19 19 19 19 8 8 19 19 19 19 19 19 19 19 19 16
0 0 2 2 2 2 2 2 19 19 19 19 19 19 19 19 8 8 8 8 8 8 19 19 19 19 19 19 16 16
2 2 14 14 2 2 2 2 2 2 19 19 19 19 8 8 8 8 8 8 8 8 8 8 19 19 16 16 16 16
14 14 14 14 18 14 2 2 2 2 2 2 8 8 8 8 8 8 8 8 8 8 8 8 16 16 16 16 16 16
14 14 14 18 14 14 18 14 2 2 2 2 2 2 8 8 8 8 8 8 8 8 16 16 16 16 16 16 16 16
2 2 14 14 14 18 14 14 18 14 2 2 2 2 2 2 8 8 8 8 16 16 16 16 16 16 16 16 16 0
2 2 2 2 14 14 14 18 14 14 18 14 2 2 2 2 2 2 16 16 16 16 16 16 16 16 16 16 0 0
0 0 2 2 2 2 2 14 14 18 14 14 18 14 2 2 2 2 16 16 16 16 16 16 16 16 2 2 0 0
0 0 0 0 2 2 2 2 14 14 14 18 14 14 18 14 2 2 16 16 16 16 16 16 0 2 2 2 0 0
0 0 0 0 0 16 2 2 2 2 14 14 14 18 14 14 14 14 16 16 16 16 0 0 0 2 2 2 0 0
0 0 0 0 0 16 0 0 2 2 2 2 14 14 14 14 16 16 16 16 0 0 0 0 0 2 2 0 0 0
0 0 0 0 0 16 0 0 0 0 2 2 2 2 16 16 16 16 2 2 0 0 0 0 0 0 2 0 0 0
0 0 0 0 0 0 0 0 0 0 0 0 2 2 16 16 0 2 2 2 0 0 0 0 0 0 2 0 0 0
0 0 0 0 0 0 0 0 0 0 0 0 0 0 0 0 0 2 2 2 0 0 0 0 0 0 2 0 0 0
0 0 0 0 0 0 0 0 0 0 0 0 0 0 0 0 0 2 2 0 0 0 0 0 0 0 0 0 0 0
0 0 0 0 0 0 0 0 0 0 0 0 0 0 0 0 0 0 2 0 0 0 0 0 0 0 0 0 0 0
0 0 0 0 0 0 0 0 0 0 0 0 0 0 0 0 0 0 2 0 0 0 0 0 0 0 0 0 0 0
0 0 0 0 0 0 0 0 0 0 0 0 0 0 0 0 0 0 2 0 0 0 0 0 0 0 0 0 0 0
---
0 0 0 0 0 0 0 0 0 0 0 0 0 0 0 0 0 0 0 0 0 0 0 0 0 0 12 12 0 0
0 0 0 0 0 0 0 0 0 0 0 0 0 0 0 0 0 0 0 0 0 0 0 0 12 12 9 9 0 0
0 0 0 0 0 0 0 0 0 0 0 0 0 0 0 0 0 0 0 0 0 0 12 12 0 9 9 9 0 0
0 0 0 0 0 0 0 0 0 0 0 0 0 0 0 0 0 0 12 12 12 12 9 9 0 0 9 0 0 0
0 0 0 0 0 0 0 0 0 0 0 0 0 0 0 0 12 12 9 9 0 9 9 9 0 0 9 0 0 0
0 0 0 0 0 0 0 0 0 0 0 0 0 0 12 12 12 9 9 9 14 0 9 0 0 0 0 0 0 0
0 0 0 0 0 0 0 0 0 0 0 0 12 12 9 9 12 12 9 14 14 14 9 0 0 0 0 0 0 0
0 0 0 0 0 0 0 0 0 0 12 12 19 9 9 9 8 8 9 8 8 14 14 14 14 0 0 0 0 0
0 0 0 0 0 0 0 0 12 12 9 9 19 19 9 8 8 8 8 8 8 8 8 14 14 14 14 0 0 0
0 0 0 0 0 0 12 12 19 9 9 9 8 8 9 8 8 16 16 16 16 8 8 8 8 14 14 14 14 0
0 0 0 0 12 12 9 9 19 19 9 8 8 8 8 16 16 16 16 16 16 16 16 8 8 8 8 14 14 14
0 0 12 12 19 9 9 9 8 8 9 8 8 16 16 16 16 16 16 16 16 16 16 16 16 8 8 8 8 14
0 0 19 19 19 19 9 9 8 8 8 16 16 16 16 16 16 16 16 16 16 16 16 16 16 16 16 8 8 14
0 0 19 19 19 19 9 9 8 16 16 16 16 16 16 16 16 16 2 2 16 16 16 16 16 16 16 16 16 14
0 0 19 19 19 19 19 19 16 16 16 16 16 16 16 16 2 2 2 2 2 2 16 16 16 16 16 16 14 14
19 19 2 2 19 19 19 19 19 19 16 16 16 16 2 2 2 2 2 2 2 2 2 2 16 16 14 14 14 14
2 2 2 2 12 2 19 19 19 19 19 19 2 2 2 2 2 2 2 2 2 2 2 2 14 14 14 14 14 14
2 2 2 12 2 2 12 2 19 19 19 19 19 19 2 2 2 2 2 2 2 2 14 14 14 14 14 14 14 14
18 18 2 2 2 12 2 2 19 2 19 19 19 19 19 19 2 2 2 2 14 14 14 14 14 14 14 14 14 0
18 18 18 18 2 2 2 19 2 2 19 2 19 19 19 19 19 19 14 14 14 14 14 14 14 14 14 14 0 0
0 0 18 18 18 18 18 2 2 19 2 2 19 2 19 19 19 19 14 14 14 14 14 14 14 14 16 16 0 0
0 0 0 0 18 19 19 19 2 2 2 19 2 2 19 2 19 19 14 14 14 14 14 14 0 16 16 16 0 0
0 0 0 0 0 2 19 19 19 19 2 2 2 19 2 2 2 2 14 14 14 14 0 0 0 16 16 16 0 0
0 0 0 0 0 2 0 0 19 19 19 19 2 2 2 2 14 14 14 14 0 0 0 0 0 16 2 0 0 0
0 0 0 0 0 2 0 0 0 0 2 2 2 2 14 14 14 14 16 16 0 0 0 0 0 0 2 0 0 0
0 0 0 0 0 0 0 0 0 0 0 0 2 2 14 14 0 16 16 16 0 0 0 0 0 0 2 0 0 0
0 0 0 0 0 0 0 0 0 0 0 0 0 0 0 0 0 16 16 16 0 0 0 0 0 0 2 0 0 0
0 0 0 0 0 0 0 0 0 0 0 0 0 0 0 0 0 16 16 0 0 0 0 0 0 0 0 0 0 0
0 0 0 0 0 0 0 0 0 0 0 0 0 0 0 0 0 0 2 0 0 0 0 0 0 0 0 0 0 0
0 0 0 0 0 0 0 0 0 0 0 0 0 0 0 0 0 0 2 0 0 0 0 0 0 0 0 0 0 0
0 0 0 0 0 0 0 0 0 0 0 0 0 0 0 0 0 0 2 0 0 0 0 0 0 0 0 0 0 0
