0 0 0 0 0 0 0 0 0 15 15 10 10 10 10 10 10 10 16 0 0 0 0 0
0 0 0 0 0 0 0 0 15 15 15 15 10 10 10 10 10 10 10 15 15 0 0 0
0 0 0 16 16 16 16 16 10 15 15 12 10 10 15 15 10 10 15 15 15 15 0 0
0 0 16 10 10 10 10 10 10 10 12 10 10 15 15 15 15 10 10 15 15 0 0 0
0 0 0 16 16 16 16 10 10 10 10 10 10 10 15 15 12 10 10 10 12 16 0 0
0 0 0 0 0 0 0 16 16 13 13 13 13 10 10 12 10 10 10 10 10 10 16 16
0 0 0 4 0 0 0 0 16 14 14 14 14 13 13 13 13 13 12 12 12 10 10 10
0 0 4 15 4 0 0 0 16 14 14 14 14 14 14 14 14 14 16 12 12 12 12 16
0 0 0 4 0 0 0 16 9 9 14 14 16 16 16 14 14 14 16 16 16 16 16 4
0 0 0 0 0 0 16 9 9 9 9 14 14 14 7 7 7 14 16 4 4 4 4 4
0 4 0 0 0 16 9 9 9 9 9 9 14 14 7 7 14 14 16 4 4 4 4 0
0 0 0 0 0 16 16 16 16 9 9 14 14 14 14 14 14 14 16 4 4 0 0 0
0 0 0 0 0 0 0 0 16 16 14 14 14 14 14 14 14 14 16 4 4 0 0 0
0 0 4 0 0 0 4 0 0 16 14 14 14 14 14 14 14 14 16 4 4 0 0 0
0 0 4 0 0 0 0 0 0 16 14 14 14 14 14 14 14 14 16 4 4 0 0 0
4 4 15 4 4 0 0 0 0 16 14 14 14 14 14 14 14 14 16 4 4 0 0 0
0 0 4 0 0 0 0 0 0 16 14 14 14 14 14 14 14 14 16 4 4 4 0 0
0 0 4 0 0 0 0 0 16 16 14 14 14 14 14 14 14 14 9 16 16 4 4 0
0 0 0 0 0 0 0 16 15 9 14 14 14 14 14 9 9 9 15 9 16 4 4 4
0 0 0 0 0 0 0 16 15 15 9 9 9 9 9 9 15 15 15 9 14 16 16 4
0 0 0 0 0 0 16 16 15 15 15 15 15 15 15 15 15 15 9 14 14 14 14 16
0 4 0 0 0 0 16 14 9 15 15 15 15 15 15 15 9 9 14 14 14 14 14 14
0 0 0 0 0 16 14 14 9 15 15 15 15 15 9 9 14 14 14 14 14 14 14 14
0 0 0 0 0 16 14 14 14 9 15 15 15 9 14 14 14 14 14 14 14 14 14 14
---
0 0 0 0 0 0 0 0 0 14 14 14 14 14 14 14 14 14 14 0 0 0 0 0
0 0 0 0 0 0 0 0 14 14 14 14 14 14 14 14 14 14 14 14 14 0 0 0
0 0 0 15 15 15 15 15 14 14 14 14 14 14 14 14 14 14 14 14 14 14 0 0
0 0 15 14 14 14 14 14 14 14 14 14 14 14 14 14 14 14 14 14 14 0 0 0
0 0 0 15 15 15 15 14 14 14 14 14 14 14 14 14 14 14 14 14 14 14 0 0
0 0 0 0 0 0 0 15 15 14 14 14 14 14 14 14 14 14 14 14 14 14 14 14
0 0 0 12 0 0 0 0 15 4 4 4 4 14 14 14 14 14 14 14 14 14 14 14
0 0 12 12 12 0 0 0 15 4 4 4 12 12 12 12 12 12 15 14 14 14 14 15
0 0 0 12 0 0 0 15 10 10 4 4 7 7 7 7 7 4 15 15 15 15 15 16
0 0 0 0 0 0 15 10 10 10 10 4 4 4 10 10 10 4 15 16 16 16 16 16
0 12 0 0 0 15 10 10 10 10 10 10 4 4 10 10 4 4 15 16 16 16 16 0
0 0 0 0 0 15 15 15 15 10 10 4 4 4 4 4 4 4 15 16 16 0 0 0
0 0 0 0 0 0 0 0 15 15 4 4 4 4 4 4 4 4 15 16 16 0 0 0
0 0 13 0 0 0 4 0 0 15 4 4 4 4 4 4 4 4 15 16 16 0 0 0
0 0 13 0 0 0 0 0 0 15 9 9 9 9 9 9 9 4 15 16 16 0 0 0
13 13 13 13 13 0 0 0 0 15 9 9 9 9 9 9 9 9 15 16 16 0 0 0
0 0 13 0 0 0 0 0 0 15 9 9 9 9 9 9 9 9 15 16 16 16 0 0
0 0 13 0 0 0 0 0 15 15 9 9 9 9 9 9 9 9 14 15 15 16 16 0
0 0 0 0 0 0 0 15 10 14 9 9 9 9 9 14 14 14 10 14 15 16 16 16
0 0 0 0 0 0 0 15 10 10 14 14 14 14 14 14 10 10 10 14 16 15 15 16
0 0 0 0 0 0 15 15 10 10 10 10 10 10 10 10 10 10 14 16 16 16 16 15
0 4 0 0 0 0 15 16 15 10 10 10 10 10 10 10 14 14 16 16 16 16 16 16
0 0 0 0 0 15 16 16 14 10 10 10 10 10 14 14 16 16 16 16 16 16 16 16
0 0 0 0 0 15 16 16 16 14 10 10 10 14 16 16 16 16 16 16 16 16 16 16
