9 8 8 9 9 9 9 17 17 17 17 17 17 17 17 17 17 9 9 9 9 8 8 9
9 8 8 8 9 9 9 9 17 17 9 9 9 9 9 9 9 9 9 9 8 8 8 9
9 8 8 8 8 9 9 9 9 9 9 9 9 9 9 9 16 16 9 8 8 8 8 9
9 8 8 8 8 9 9 9 16 16 16 9 9 9 9 16 9 9 16 16 8 8 8 9
17 9 8 8 8 9 16 16 9 9 9 9 9 9 9 9 9 9 9 9 8 8 9 17
17 9 8 8 8 9 16 9 9 9 9 9 9 9 9 9 9 9 9 9 9 8 9 17
17 17 9 8 9 9 9 12 12 12 12 9 9 9 9 12 12 12 12 9 9 8 9 17
17 17 9 8 9 9 9 12 12 12 12 9 9 9 9 12 12 12 12 9 9 9 9 17
17 17 17 9 9 9 16 16 16 16 16 9 9 9 9 16 16 16 16 16 9 9 17 17
17 17 9 9 9 9 9 14 5 5 14 9 9 9 9 14 5 5 14 9 9 9 9 17
17 17 9 9 9 9 9 9 9 9 9 9 16 16 9 9 9 9 9 9 9 9 9 17
17 17 9 9 9 9 9 9 9 9 9 16 16 16 16 9 9 9 9 9 9 9 9 9
17 17 9 9 8 16 16 16 8 8 9 16 16 16 16 9 8 8 16 16 16 8 9 9
17 17 17 9 8 8 8 16 16 8 8 8 16 16 8 8 8 16 16 8 8 8 9 17
17 17 17 17 9 9 8 8 8 16 16 16 16 16 16 16 16 8 8 8 9 9 17 17
17 17 17 17 17 17 9 8 8 8 8 8 8 8 8 8 8 8 8 9 9 17 17 17
17 17 17 17 17 17 9 8 8 8 8 8 8 8 8 8 8 8 9 9 17 17 17 17
17 17 17 17 17 17 17 9 9 8 8 8 8 8 8 8 8 9 9 9 17 17 17 17
17 17 17 17 17 17 17 9 9 9 8 8 8 8 8 8 9 9 9 17 17 17 17 17
17 17 17 17 17 17 17 17 9 9 9 8 8 8 8 8 9 9 9 17 17 17 17 17
17 17 17 17 17 17 17 17 6 6 9 8 8 8 8 8 9 6 17 17 17 17 17 17
17 17 17 17 17 17 17 17 6 6 4 8 8 8 8 4 6 6 17 17 17 17 17 17
17 17 17 17 17 17 17 17 6 6 6 4 4 4 4 6 6 6 17 17 17 17 17 17
17 17 17 17 17 17 17 6 6 6 6 4 4 4 4 6 6 6 6 17 17 17 17 17
---
8 16 16 8 8 8 8 6 6 6 6 6 6 6 6 6 6 17 17 17 17 16 16 17
8 16 16 16 8 8 8 8 6 6 17 17 17 17 17 17 17 17 17 17 16 16 16 17
8 16 16 16 16 8 8 8 8 8 17 17 17 17 17 17 9 9 17 16 16 16 16 17
8 16 16 16 16 8 8 8 12 12 12 17 17 17 17 9 17 17 9 9 16 16 16 17
9 8 16 16 16 8 12 12 8 8 17 17 17 17 17 17 17 17 17 17 16 16 17 4
9 8 16 16 16 8 12 8 8 8 8 17 17 17 17 17 17 17 17 17 17 16 17 4
9 9 8 16 8 8 8 6 6 6 6 17 17 17 17 8 8 8 8 17 17 16 17 4
9 9 8 16 8 8 8 6 6 6 6 17 17 17 17 8 8 8 8 17 17 17 17 4
9 9 9 8 8 8 6 14 14 14 14 17 17 17 17 4 4 9 9 9 17 17 4 4
9 9 8 8 8 8 8 5 16 16 5 17 17 17 17 5 16 16 5 17 17 17 17 4
9 9 17 17 17 17 17 17 17 17 17 17 9 9 17 17 17 17 17 17 17 17 17 4
9 9 17 17 17 17 17 17 17 17 17 9 9 9 9 17 17 17 17 17 17 17 17 17
9 9 17 17 9 9 9 9 9 9 17 9 9 9 9 17 9 9 9 9 9 9 17 17
9 9 9 17 9 9 9 9 9 9 9 9 9 9 9 9 9 9 9 9 9 9 17 8
9 9 9 9 17 17 9 9 9 9 9 9 9 9 9 9 9 9 9 9 17 17 8 8
9 9 9 9 9 9 17 9 9 9 9 9 9 9 9 9 9 9 9 17 17 8 8 8
9 9 9 9 9 9 17 9 9 9 9 9 9 9 9 9 9 9 17 17 8 8 8 8
9 9 9 9 9 9 9 17 17 9 9 9 9 9 9 9 9 17 17 17 8 8 8 8
9 9 9 9 9 9 9 17 17 17 9 9 9 9 9 9 17 17 17 8 8 8 8 8
9 9 9 9 9 9 9 9 17 17 17 9 9 9 9 9 17 17 17 8 8 8 8 8
9 9 9 9 9 9 9 9 8 8 17 9 9 9 9 9 17 16 8 8 8 8 8 8
9 9 9 9 9 9 9 9 8 8 12 9 9 9 9 12 16 16 8 8 8 8 8 8
9 9 9 9 9 9 9 9 8 8 8 12 12 12 12 16 16 16 8 8 8 8 8 8
9 9 9 9 9 9 9 8 8 8 8 12 12 12 12 16 16 16 16 8 8 8 8 8
