0 0 0 0 0 0 0 0 0 1 1 1 1 1 1 1 0 0 0 0 0 0 0 0 0
0 0 0 0 0 0 0 1 1 14 14 14 1 1 1 1 1 1 0 0 0 0 0 0 0
0 0 0 0 0 1 1 14 14 1 1 1 1 1 1 1 1 1 1 1 0 0 0 0 0
0 0 0 0 1 14 14 14 1 1 1 1 1 1 1 1 1 1 1 1 1 0 0 0 0
0 0 0 1 14 14 14 1 1 15 1 1 1 1 9 9 1 1 1 1 1 1 0 0 0
0 0 1 14 14 1 1 1 1 15 1 1 1 9 15 15 9 9 1 1 1 1 1 0 0
0 0 1 14 14 1 1 1 15 14 15 1 1 1 9 15 15 15 9 1 1 1 1 0 0
0 1 14 14 1 1 15 15 14 15 14 15 15 1 1 9 15 15 15 9 1 1 1 1 0
0 1 14 14 1 1 1 1 15 14 15 1 1 1 1 9 15 15 15 14 9 1 1 1 0
1 14 14 1 1 1 1 1 1 15 1 1 1 1 1 1 9 15 15 14 9 1 1 1 1
1 14 14 1 1 1 1 1 1 15 1 1 1 1 1 1 9 15 15 15 14 9 1 1 1
1 14 14 1 1 1 1 1 1 1 1 1 1 1 1 1 9 15 15 15 14 9 1 1 1
1 14 14 1 1 1 9 1 1 1 1 1 1 1 1 1 9 15 15 15 14 9 1 1 1
1 14 14 1 1 1 9 1 1 1 1 1 1 1 1 9 15 15 15 15 14 9 1 1 1
1 14 14 1 1 9 15 9 1 1 1 1 1 1 1 9 15 15 15 15 14 9 1 1 1
0 1 14 9 9 15 14 15 9 9 1 1 1 1 9 15 15 15 15 14 9 1 1 1 0
0 1 14 14 1 9 15 9 1 1 1 1 1 9 15 15 15 15 15 14 9 1 1 1 0
0 0 1 14 1 1 9 1 1 1 1 1 9 15 15 15 15 15 14 9 1 1 1 0 0
0 0 1 14 14 1 9 1 1 1 9 9 15 15 15 15 15 14 9 1 1 1 1 0 0
0 0 0 1 14 14 1 1 9 9 15 15 15 15 15 15 9 9 1 1 1 1 0 0 0
0 0 0 0 4 14 14 1 1 1 9 9 9 9 9 9 1 1 1 1 4 0 0 0 0
0 0 0 16 14 4 4 14 1 1 1 1 1 1 1 1 1 1 4 4 6 16 0 0 0
0 0 0 16 6 5 5 4 4 1 1 1 1 1 1 1 4 4 5 5 6 16 0 0 0
0 0 0 16 6 6 12 7 7 4 4 4 4 4 4 4 7 7 12 6 6 16 0 0 0
0 0 0 16 6 14 12 7 7 12 9 9 9 9 9 12 7 7 12 14 6 16 0 0 0
0 0 16 15 12 6 12 7 14 12 15 15 13 15 15 12 14 7 12 6 12 15 16 0 0
0 0 16 9 15 12 12 7 7 12 15 13 14 13 15 12 7 7 12 12 15 9 16 0 0
0 0 0 16 9 15 15 12 12 12 15 15 13 15 15 12 12 12 15 15 9 16 0 0 0
0 0 0 0 16 16 9 15 15 15 12 12 12 12 12 15 15 15 9 16 16 0 0 0 0
0 0 0 0 0 0 16 16 9 9 9 9 9 9 9 9 9 16 16 0 0 0 0 0 0
0 0 0 0 0 0 0 0 16 16 16 16 16 16 16 16 16 0 0 0 0 0 0 0 0
---
0 0 0 0 0 0 0 0 0 9 9 9 9 9 9 9 0 0 0 0 0 0 0 0 0
0 0 0 0 0 0 0 9 9 9 9 9 9 9 9 14 14 14 0 0 0 0 0 0 0
0 0 0 0 0 9 9 9 9 14 14 14 14 14 14 14 14 15 15 15 0 0 0 0 0
0 0 0 0 9 9 9 9 14 14 14 14 14 14 14 15 15 15 15 15 15 0 0 0 0
0 0 0 9 9 9 9 14 14 1 14 14 14 14 1 1 15 15 15 15 15 15 0 0 0
0 0 9 9 9 14 14 14 14 1 14 14 14 1 1 1 1 1 15 15 15 15 15 0 0
0 0 9 9 9 14 14 14 1 1 1 14 14 14 1 1 1 1 1 15 15 15 15 0 0
0 9 9 9 14 14 1 1 1 1 1 1 1 14 14 1 1 1 1 1 15 15 15 15 0
0 9 9 9 14 14 14 14 1 1 1 14 14 14 14 1 1 1 1 1 1 15 15 15 0
9 9 9 14 14 14 14 14 14 1 14 14 14 14 14 14 1 1 1 1 1 15 15 15 15
9 9 9 14 14 14 12 4 4 1 4 4 4 4 4 4 1 1 1 1 1 1 15 15 15
9 9 9 12 12 12 12 4 4 4 4 4 4 4 4 16 1 1 1 1 1 1 15 15 15
9 9 9 12 12 12 1 16 16 16 16 16 16 16 16 16 1 1 1 1 1 1 15 15 15
9 9 9 12 12 12 1 16 16 16 16 7 7 7 7 1 1 1 1 1 1 1 15 15 15
9 9 9 12 12 1 1 1 7 7 7 7 7 7 7 1 1 1 1 1 1 1 15 15 15
0 9 9 1 1 1 1 1 1 1 13 7 7 7 1 1 1 1 1 1 1 15 15 15 0
0 9 9 9 15 1 1 1 6 6 13 13 13 1 1 1 1 1 1 1 1 15 15 15 0
0 0 9 9 15 15 1 6 6 6 6 6 1 1 1 1 1 1 1 1 15 15 15 0 0
0 0 9 9 9 15 1 6 6 6 1 1 1 1 1 1 1 1 1 15 15 15 15 0 0
0 0 0 9 9 9 15 6 1 1 1 1 1 1 1 1 1 1 15 15 15 15 0 0 0
0 0 0 0 1 9 9 15 15 15 1 1 1 1 1 1 15 15 15 15 1 0 0 0 0
0 0 0 1 9 1 1 9 15 15 15 15 15 15 15 15 15 15 1 1 16 1 0 0 0
0 0 0 1 16 16 16 1 1 15 15 15 15 15 15 15 1 1 16 16 16 1 0 0 0
0 0 0 1 16 16 1 12 12 1 1 1 1 1 1 1 12 12 1 16 16 1 0 0 0
0 0 0 1 16 16 1 12 12 1 1 1 1 1 1 1 12 12 1 16 16 1 0 0 0
0 0 1 1 1 16 1 12 12 1 1 1 1 1 1 1 12 12 1 16 1 1 1 0 0
0 0 1 5 1 1 1 12 12 1 1 1 4 1 1 1 12 12 1 1 1 5 1 0 0
0 0 0 1 5 1 1 1 1 1 1 1 1 1 1 1 1 1 1 1 5 1 0 0 0
0 0 0 0 1 1 1 1 1 1 1 1 1 1 1 1 1 1 1 1 1 0 0 0 0
0 0 0 0 0 0 1 1 1 1 1 1 1 1 1 1 1 1 1 0 0 0 0 0 0
0 0 0 0 0 0 0 0 1 1 1 1 1 1 1 1 1 0 0 0 0 0 0 0 0
