0 0 0 18 18 18 18 18 0 0 0
0 0 18 13 13 13 13 13 18 0 0
0 18 18 13 13 13 13 13 18 18 0
0 18 14 18 13 13 13 18 14 18 0
0 18 14 14 18 13 18 14 14 18 0
0 18 14 14 18 13 18 14 14 18 0
0 0 18 18 13 13 13 18 18 0 0
0 18 13 18 18 18 18 18 13 18 0
18 13 1 13 13 18 13 13 1 13 18
18 13 18 13 18 15 18 13 18 13 18
0 18 18 1 1 1 1 1 18 18 0
0 0 18 13 13 18 13 13 18 0 0
0 0 0 18 18 0 18 18 0 0 0
---
0 0 0 13 13 13 13 13 0 0 0
0 0 14 18 18 18 18 18 13 0 0
0 14 14 18 18 18 18 18 13 13 0
0 14 18 14 18 18 18 13 18 13 0
0 14 18 18 14 18 13 18 18 13 0
0 14 18 18 14 18 13 18 18 13 0
0 0 14 18 18 18 18 13 13 0 0
0 15 18 13 13 13 13 13 18 13 0
18 18 18 18 18 13 18 18 18 18 13
1 18 1 18 13 18 13 18 13 18 13
0 1 1 18 18 18 18 18 13 13 0
0 0 1 18 18 13 18 18 13 0 0
0 0 0 1 1 0 13 13 0 0 0
