0 0 0 0 0 0 0 18 18 18 18 18 18 18 18 0 0 0 0 0 0 0
0 0 0 0 0 18 18 9 9 9 9 9 9 9 9 18 18 0 0 0 0 0
0 0 0 0 18 14 9 2 2 2 2 2 2 2 2 9 14 18 0 0 0 0
0 0 18 18 14 9 2 14 2 14 2 14 2 14 2 2 2 14 18 18 0 0
0 18 9 14 14 18 18 14 1 14 1 14 1 14 18 18 18 14 14 9 18 0
18 9 2 18 18 2 2 14 2 14 2 14 2 14 2 2 2 18 18 2 9 18
18 18 18 14 14 2 2 2 2 2 2 2 2 2 2 2 2 14 14 18 18 18
18 2 2 14 14 2 2 2 2 2 2 2 2 2 2 2 16 19 19 16 2 18
0 18 2 14 14 2 2 2 2 2 2 2 2 2 16 16 16 19 14 18 18 0
0 0 18 18 19 2 16 2 2 2 2 2 16 16 16 16 16 14 18 18 0 0
0 0 0 0 18 14 2 16 16 16 16 16 16 16 16 2 14 18 0 0 0 0
0 0 0 0 0 18 18 2 2 2 2 2 2 2 2 18 18 0 0 0 0 0
0 0 0 0 0 0 0 18 18 18 18 18 18 18 18 0 0 0 0 0 0 0
---
0 0 0 0 0 0 0 2 2 2 2 2 2 2 2 0 0 0 0 0 0 0
0 0 0 0 0 2 2 14 14 14 14 14 14 14 14 2 2 0 0 0 0 0
0 0 0 0 2 19 14 9 9 9 9 9 9 9 9 14 18 2 0 0 0 0
0 0 2 2 19 14 9 16 9 16 9 16 9 16 9 9 9 18 2 2 0 0
0 2 2 19 19 2 2 16 2 16 2 16 2 16 2 2 2 18 18 2 2 0
2 2 16 2 2 18 18 16 18 16 18 16 18 16 18 18 18 2 2 2 2 2
2 2 2 16 16 18 18 18 18 18 18 18 18 18 18 18 18 2 2 2 2 2
2 14 14 16 16 18 18 18 18 18 18 18 18 18 18 18 14 2 2 2 2 2
0 2 14 16 16 18 18 18 18 18 18 18 18 18 14 14 14 2 1 2 2 0
0 0 2 2 2 18 14 18 18 18 18 18 14 14 14 14 14 1 2 2 0 0
0 0 0 0 2 2 18 14 14 14 14 14 14 14 14 18 1 2 0 0 0 0
0 0 0 0 0 2 2 18 18 18 18 18 18 18 18 2 2 0 0 0 0 0
0 0 0 0 0 0 0 2 2 2 2 2 2 2 2 0 0 0 0 0 0 0
