5 5 5 5 2 2 5 5 5 5 5 5 5 5 5 5 5 5 2 2 5 5 5 5
5 5 5 2 2 2 2 5 5 5 5 5 5 5 5 5 5 2 2 2 2 5 5 5
5 5 5 2 2 2 2 2 5 5 5 5 5 5 5 5 2 2 2 2 2 5 5 5
5 5 2 2 2 7 2 2 5 5 5 5 5 5 5 5 2 2 7 2 2 2 5 5
5 5 2 2 7 7 7 2 2 5 5 5 5 5 5 2 2 7 7 7 2 2 5 5
5 5 2 2 7 7 7 7 2 2 2 14 14 2 2 2 7 7 7 7 2 2 5 5
5 2 2 7 7 7 7 7 2 2 2 14 14 2 2 2 7 7 7 7 7 2 2 5
5 2 2 7 7 7 7 7 2 2 2 14 14 2 2 2 7 7 7 7 7 2 2 5
5 2 2 7 7 7 7 2 2 2 2 14 14 2 2 2 2 7 7 7 7 2 2 5
2 2 2 7 7 2 2 2 2 2 2 14 14 2 2 2 2 2 2 7 7 2 2 2
2 2 2 7 2 2 2 2 2 2 14 14 14 14 2 2 2 2 2 2 7 2 2 2
2 2 2 2 2 2 2 2 2 14 14 14 14 14 14 2 2 2 2 2 2 2 2 2
2 2 2 2 2 16 16 16 2 14 14 14 14 14 14 2 16 16 16 2 2 2 2 2
2 2 2 2 2 2 2 2 2 14 16 16 16 16 14 2 2 2 2 2 2 2 2 2
2 2 2 2 2 2 2 2 14 16 16 16 16 16 16 14 2 2 2 2 2 2 2 2
2 2 2 2 2 2 2 14 14 16 16 16 16 16 16 14 14 2 2 2 2 2 2 2
2 2 2 2 2 14 14 14 14 16 16 16 16 16 16 14 14 14 14 2 2 2 2 2
2 2 2 14 14 14 14 14 14 14 16 16 16 16 14 14 14 14 14 14 14 2 2 2
2 2 14 14 14 14 14 14 14 14 14 14 14 14 14 14 14 14 14 14 14 14 2 2
2 14 14 14 14 14 16 14 14 14 16 16 16 16 14 14 14 16 14 14 14 14 14 2
14 14 14 14 14 14 14 16 16 16 16 10 10 16 16 16 16 14 14 14 14 14 14 14
14 14 14 14 14 14 14 14 16 16 10 10 10 10 16 16 14 14 14 14 14 14 14 14
14 14 14 14 14 14 14 14 14 14 10 10 10 10 14 14 14 14 14 14 14 14 14 14
14 14 14 14 14 14 14 14 14 14 14 10 10 14 14 14 14 14 14 14 14 14 14 14
---
5 5 5 5 14 14 5 2 2 2 2 2 2 2 2 2 2 5 14 14 5 5 5 5
5 5 5 14 14 14 14 2 2 2 2 2 2 2 2 2 2 14 14 14 14 5 5 5
5 5 5 14 14 14 14 14 2 2 2 2 2 2 2 2 14 14 14 14 14 5 5 5
5 5 14 14 14 16 14 14 2 2 2 2 2 2 2 2 14 14 16 14 14 14 5 5
5 5 14 14 16 16 16 14 14 2 2 2 2 2 2 14 14 16 16 16 14 14 5 5
5 5 14 14 16 16 16 16 14 14 14 2 2 14 14 14 16 16 16 16 14 14 5 5
5 14 14 16 16 16 16 16 14 14 14 2 2 14 14 14 16 16 16 16 16 14 14 5
5 14 14 16 16 16 16 16 14 14 14 2 2 14 14 14 16 16 16 16 16 14 14 5
5 14 14 16 16 16 16 14 14 14 14 2 2 14 14 14 14 16 16 16 16 14 14 5
14 14 14 16 16 14 14 14 14 14 14 2 2 14 14 14 14 14 14 16 16 14 14 14
14 14 14 16 14 14 14 14 14 14 2 2 2 2 14 14 14 14 14 14 16 14 14 14
14 14 14 14 14 14 14 14 14 2 2 2 2 2 2 14 14 14 14 14 14 14 14 14
14 14 14 14 14 7 7 7 14 2 2 2 2 2 2 14 7 7 7 14 14 14 14 14
5 14 14 14 14 14 14 14 14 2 7 7 7 7 2 14 14 14 14 14 14 14 14 10
5 5 5 5 5 5 5 5 2 7 7 7 7 7 7 2 10 10 10 10 10 10 10 10
5 5 5 5 5 5 5 2 2 7 7 7 7 7 7 2 2 10 10 10 5 5 5 5
5 5 5 5 5 2 2 2 2 7 7 7 7 7 7 2 2 2 2 5 5 5 5 5
5 5 5 2 2 2 2 2 2 2 7 7 7 7 2 2 2 2 2 2 2 5 5 5
5 5 2 2 2 2 2 2 2 2 2 2 2 2 2 2 2 2 2 2 2 2 5 5
5 2 2 2 2 2 7 2 2 2 7 7 7 7 2 2 2 7 2 2 2 2 2 5
2 2 2 2 2 2 2 7 7 7 7 2 2 7 7 7 7 2 2 2 2 2 2 2
2 2 2 2 2 2 2 2 7 7 2 2 2 2 7 7 2 2 2 2 2 2 2 2
2 2 2 2 2 2 2 2 2 2 2 2 2 2 2 2 2 2 2 2 2 2 2 2
2 2 2 2 2 2 2 2 2 2 2 2 2 2 2 2 2 2 2 2 2 2 2 2
