0 0 0 16 16 16 0 0 0 0 0 0 0 0 0 0 0
0 0 16 6 6 6 16 0 0 0 16 16 16 0 0 0 0
0 0 16 6 6 6 6 16 0 16 9 9 16 0 0 0 0
0 0 16 6 6 6 6 16 16 9 9 9 16 0 0 0 0
0 0 0 16 16 6 6 16 9 9 16 16 0 0 0 0 0
0 0 16 16 16 16 16 16 9 16 16 16 16 16 0 0 0
0 16 13 13 13 13 16 16 9 16 10 10 10 10 16 0 0
16 13 13 13 13 13 16 9 9 16 13 13 10 14 10 16 0
16 19 19 19 19 13 13 16 16 13 13 10 14 14 13 10 16
16 16 19 19 19 19 13 13 13 13 13 10 10 10 13 10 16
0 0 16 19 19 19 19 13 13 13 13 13 13 13 13 10 16
0 0 16 8 8 19 19 13 13 13 13 13 13 13 13 10 16
0 0 16 8 8 8 19 13 13 13 13 13 13 13 13 10 16
0 0 16 8 8 8 19 13 13 13 13 13 13 13 13 10 16
0 16 8 8 8 8 13 13 13 13 13 13 13 13 13 10 16
16 8 8 8 8 8 13 13 13 13 13 13 13 13 10 16 0
16 8 8 8 8 13 13 13 13 13 13 13 13 10 10 16 0
0 16 13 13 13 13 13 10 10 13 13 10 10 10 16 0 0
0 0 16 13 13 10 10 16 16 10 10 10 10 16 0 0 0
0 0 0 16 16 16 16 0 0 16 16 16 16 0 0 0 0
---
0 0 0 13 13 13 0 0 0 0 0 0 0 0 0 0 0
0 0 13 16 16 16 13 0 0 0 13 13 13 0 0 0 0
0 0 13 16 16 16 16 13 0 13 13 13 13 0 0 0 0
0 0 13 16 16 16 16 13 13 13 13 13 13 0 0 0 0
0 0 0 13 13 16 16 13 13 13 13 13 0 0 0 0 0
0 0 13 13 13 13 13 13 13 13 13 13 13 13 0 0 0
0 13 16 16 16 16 13 13 13 13 16 16 16 16 13 0 0
13 16 16 16 16 16 13 13 13 13 19 13 16 10 16 13 0
13 10 10 10 10 16 16 13 13 19 19 16 10 10 19 16 13
13 13 10 10 10 10 14 14 14 19 19 16 16 16 19 16 13
0 0 13 10 10 10 10 9 9 19 19 19 19 19 19 16 13
0 0 13 16 16 10 10 9 9 9 9 9 19 19 19 16 13
0 0 13 16 16 16 10 9 9 9 9 10 10 10 10 16 13
0 0 13 16 16 16 10 10 10 10 10 10 10 10 10 16 13
0 13 16 16 16 16 6 6 6 6 6 6 6 6 6 16 13
13 16 16 16 16 16 8 8 8 8 6 6 6 6 16 13 0
13 16 16 16 16 8 8 8 8 8 8 8 8 16 16 13 0
0 13 8 8 8 8 8 16 16 8 8 16 16 16 13 0 0
0 0 13 8 8 16 16 13 13 16 16 16 16 13 0 0 0
0 0 0 13 13 13 13 0 0 13 13 13 13 0 0 0 0
