0 0 0 0 0 16 16 16 0 0 0 0 0
0 0 0 16 16 9 15 15 16 16 0 0 0
0 0 16 9 15 9 9 15 15 15 16 0 0
0 16 9 9 9 9 9 9 9 9 16 0 0
0 16 9 9 9 14 14 9 9 14 14 16 0
16 2 9 9 9 14 16 14 9 16 14 16 0
16 2 9 2 9 14 14 14 9 14 14 2 16
16 2 9 2 9 9 9 16 16 16 9 2 16
16 2 9 2 9 9 9 9 9 9 9 2 16
16 2 2 2 9 9 9 9 9 9 9 2 16
0 16 2 2 2 9 9 9 2 9 2 16 0
0 0 16 2 2 2 2 2 2 2 16 0 0
0 0 0 16 16 16 16 16 16 16 0 0 0
---
0 0 0 0 0 2 2 2 0 0 0 0 0
0 0 0 2 2 2 9 9 2 2 0 0 0
0 0 2 16 2 2 2 9 9 9 2 0 0
0 2 15 16 16 16 16 16 16 16 2 0 0
0 2 15 16 16 9 9 16 16 9 9 2 0
2 9 15 16 16 9 9 9 16 9 9 2 0
2 9 15 9 16 9 9 9 16 9 9 9 2
2 9 15 9 16 16 16 9 9 9 16 9 2
2 9 15 9 16 16 16 16 16 16 16 9 2
2 9 9 9 16 16 16 16 16 16 16 9 14
0 14 9 9 9 16 16 16 9 16 9 14 0
0 0 14 9 9 9 9 9 9 9 14 0 0
0 0 0 14 14 14 14 14 14 14 0 0 0
