0 0 0 0 1 1 1 1 0 0 0 0
0 0 0 1 1 1 1 1 1 0 0 0
0 0 1 1 14 1 1 14 1 1 0 0
0 0 1 14 16 14 14 16 14 1 0 0
0 0 1 14 14 9 9 14 14 1 0 0
0 0 13 13 14 14 14 14 13 13 0 0
0 1 1 13 13 13 13 13 13 13 1 0
1 1 1 14 14 14 14 13 13 1 1 1
1 1 4 14 14 14 14 13 14 4 1 1
0 0 4 1 14 14 14 14 1 4 0 0
0 0 0 4 1 1 1 1 4 0 0 0
0 0 9 9 9 0 0 9 9 9 0 0
---
0 0 0 0 14 14 14 14 0 0 0 0
0 0 0 14 14 1 14 14 14 0 0 0
0 0 14 14 13 14 14 13 14 14 0 0
0 0 14 13 16 13 13 16 13 14 0 0
0 0 14 13 13 1 1 13 13 14 0 0
0 0 1 1 13 13 13 13 1 1 0 0
0 9 9 1 1 1 1 1 1 1 14 0
9 9 9 1 1 1 1 1 1 14 14 14
9 9 1 1 1 1 1 1 1 14 14 14
0 0 1 4 1 1 1 1 4 14 0 0
0 0 0 1 4 4 4 4 9 0 0 0
0 0 1 1 1 0 0 1 1 1 0 0
