0 0 18 18 18 18 0 0 0 0 0 0 0 0 18 18 18 18 0 0
0 18 10 10 10 10 18 0 0 0 0 0 0 18 10 19 19 19 18 0
18 10 10 10 10 10 18 0 0 0 0 0 0 18 19 19 19 19 1 18
18 10 10 10 10 10 10 18 0 0 0 0 18 19 19 19 19 1 1 18
18 10 10 10 10 10 19 18 0 0 0 0 18 19 19 1 1 1 1 18
0 18 10 10 19 19 19 18 0 0 0 0 18 1 1 1 1 1 18 0
0 18 19 19 19 19 19 19 18 18 18 18 1 1 1 1 1 1 18 0
0 18 19 19 19 19 19 19 1 1 1 1 1 1 1 1 6 6 18 0
0 0 18 19 19 19 1 1 1 1 1 1 1 1 6 6 6 18 0 0
0 18 19 19 1 1 1 1 1 1 1 1 6 6 6 6 6 6 18 0
18 18 1 1 1 1 1 18 1 1 6 6 18 6 6 6 6 6 18 18
18 1 1 1 1 1 1 18 6 6 6 6 18 6 6 6 6 6 6 18
18 1 1 1 1 1 6 18 6 6 6 6 18 6 6 6 15 15 15 18
18 1 1 1 6 6 6 6 6 6 6 6 6 15 15 15 15 15 15 18
18 1 6 6 6 6 6 6 6 6 6 15 15 15 15 15 15 15 15 18
18 6 6 6 6 6 6 6 6 15 15 15 15 15 15 15 15 15 15 18
0 18 6 6 6 6 6 15 15 15 15 15 15 15 10 10 10 10 18 0
0 0 18 18 18 15 15 15 15 15 15 15 10 10 10 18 18 18 0 0
0 0 0 0 18 15 15 15 15 10 10 10 10 10 10 18 0 0 0 0
0 0 0 18 18 15 15 10 10 10 10 10 10 10 10 18 18 0 0 0
0 0 0 18 10 10 10 10 10 10 10 10 3 3 3 3 18 0 0 0
0 0 0 18 18 10 10 10 10 10 3 3 3 3 3 18 18 0 0 0
0 0 0 0 18 18 18 3 3 3 3 3 3 18 18 18 0 0 0 0
0 0 0 0 0 0 18 18 18 18 18 18 18 18 0 0 0 0 0 0
---
0 0 10 10 10 10 0 0 0 0 0 0 0 0 10 10 10 10 0 0
0 10 1 1 1 1 10 0 0 0 0 0 0 10 1 18 18 18 15 0
10 1 1 1 1 1 10 0 0 0 0 0 0 10 18 18 18 18 6 15
10 1 1 1 1 1 1 10 0 0 0 0 10 18 18 18 18 6 6 15
10 1 1 1 1 1 1 10 0 0 0 0 10 18 18 6 6 6 6 15
0 10 1 1 1 1 1 10 0 0 0 0 10 6 6 6 6 6 15 0
0 10 1 1 1 1 1 1 10 10 10 10 6 6 6 6 6 6 15 0
0 10 1 1 1 1 1 1 6 6 6 6 6 6 6 6 15 15 15 0
0 0 10 1 1 1 6 6 6 6 6 6 6 6 15 15 15 15 0 0
0 10 1 1 6 6 6 6 6 6 6 6 15 15 15 15 15 15 15 0
10 10 6 6 6 6 6 1 6 6 15 15 6 15 15 15 15 15 15 15
19 6 6 6 6 6 6 1 1 1 3 3 6 15 15 15 15 15 15 15
19 6 6 6 6 6 19 1 3 3 3 3 6 15 15 15 18 18 18 15
19 6 6 6 19 19 19 19 3 3 3 3 3 18 18 18 18 18 18 15
19 6 19 19 19 19 19 19 3 3 3 18 18 18 18 18 18 18 18 15
19 19 19 19 19 19 19 19 3 18 18 18 18 18 18 18 18 18 18 15
0 19 19 19 19 19 19 18 18 18 18 18 18 18 18 18 18 18 15 0
0 0 19 19 19 18 18 18 18 18 18 18 18 18 18 15 15 15 0 0
0 0 0 0 19 18 18 18 18 18 18 18 18 18 18 10 0 0 0 0
0 0 0 10 19 18 18 18 18 18 18 18 18 18 18 10 10 0 0 0
0 0 0 10 18 18 18 18 18 18 18 18 1 1 1 1 10 0 0 0
0 0 0 10 10 18 18 18 18 18 1 1 1 1 1 10 10 0 0 0
0 0 0 0 10 10 10 1 1 1 1 1 1 10 10 10 0 0 0 0
0 0 0 0 0 0 10 10 10 10 10 10 10 10 0 0 0 0 0 0
