1 1 1 1 1 1 1 1 1 1 1 1 1 1 1 1 1 1 1 18 18 3 3 3 3 3 3 3 3 3 3 3 3 3 3 3 3 3 3 3
1 1 1 1 1 14 1 1 1 1 1 1 1 1 14 1 1 1 1 18 18 3 3 3 3 3 3 3 7 7 7 7 3 3 3 3 3 3 3 3
1 1 1 1 14 1 14 1 1 1 2 14 1 1 1 1 1 14 1 18 18 3 3 3 3 3 10 7 7 7 7 7 7 10 3 3 3 3 3 3
1 1 1 1 1 14 1 1 1 1 2 14 14 1 1 2 14 16 1 18 18 7 7 10 3 10 7 7 7 7 7 7 7 7 10 3 3 3 3 3
1 1 1 1 1 1 1 1 1 1 1 2 14 14 1 2 16 1 1 18 18 7 7 7 10 7 7 7 7 7 7 7 7 7 10 10 3 3 3 3
1 1 1 1 1 1 1 1 1 2 2 2 16 14 14 2 16 1 1 18 18 7 2 7 7 7 7 7 7 7 7 7 7 7 7 7 7 3 3 3
1 1 1 1 1 1 1 1 1 2 16 16 1 2 14 2 2 1 1 18 18 7 2 7 7 10 7 7 7 7 10 10 7 7 7 7 7 7 3 3
1 14 1 1 2 14 1 1 16 16 1 1 1 16 16 2 2 14 1 18 18 7 2 7 10 10 7 7 10 10 7 7 2 7 7 7 7 7 3 3
1 1 1 1 2 2 1 1 1 1 14 14 1 1 1 16 16 2 14 18 18 2 7 7 7 7 2 2 7 7 7 7 2 7 7 7 7 7 3 3
14 2 1 1 14 2 1 1 1 14 2 2 14 1 1 1 1 16 2 18 18 2 7 7 7 16 16 2 7 7 7 2 16 7 7 7 7 7 10 3
16 16 2 14 2 2 1 1 1 16 16 16 2 14 14 1 1 16 2 18 18 16 7 2 7 7 16 2 2 7 2 2 16 7 7 7 7 7 10 3
1 16 2 14 2 1 1 1 1 1 1 16 2 2 14 14 1 1 16 18 18 2 7 2 7 7 7 16 2 7 2 16 7 10 7 7 7 7 10 3
1 16 2 2 2 2 1 14 1 1 1 1 16 16 2 14 14 1 14 18 18 2 7 16 2 7 10 2 2 2 16 7 7 7 10 7 7 7 7 7
1 1 16 16 16 2 1 1 14 2 2 1 1 16 16 16 2 14 14 18 18 2 7 16 2 2 10 2 16 16 7 7 7 7 7 10 7 7 7 7
1 1 1 1 16 2 14 14 2 2 1 2 14 1 1 16 2 2 14 18 18 2 10 7 16 2 2 16 7 7 7 7 7 7 7 10 7 7 7 7
2 14 1 1 16 2 2 14 2 1 1 2 14 14 1 16 2 2 2 18 18 2 10 10 2 2 16 7 7 7 2 10 7 7 10 10 7 7 7 10
16 2 14 1 1 16 2 2 2 14 1 16 16 2 2 2 2 16 2 18 18 2 2 2 2 16 7 7 7 2 2 10 7 10 10 7 2 2 7 10
16 2 14 14 14 1 16 16 2 2 14 1 1 16 16 16 16 16 2 18 18 2 2 2 16 10 7 10 2 2 10 10 10 2 2 2 2 7 7 10
1 16 2 2 2 14 14 1 16 2 2 14 14 1 1 1 16 2 2 18 18 2 2 2 16 7 10 2 2 10 10 2 2 2 10 7 10 10 7 10
18 18 18 18 18 18 18 18 18 18 18 18 18 18 18 18 18 18 18 18 18 18 18 18 18 18 18 18 18 18 18 18 18 18 18 18 18 18 18 18
18 18 18 18 18 18 18 18 18 18 18 18 18 18 18 18 18 18 18 18 18 18 18 18 18 18 18 18 18 18 18 18 18 18 18 18 18 18 18 18
15 15 9 15 9 2 2 15 2 2 15 9 2 2 2 3 16 2 2 18 18 2 2 2 16 6 16 2 2 2 9 2 2 2 9 2 16 6 6 17
15 15 15 15 9 9 2 2 16 16 2 2 2 16 2 2 2 2 2 18 18 2 2 2 16 8 16 2 16 5 9 5 6 6 9 6 6 6 17 8
9 15 15 15 15 9 2 16 9 9 16 16 16 9 16 2 2 2 2 18 18 2 2 2 16 16 2 2 16 5 9 5 6 5 9 6 6 6 17 8
9 9 15 2 2 2 16 9 9 15 15 9 9 9 13 16 2 2 2 18 18 2 2 2 2 2 2 2 2 16 9 6 6 6 9 6 6 6 17 8
13 9 15 2 15 15 15 15 15 15 9 9 9 13 3 16 2 2 2 18 18 2 2 2 2 2 16 16 16 5 9 6 5 5 9 5 6 17 8 8
3 13 15 15 15 15 9 15 13 3 13 13 3 3 3 16 2 2 2 18 18 2 2 2 16 16 17 6 5 5 9 5 5 6 9 6 6 8 8 8
3 3 9 15 9 9 9 13 3 3 3 3 3 3 3 16 2 2 2 18 18 2 2 2 16 8 17 17 6 5 9 6 6 17 9 17 8 8 8 8
3 3 3 9 13 13 13 3 3 3 3 3 3 3 3 16 2 2 2 18 18 2 2 2 16 8 8 8 8 17 9 17 17 8 9 8 8 8 8 8
3 3 3 3 3 3 3 3 3 3 3 3 3 3 3 16 2 2 2 18 18 2 2 2 16 8 8 8 8 8 9 8 8 8 9 8 8 8 8 8
3 3 3 3 3 3 3 3 3 3 3 3 3 3 3 16 2 2 2 18 18 2 2 2 16 8 8 8 8 8 9 1 1 1 9 8 8 8 8 8
3 3 3 3 3 3 3 3 3 3 3 3 3 3 16 2 2 2 2 18 18 2 2 2 16 8 8 8 8 8 16 16 16 16 16 8 8 8 8 8
3 3 3 3 3 3 3 3 3 3 3 15 9 9 16 2 2 2 2 18 18 2 2 2 2 16 8 17 8 8 8 8 8 8 8 8 8 8 8 8
3 3 3 3 3 3 17 3 3 15 15 15 15 9 16 2 2 2 2 18 18 2 2 2 2 16 17 5 17 17 5 8 8 13 8 8 8 8 8 8
3 3 3 3 3 17 17 5 15 9 15 15 9 9 9 2 2 2 2 18 18 2 2 2 2 2 16 16 5 5 5 5 13 7 13 5 17 8 8 8
17 17 17 17 5 15 15 15 15 15 9 13 16 16 2 2 2 2 2 18 18 2 2 2 14 14 15 18 16 16 16 5 5 17 5 5 5 5 17 17
5 5 5 5 13 13 9 15 9 16 2 2 2 2 2 2 2 2 2 18 18 2 2 2 2 15 18 15 2 2 2 16 5 17 5 5 5 7 5 5
5 5 15 5 5 5 5 13 13 2 2 15 16 2 2 16 16 16 2 18 18 2 2 2 2 18 15 14 2 9 2 2 2 2 5 5 7 8 7 5
5 5 9 13 5 5 5 5 5 5 15 9 5 5 5 5 5 5 16 18 18 16 2 16 16 16 5 14 9 15 9 5 5 5 5 5 5 17 5 5
5 5 17 5 5 17 17 17 17 5 5 5 17 5 17 17 17 5 5 18 18 5 5 5 5 17 17 17 5 17 5 17 5 5 17 17 17 17 5 5
---
2 2 2 2 2 2 2 16 16 16 16 16 16 16 16 16 16 16 16 18 18 7 7 7 7 7 7 7 7 7 7 7 7 7 7 7 7 7 7 7
2 2 2 2 2 2 2 16 16 16 16 16 16 16 2 16 16 16 16 18 18 7 7 7 7 7 7 7 10 10 10 10 7 7 7 7 7 7 7 7
2 2 2 2 2 2 2 16 16 16 1 1 16 16 16 16 16 1 16 18 18 7 7 7 7 7 7 10 10 10 10 10 10 3 7 7 7 7 7 7
2 2 2 2 2 2 2 16 16 16 1 1 1 16 16 1 1 1 16 18 18 2 2 7 7 7 2 10 10 10 10 10 10 10 3 7 7 7 7 7
2 2 2 2 2 2 2 2 16 16 16 1 1 1 16 1 1 16 16 18 18 2 2 2 7 2 16 16 10 10 10 10 10 10 3 3 7 7 7 7
2 2 2 2 2 2 2 2 16 1 1 1 1 1 1 1 1 16 16 18 18 2 7 2 2 2 16 16 10 10 10 10 10 10 10 10 10 7 7 7
2 2 2 2 2 2 2 2 16 1 1 1 14 1 1 1 1 16 16 18 18 2 7 2 2 3 16 16 10 10 3 3 10 10 10 10 10 10 7 7
2 2 2 2 1 1 14 14 1 1 14 14 14 1 1 1 1 1 16 18 18 2 7 2 3 3 16 16 3 3 16 16 7 10 10 10 10 10 7 7
2 2 2 2 1 1 14 14 14 14 1 1 14 14 14 1 1 1 1 18 18 7 2 2 2 2 7 7 16 16 16 16 7 10 10 10 3 3 7 7
1 1 2 2 1 1 14 14 14 14 1 1 1 14 14 14 14 1 1 18 18 7 2 2 2 7 7 7 16 16 16 7 7 3 3 3 3 3 3 7
1 1 1 1 1 1 14 14 14 1 1 1 1 1 1 14 14 1 1 18 18 7 2 7 2 2 7 7 7 16 7 7 7 3 3 3 3 3 3 7
2 1 1 1 1 14 14 14 14 14 14 1 1 1 1 1 14 14 1 18 18 7 2 7 2 2 2 7 7 16 7 7 2 7 3 3 3 3 3 7
2 1 1 1 1 1 14 1 14 14 14 14 1 1 1 1 1 14 1 18 18 7 2 7 7 2 3 7 7 7 7 2 2 2 7 3 3 3 3 3
2 2 1 1 1 1 14 14 1 1 1 14 14 1 1 1 1 1 1 18 18 7 2 7 7 7 3 7 7 7 2 2 2 2 2 7 3 3 3 3
2 2 2 2 1 1 1 1 1 1 14 1 1 14 14 1 1 1 1 18 18 7 3 2 7 7 7 7 2 2 2 2 2 2 2 7 3 3 3 3
1 1 2 2 1 1 1 1 1 14 14 1 1 1 14 1 1 1 1 18 18 7 3 3 7 7 7 2 2 2 7 7 2 2 7 7 3 3 3 3
1 1 1 2 2 1 1 1 1 1 14 1 1 1 1 1 1 1 1 18 18 7 7 7 7 7 2 2 2 7 7 7 2 7 7 3 7 7 3 3
1 1 1 1 1 2 1 1 1 1 1 14 14 1 1 1 1 1 1 18 18 7 7 7 7 3 2 3 7 7 7 7 7 7 7 7 7 3 3 3
1 1 1 1 1 1 1 1 1 1 1 1 1 14 14 14 1 1 1 18 18 7 7 7 7 2 3 7 7 7 7 7 7 7 3 3 3 3 3 3
18 18 18 18 18 18 18 18 18 18 18 18 18 18 18 18 18 18 18 18 18 18 18 18 18 18 18 18 18 18 18 18 18 18 18 18 18 18 18 18
18 18 18 18 18 18 18 18 18 18 18 18 18 18 18 18 18 18 18 18 18 18 18 18 18 18 18 18 18 18 18 18 18 18 18 18 18 18 18 18
2 2 2 2 2 3 3 3 3 3 3 5 3 3 3 5 3 3 3 18 18 8 8 8 5 5 5 8 8 8 5 9 9 9 5 17 17 17 17 15
2 2 2 2 2 2 3 3 9 9 3 3 3 9 3 3 3 3 3 18 18 8 8 8 5 5 5 8 5 8 5 9 9 9 5 17 17 17 15 2
2 2 2 2 2 2 3 9 5 5 9 9 9 2 9 3 3 3 3 18 18 8 8 8 5 5 8 8 5 8 5 9 9 9 5 17 17 17 15 2
2 2 2 3 3 3 9 5 5 2 2 2 2 2 17 9 3 3 3 18 18 8 8 8 8 8 8 8 8 5 5 9 9 9 5 17 17 17 15 2
17 2 2 3 2 2 2 2 2 2 2 2 2 17 9 9 3 3 3 18 18 8 8 8 8 8 5 5 5 17 5 9 9 9 5 17 17 15 2 2
15 17 2 2 2 2 2 2 17 16 17 17 9 9 9 9 3 3 3 18 18 8 8 8 5 5 13 5 17 17 5 9 9 9 5 17 17 2 2 2
15 15 2 2 2 2 2 17 5 16 16 9 9 9 9 9 3 3 3 18 18 8 8 8 5 2 13 13 5 17 5 9 9 9 5 16 2 2 2 2
15 15 15 2 17 17 17 15 5 16 16 9 9 9 9 9 3 3 3 18 18 8 8 8 5 2 2 2 2 17 5 9 9 6 5 2 2 2 2 2
15 15 15 15 15 15 15 5 5 16 16 16 9 9 9 9 3 3 3 18 18 8 8 8 5 2 2 2 2 2 5 6 6 6 5 2 2 2 2 2
15 15 15 15 15 15 15 5 5 5 16 16 9 9 9 9 3 3 3 18 18 8 8 8 5 2 2 2 2 2 5 17 17 17 5 2 2 2 2 2
15 15 15 15 15 15 15 5 5 5 16 16 9 9 9 3 3 3 3 18 18 8 8 8 5 2 2 2 2 2 17 17 17 17 17 2 2 2 2 2
15 15 15 15 15 15 15 5 5 5 16 5 13 13 9 3 3 3 3 18 18 8 8 8 8 5 2 6 2 2 2 2 2 2 2 2 2 2 2 2
15 15 15 15 15 15 13 5 5 5 5 5 5 13 9 3 3 3 3 18 18 8 8 8 8 5 6 6 6 6 6 2 2 1 2 2 2 2 2 2
15 15 15 15 15 13 13 5 5 13 5 5 13 13 13 3 3 3 3 18 18 8 8 8 8 8 5 5 6 6 6 6 1 5 1 16 16 2 2 2
13 13 13 13 2 5 5 5 5 5 13 17 3 3 3 3 3 3 3 18 18 8 8 8 8 8 14 8 5 5 5 6 6 6 16 16 16 16 2 2
2 2 2 2 17 17 13 5 13 3 3 3 3 3 3 3 3 3 3 18 18 8 8 8 8 14 8 14 6 6 6 5 6 6 16 16 16 18 16 16
2 2 16 2 2 2 2 17 17 3 3 16 3 3 3 3 3 3 3 18 18 8 8 8 8 8 14 16 6 5 6 6 6 6 16 16 18 16 18 16
2 2 16 16 2 2 2 2 2 2 16 16 2 2 2 2 2 2 3 18 18 8 8 8 8 8 16 16 5 16 5 16 16 16 16 16 16 2 16 16
2 2 16 2 2 16 16 16 16 2 2 2 16 2 16 16 16 2 2 18 18 7 7 7 7 16 16 16 16 17 16 17 16 16 2 2 2 2 16 16
