0 0 0 0 0 0 0 16 16 16 16 0 0 0 0 0 0 0
0 0 0 0 0 16 16 14 13 13 14 16 16 0 0 0 0 0
0 0 0 16 16 14 14 13 14 13 13 14 14 16 16 0 0 0
0 16 16 14 14 14 13 13 13 13 13 13 14 14 14 16 16 0
16 14 14 14 14 14 13 13 13 7 7 13 14 14 14 14 14 16
16 14 14 14 14 14 14 13 13 7 13 14 14 14 14 14 14 16
16 10 10 14 14 14 14 14 14 14 14 14 14 14 14 10 10 16
16 10 10 10 10 14 14 14 14 14 14 14 14 10 10 10 10 16
16 14 14 10 10 10 10 14 14 14 14 10 10 10 10 14 14 16
16 13 14 14 14 10 10 10 10 10 10 10 10 14 14 14 13 16
16 13 13 14 14 14 14 10 10 10 10 14 14 14 14 13 13 16
16 15 13 14 7 13 13 14 14 14 14 13 13 7 14 13 15 16
16 15 13 14 13 15 13 13 14 14 13 15 13 13 14 13 15 16
16 10 10 10 13 15 15 13 14 14 13 15 15 13 14 10 10 16
0 16 16 10 10 10 13 13 14 14 13 13 10 10 10 16 16 0
0 0 0 16 16 10 10 10 10 10 10 10 10 16 16 0 0 0
0 0 0 0 0 16 16 10 10 10 10 16 16 0 0 0 0 0
0 0 0 0 0 0 0 16 16 16 16 0 0 0 0 0 0 0
---
0 0 0 0 0 0 0 14 14 14 14 0 0 0 0 0 0 0
0 0 0 0 0 14 14 10 16 16 10 14 14 0 0 0 0 0
0 0 0 14 14 10 10 16 10 16 16 10 10 14 14 0 0 0
0 14 14 10 10 10 16 16 16 16 16 16 10 10 10 14 14 0
14 10 10 10 10 10 16 16 16 7 7 16 10 10 10 10 10 14
14 10 10 10 10 10 10 16 16 7 16 10 10 10 10 10 10 14
14 14 14 10 10 10 10 13 13 13 13 10 10 10 10 14 14 14
14 14 14 14 14 10 10 13 13 13 13 10 10 14 14 14 14 14
14 13 13 14 14 14 14 13 13 13 13 14 14 14 14 13 13 14
14 10 13 13 13 14 14 14 14 14 14 14 14 13 13 13 14 14
14 10 10 13 13 13 13 14 14 14 14 13 13 13 13 14 14 14
14 15 10 13 7 16 16 13 13 13 13 15 15 7 13 14 15 14
14 15 10 13 16 10 16 16 13 13 15 14 13 16 13 14 15 14
14 16 16 16 16 10 10 16 13 13 15 14 14 16 13 16 16 14
0 14 14 16 16 16 16 16 13 13 15 15 16 16 16 14 14 0
0 0 0 14 14 16 16 16 16 16 16 16 16 14 14 0 0 0
0 0 0 0 0 14 14 16 16 16 16 14 14 0 0 0 0 0
0 0 0 0 0 0 0 14 14 14 14 0 0 0 0 0 0 0
