0 0 0 0 18 18 18 0 0 0 0 0 0 0
0 0 0 18 2 2 2 18 0 0 0 0 0 0
0 0 18 2 2 2 2 2 18 0 0 0 0 0
0 18 2 18 18 18 18 2 18 0 0 0 0 0
18 2 2 2 2 2 2 2 2 18 0 0 0 0
0 0 3 3 3 3 3 3 2 18 0 0 0 0
0 0 18 14 9 18 14 3 18 0 0 0 0 0
0 0 0 9 9 9 3 3 18 0 18 18 0 0
18 9 9 9 9 9 3 3 18 18 9 9 18 0
0 18 9 9 9 9 9 3 18 9 9 9 9 18
0 0 18 3 3 3 3 3 3 9 9 9 9 18
0 18 3 3 3 3 3 3 9 3 9 9 18 0
18 3 3 3 3 3 3 3 9 3 9 18 0 0
18 3 18 3 3 3 3 3 3 9 18 0 0 0
0 18 18 3 3 3 3 3 9 18 0 0 0 0
0 18 3 3 18 18 18 3 3 18 0 0 0 0
18 9 9 9 18 0 18 9 9 9 18 0 0 0
0 18 18 18 0 0 0 18 18 18 0 0 0 0
---
0 0 0 0 9 9 9 0 0 0 0 0 0 0
0 0 0 9 18 18 18 9 0 0 0 0 0 0
0 0 9 18 18 18 18 18 9 0 0 0 0 0
0 9 18 9 9 9 9 18 9 0 0 0 0 0
9 18 18 18 18 18 18 18 18 9 0 0 0 0
0 0 18 18 18 18 18 18 18 9 0 0 0 0
0 0 14 18 3 14 18 18 9 0 0 0 0 0
0 0 0 3 3 3 18 18 9 0 9 9 0 0
3 3 3 3 3 3 18 18 9 9 3 3 9 0
0 3 3 3 3 3 3 18 9 3 3 3 3 9
0 0 3 18 18 18 18 18 18 3 3 3 3 9
0 3 18 18 18 18 18 18 3 18 3 3 9 0
3 18 18 18 18 18 18 18 3 18 3 9 0 0
3 18 3 18 2 2 2 2 2 3 9 0 0 0
0 3 3 2 2 2 2 2 3 9 0 0 0 0
0 3 2 2 2 2 9 2 2 9 0 0 0 0
3 3 3 3 2 0 9 3 3 3 9 0 0 0
0 3 2 2 0 0 0 9 9 9 0 0 0 0
