0 0 0 0 0 0 0 0 0 0 0 0 0 0 0 0 0 0 0 0 0
0 0 0 0 0 0 0 0 0 0 0 0 0 0 0 0 0 0 0 0 0
0 0 0 0 0 0 0 0 0 0 0 0 0 0 0 0 0 0 0 0 0
0 0 0 0 0 0 0 0 0 0 0 0 0 0 0 0 0 0 0 0 0
0 0 0 0 0 0 0 0 0 0 0 0 0 0 0 0 0 0 0 0 0
0 0 0 0 0 0 0 0 18 18 18 18 18 0 0 0 0 0 0 0 0
0 0 0 0 0 0 18 18 3 14 14 14 3 18 18 0 0 0 0 0 0
0 0 0 0 0 18 3 14 14 14 14 3 3 3 3 18 0 0 0 0 0
0 0 0 0 18 3 3 14 14 14 14 14 3 3 3 1 18 0 0 0 0
0 0 0 0 18 3 3 3 3 14 3 3 3 3 3 1 18 0 0 0 0
0 0 0 18 3 3 3 3 3 3 3 3 3 3 3 3 1 18 0 0 0
0 0 0 18 3 18 18 14 18 3 3 3 18 18 14 18 1 18 0 0 0
0 0 0 18 3 18 18 18 18 3 3 3 18 18 18 18 1 18 0 0 0
0 0 0 18 3 3 18 18 3 3 18 3 3 18 18 3 1 18 0 0 0
0 18 18 18 1 3 3 3 3 18 3 18 3 3 3 1 1 18 18 18 0
18 10 10 18 18 1 1 3 3 3 3 3 3 1 1 1 18 18 10 10 18
0 18 18 3 3 18 18 18 18 3 3 1 18 18 18 18 3 3 18 18 0
18 3 3 3 18 3 3 3 3 18 1 18 3 3 3 3 18 3 3 3 18
18 10 10 10 18 3 3 3 3 18 10 18 3 3 3 3 18 10 10 10 18
0 18 18 18 18 10 10 10 10 18 18 18 10 10 10 10 18 18 18 18 0
0 0 0 0 0 18 18 18 18 0 0 0 18 18 18 18 0 0 0 0 0
---
0 0 0 0 0 0 0 0 0 0 0 0 0 0 0 0 0 0 0 0 0
0 0 0 0 0 0 0 0 0 0 0 0 0 0 0 0 0 0 0 0 0
0 0 0 0 0 0 0 0 0 0 0 0 0 0 0 0 0 0 0 0 0
0 0 0 0 0 0 0 0 0 0 0 0 0 0 0 0 0 0 0 0 0
0 0 0 0 0 0 0 0 0 0 0 0 0 0 0 0 0 0 0 0 0
0 0 0 0 0 0 0 0 3 3 3 3 3 0 0 0 0 0 0 0 0
0 0 0 0 0 0 14 14 18 3 3 3 18 3 3 0 0 0 0 0 0
0 0 0 0 0 14 18 3 3 3 3 18 18 18 18 3 0 0 0 0 0
0 0 0 0 14 18 18 3 3 3 3 3 18 18 18 10 3 0 0 0 0
0 0 0 0 14 18 18 18 18 3 18 18 18 18 18 10 3 0 0 0 0
0 0 0 14 18 18 18 18 18 18 18 18 18 18 18 18 10 3 0 0 0
0 0 0 14 18 1 1 3 1 18 18 18 3 3 3 3 10 3 0 0 0
0 0 0 14 18 1 1 1 1 18 18 18 3 3 3 3 10 3 0 0 0
0 0 0 14 18 18 1 1 18 18 10 18 18 3 3 18 10 3 0 0 0
0 14 14 14 10 18 18 18 18 10 18 10 18 18 18 10 10 3 3 3 0
14 18 18 3 3 10 10 18 18 18 18 18 18 10 10 10 3 3 1 1 3
0 14 14 18 18 3 3 3 3 18 18 10 3 3 3 3 18 18 3 3 0
3 18 18 18 3 18 18 18 18 3 10 3 18 18 18 18 3 18 18 18 3
3 3 3 3 3 18 18 18 18 3 1 3 18 18 18 18 3 18 18 18 3
0 3 3 3 3 18 18 18 18 3 3 3 1 1 1 1 3 3 3 3 0
0 0 0 0 0 3 3 3 3 0 0 0 3 3 3 3 0 0 0 0 0
