0 0 0 0 0 18 18 18 0 0 0 0 0
0 0 0 0 18 3 3 14 18 0 0 0 0
0 0 0 18 3 3 3 3 14 18 0 0 0
0 0 0 18 3 14 3 18 18 18 0 0 0
0 0 0 18 3 14 3 3 3 18 0 0 0
0 0 0 18 3 14 13 13 3 18 0 0 0
0 0 0 18 3 14 13 18 18 18 0 0 0
0 0 0 18 3 14 13 13 3 18 0 0 0
0 0 0 18 3 14 13 13 3 18 0 0 0
0 0 0 18 3 14 13 18 18 18 0 0 0
0 0 0 18 3 14 13 13 3 18 0 0 0
0 0 18 3 3 14 13 13 3 3 18 0 0
0 18 3 13 13 14 13 13 13 13 3 18 0
18 3 13 13 14 13 13 13 13 13 13 3 18
18 3 13 14 13 13 13 13 13 13 13 3 18
18 3 13 14 14 13 13 13 13 13 13 3 18
18 3 13 13 14 14 14 13 14 13 13 3 18
0 18 3 13 13 13 13 13 13 13 3 18 0
0 0 18 18 3 3 3 3 3 18 18 0 0
0 0 0 0 18 18 18 18 18 0 0 0 0
---
0 0 0 0 0 13 13 13 0 0 0 0 0
0 0 0 0 13 18 18 18 13 0 0 0 0
0 0 0 13 18 18 18 18 18 13 0 0 0
0 0 0 13 18 18 18 13 13 13 0 0 0
0 0 0 13 18 18 18 18 18 13 0 0 0
0 0 0 13 18 18 18 3 18 13 0 0 0
0 0 0 13 18 18 18 13 13 13 0 0 0
0 0 0 13 18 18 18 3 18 13 0 0 0
0 0 0 13 18 18 18 3 18 13 0 0 0
0 0 0 13 18 18 18 13 13 13 0 0 0
0 0 0 13 18 18 18 3 14 13 0 0 0
0 0 13 18 18 18 18 3 14 14 13 0 0
0 13 18 18 18 18 3 3 3 3 14 13 0
13 18 18 18 3 3 3 3 3 3 3 14 13
13 18 14 3 3 3 3 3 3 3 3 14 13
13 18 14 3 3 3 3 3 3 3 3 14 13
13 18 14 14 3 3 3 3 13 3 3 14 13
0 13 18 14 14 3 3 3 3 3 14 13 0
0 0 13 13 14 14 14 14 14 13 13 0 0
0 0 0 0 13 13 13 13 13 0 0 0 0
