0 0 18 18 0 0 0 0 0 0 18 18 0 0
0 18 9 9 18 18 18 18 18 18 19 19 18 0
0 18 2 2 9 9 19 19 19 19 2 2 18 0
0 18 9 2 9 9 9 19 19 19 2 19 18 0
0 0 18 9 9 9 9 19 19 19 19 18 0 0
0 18 9 18 18 9 8 8 19 18 18 19 18 0
18 9 13 13 9 8 18 10 8 19 13 13 19 18
18 19 9 9 2 18 6 18 2 2 19 19 19 18
18 19 19 2 19 2 6 6 18 19 2 19 19 18
18 19 19 19 19 2 6 6 18 19 19 19 19 18
18 19 19 19 2 19 18 18 19 2 19 19 19 18
0 18 19 19 19 19 19 19 19 19 19 19 18 0
0 0 18 18 18 18 18 18 18 18 18 18 0 0
---
0 0 19 19 0 0 0 0 0 0 19 19 0 0
0 19 18 18 19 19 19 19 19 19 18 18 19 0
0 19 18 18 18 18 18 18 18 18 18 18 19 0
0 19 18 18 18 18 18 2 2 18 18 2 19 0
0 0 19 18 18 18 18 2 2 2 2 19 0 0
0 19 18 19 19 18 18 18 2 19 19 2 19 0
19 18 18 18 18 18 19 19 18 2 18 18 2 19
19 9 18 18 18 19 18 19 18 18 2 2 2 19
19 9 9 18 9 18 18 18 19 2 18 6 6 19
19 9 9 9 9 18 18 18 19 13 6 6 6 19
19 9 9 9 18 9 19 19 8 18 13 13 13 19
0 19 9 9 9 9 9 9 10 8 8 8 19 0
0 0 19 19 19 19 19 19 19 19 19 19 0 0
