0 0 0 0 0 0 0 0 0 0 0 0 18 18 18
0 0 0 0 0 0 0 0 0 0 18 18 8 19 18
0 0 0 0 0 0 0 0 0 18 8 8 19 19 18
0 0 0 0 0 0 0 0 18 8 8 16 19 18 0
0 0 0 0 0 0 0 18 8 8 16 19 19 18 0
0 0 0 0 0 0 18 8 8 16 19 19 18 0 0
0 0 0 0 0 0 18 8 16 19 19 18 0 0 0
0 0 0 0 0 18 18 16 19 19 18 0 0 0 0
0 0 0 0 18 14 2 18 18 18 0 0 0 0 0
0 0 0 18 14 1 1 1 14 18 0 0 0 0 0
0 0 18 18 14 1 1 1 14 18 18 0 0 0 0
0 18 14 14 1 1 1 1 1 1 14 18 0 0 0
18 14 1 1 1 1 1 1 1 1 1 14 18 0 0
18 14 4 4 4 4 4 4 4 4 4 14 18 0 0
18 14 4 4 4 4 4 4 4 4 4 14 18 0 0
18 14 1 4 4 4 4 4 4 4 1 14 18 0 0
0 18 14 14 14 14 14 14 14 14 14 18 0 0 0
0 0 18 18 18 18 18 18 18 18 18 0 0 0 0
---
0 0 0 0 0 0 0 0 0 0 0 0 4 4 4
0 0 0 0 0 0 0 0 0 0 4 4 18 18 4
0 0 0 0 0 0 0 0 0 4 18 18 18 18 4
0 0 0 0 0 0 0 0 4 18 18 18 18 4 0
0 0 0 0 0 0 0 4 18 18 18 18 18 4 0
0 0 0 0 0 0 4 18 18 18 18 18 4 0 0
0 0 0 0 0 0 4 18 18 18 18 4 0 0 0
0 0 0 0 0 4 4 18 18 18 4 0 0 0 0
0 0 0 0 4 1 18 4 4 4 0 0 0 0 0
0 0 0 4 1 18 18 18 19 4 0 0 0 0 0
0 0 14 14 1 18 18 18 19 14 14 0 0 0 0
0 14 1 1 18 18 18 18 18 18 1 14 0 0 0
14 1 18 18 18 18 18 18 18 18 18 1 14 0 0
14 1 18 19 19 19 19 19 19 19 19 1 14 0 0
14 1 8 16 16 16 16 16 2 19 19 1 14 0 0
14 1 8 8 8 8 8 8 8 8 8 1 14 0 0
0 14 1 1 1 1 1 1 1 1 1 14 0 0 0
0 0 14 14 14 14 14 14 14 14 14 0 0 0 0
