0 0 0 0 0 0 0 0 0 0 0
0 0 0 0 16 16 16 0 0 0 0
0 0 16 16 13 13 13 16 16 0 0
0 16 13 13 13 14 14 13 13 16 0
0 16 14 13 13 14 14 13 13 16 0
16 14 13 13 13 13 13 13 13 14 16
16 13 13 16 16 16 16 16 13 14 16
16 13 16 8 16 8 16 8 16 13 16
0 16 16 8 16 8 16 8 16 16 0
0 0 16 8 8 8 8 8 16 0 0
0 0 0 16 16 16 16 16 0 0 0
---
0 0 0 0 0 0 0 0 0 0 0
0 0 0 0 13 13 13 0 0 0 0
0 0 13 13 16 16 16 13 13 0 0
0 13 16 16 16 16 16 16 16 13 0
0 13 13 16 16 16 16 16 16 13 0
13 13 16 16 16 16 16 16 16 13 13
14 16 16 8 8 8 8 8 16 13 13
14 16 8 16 8 16 8 16 13 16 13
0 14 8 16 8 16 8 16 13 13 0
0 0 14 16 16 16 16 16 13 0 0
0 0 0 14 14 14 14 13 0 0 0
