0 0 0 0 0 0 16 16 16 16 0 0 0 0 0 0
0 0 0 0 16 16 13 15 15 13 16 16 0 0 0 0
0 0 0 16 13 13 13 15 15 13 13 13 16 0 0 0
0 0 16 13 13 13 13 13 13 13 13 13 13 16 0 0
0 0 16 13 13 13 13 13 13 13 13 13 13 16 0 0
0 16 13 14 14 13 13 13 13 13 13 14 14 13 16 0
0 16 14 14 14 14 16 16 16 16 14 14 14 14 16 0
0 16 14 14 16 14 16 16 16 16 14 16 14 14 16 0
0 16 13 14 14 14 16 16 16 16 14 14 14 13 16 0
0 0 16 13 13 14 16 16 16 16 14 13 13 16 0 0
0 0 16 13 13 13 16 16 16 16 13 13 13 16 0 0
0 0 0 16 13 13 13 16 16 13 13 13 16 0 0 0
0 0 16 15 13 13 13 13 13 13 13 13 15 16 0 0
0 16 1 15 13 13 13 13 13 13 13 13 15 1 16 0
0 16 1 1 13 13 13 15 15 13 13 13 1 1 16 0
0 16 1 1 13 13 15 15 15 15 13 13 1 1 16 0
0 16 1 16 13 13 15 16 16 15 13 13 16 1 16 0
2 2 16 2 16 16 16 2 2 16 16 16 2 16 2 2
2 2 2 2 2 2 2 2 2 2 2 2 2 2 2 2
0 0 0 0 0 0 16 13 13 16 0 0 0 0 0 0
0 0 0 0 0 0 0 16 16 0 0 0 0 0 0 0
0 0 0 0 0 0 0 16 16 0 0 0 0 0 0 0
---
0 0 0 0 0 0 13 13 13 13 0 0 0 0 0 0
0 0 0 0 13 13 15 2 2 15 13 13 0 0 0 0
0 0 0 13 14 14 15 2 2 15 14 14 13 0 0 0
0 0 13 14 14 14 15 15 15 15 14 14 14 13 0 0
0 0 13 14 14 14 14 15 15 14 14 14 14 13 0 0
0 13 14 13 13 14 14 14 14 14 14 2 2 14 13 0
0 13 13 13 13 13 13 13 13 13 2 2 2 2 13 0
0 13 13 13 13 13 13 13 13 13 2 2 2 2 13 0
0 13 16 13 13 13 13 13 13 13 2 2 2 16 13 0
0 0 13 16 16 13 13 13 13 13 2 16 16 13 0 0
0 0 13 16 16 16 13 13 13 13 16 16 16 13 0 0
0 0 0 13 16 16 16 13 13 16 16 16 13 0 0 0
0 0 13 1 16 16 16 16 16 16 16 16 1 13 0 0
0 13 15 1 16 16 16 16 16 16 16 16 1 2 13 0
0 13 15 15 16 16 16 1 1 16 16 16 2 2 13 0
0 13 15 15 16 16 1 1 1 1 16 16 2 2 13 0
0 13 15 13 16 16 1 13 13 1 16 16 13 2 13 0
16 16 13 16 13 13 13 16 16 13 13 13 16 13 16 16
16 16 16 16 16 16 16 16 16 16 16 16 16 16 16 16
0 0 0 0 0 0 16 16 16 16 0 0 0 0 0 0
0 0 0 0 0 0 0 16 16 0 0 0 0 0 0 0
0 0 0 0 0 0 0 16 16 0 0 0 0 0 0 0
