0 0 0 0 0 16 16 0 0 0 0 0 0 0 0
0 0 0 0 16 19 19 16 0 16 16 0 0 0 0
0 0 16 16 16 15 9 16 16 15 19 16 0 0 0
0 16 15 9 16 15 9 16 9 15 19 16 16 16 0
0 16 15 9 16 15 16 15 16 15 19 16 15 19 16
0 16 15 16 15 19 16 15 19 15 19 16 15 19 16
0 16 15 16 15 19 16 15 19 15 9 19 15 9 16
16 16 16 16 15 19 16 15 19 15 9 19 16 16 16
16 14 14 16 15 19 16 15 19 15 9 16 14 14 16
16 9 13 14 16 19 16 15 19 9 16 14 13 13 16
16 9 13 13 14 16 16 16 16 16 14 13 13 13 16
0 16 9 13 13 14 14 14 14 14 13 13 13 16 0
0 16 9 13 13 13 13 13 13 13 13 13 13 16 0
0 16 9 13 13 13 13 13 13 13 13 13 13 16 0
0 16 9 13 13 13 13 13 13 13 13 13 13 16 0
0 16 9 13 13 13 13 13 13 13 13 13 13 16 0
0 16 9 13 13 13 13 13 13 13 13 13 13 16 0
0 0 16 9 13 13 13 13 13 13 13 13 16 0 0
0 0 0 16 16 16 16 16 16 16 16 16 0 0 0
---
0 0 0 0 0 15 15 0 0 0 0 0 0 0 0
0 0 0 0 15 13 13 15 0 15 15 0 0 0 0
0 0 15 15 15 13 13 15 15 13 13 15 0 0 0
0 19 13 13 15 13 13 15 13 13 13 15 15 15 0
0 19 13 13 15 13 15 13 15 13 13 15 13 13 15
0 19 13 19 13 13 15 13 13 13 13 15 13 13 15
0 19 13 19 13 13 15 13 13 13 13 13 13 13 15
19 19 19 19 13 13 16 13 13 13 13 13 9 9 9
19 13 13 19 13 13 16 13 13 13 13 9 13 13 9
19 16 13 13 19 13 9 13 13 13 9 13 16 16 9
19 16 16 16 13 9 9 9 9 9 13 16 16 16 9
0 19 16 16 16 13 13 13 13 13 16 16 16 9 0
0 19 16 16 16 16 16 16 16 16 16 16 16 9 0
0 19 16 16 16 16 16 16 16 16 16 16 16 9 0
0 19 16 16 16 16 16 16 16 16 16 16 16 9 0
0 19 16 16 16 16 16 16 16 16 16 16 16 9 0
0 14 16 16 16 16 16 16 16 16 16 16 16 14 0
0 0 14 16 16 16 16 16 16 16 16 16 14 0 0
0 0 0 14 14 14 14 14 14 14 14 14 0 0 0
