0 0 0 0 0 18 18 18 18 18 18 18 18 18 0 0 0 0
0 0 0 0 18 9 9 9 9 9 9 9 9 9 18 0 0 0
0 18 18 0 18 9 9 9 9 9 9 2 2 2 18 0 18 18
18 9 18 18 9 9 9 9 9 9 9 9 9 2 2 18 2 18
0 18 2 2 2 2 2 2 2 2 2 2 2 2 2 2 18 0
0 0 18 18 18 18 18 18 18 18 18 18 18 18 18 18 0 0
0 0 0 18 2 14 2 2 2 2 14 14 2 2 18 0 0 0
0 0 0 18 2 14 14 14 14 14 14 14 2 14 14 18 0 0
0 0 0 0 18 14 18 14 14 18 14 14 14 14 14 18 0 0
0 0 0 0 18 14 14 14 14 14 14 14 14 18 18 0 0 0
0 0 0 0 0 18 18 18 18 18 18 18 18 18 0 0 0 0
0 0 0 0 18 15 16 13 13 13 16 15 15 15 18 0 0 0
0 0 0 18 14 16 14 16 13 16 14 16 15 15 14 18 0 0
0 0 0 18 14 15 16 15 15 15 16 15 15 2 2 18 0 0
0 0 0 0 18 18 1 2 2 2 1 1 1 2 2 0 0 0
0 0 0 0 0 18 1 1 18 18 18 1 1 18 2 0 0 0
0 0 0 0 18 2 2 2 18 0 18 2 2 2 18 0 0 0
0 0 0 0 18 18 18 18 0 0 0 18 18 18 18 0 0 0
---
0 0 0 0 0 14 14 14 14 14 14 14 14 14 0 0 0 0
0 0 0 0 14 18 18 18 18 18 18 18 18 18 14 0 0 0
0 14 14 0 14 18 18 18 18 18 18 18 18 18 14 0 14 14
14 18 14 14 18 18 18 18 18 18 18 18 18 18 18 14 18 14
0 14 18 18 18 18 18 18 18 18 18 18 18 18 18 18 14 0
0 0 14 14 14 14 14 14 1 1 1 1 1 1 1 1 0 0
0 0 0 9 16 2 13 13 13 13 2 2 16 16 9 0 0 0
0 0 0 9 16 2 2 2 2 2 2 2 16 2 2 9 0 0
0 0 0 0 9 2 15 2 2 15 2 2 2 2 2 9 0 0
0 0 0 0 9 2 2 2 2 2 2 2 2 9 9 0 0 0
0 0 0 0 0 9 9 9 9 9 9 9 9 9 0 0 0 0
0 0 0 0 9 16 15 15 15 15 18 18 18 18 14 0 0 0
0 0 0 9 15 15 18 15 15 18 16 18 18 18 16 14 0 0
0 0 0 9 15 18 15 18 18 18 18 18 18 18 18 14 0 0
0 0 0 0 9 9 18 18 18 18 18 18 18 18 18 0 0 0
0 0 0 0 0 9 18 18 2 2 2 18 18 2 18 0 0 0
0 0 0 0 9 18 18 18 2 0 2 18 18 18 2 0 0 0
0 0 0 0 2 2 2 2 0 0 0 2 2 2 2 0 0 0
