9 15 15 15 9 9 9 14 14 16 16 16 16 16 16 14 14 9 9 9 15 15 15 9
15 9 15 15 15 9 14 16 16 10 10 10 10 10 10 16 16 14 9 15 15 15 9 15
15 15 9 15 14 14 16 16 10 10 11 11 11 11 10 10 16 16 14 14 15 9 15 15
15 15 15 14 16 16 16 10 10 11 3 3 3 3 11 10 10 16 16 16 14 15 15 15
9 15 14 16 10 10 10 10 11 11 3 14 14 3 11 11 10 10 10 10 16 14 15 9
9 9 14 16 10 11 11 11 3 11 3 3 3 3 11 3 11 11 11 10 16 14 9 9
9 14 16 10 10 11 11 3 14 3 11 3 3 11 3 14 3 11 11 10 10 16 14 9
14 16 10 10 11 11 11 3 3 3 3 3 3 3 3 3 3 11 11 11 10 10 16 14
14 16 10 11 3 14 14 11 3 3 3 3 3 3 3 3 11 14 14 3 11 10 16 14
14 16 10 11 3 3 14 3 11 3 18 18 18 18 3 11 3 14 3 3 11 10 16 14
14 16 10 10 11 3 3 3 3 18 14 14 14 14 18 3 3 3 3 11 10 10 16 14
15 14 16 10 10 11 11 3 18 14 1 1 1 1 14 18 3 11 11 10 10 16 14 15
15 14 16 16 16 10 10 18 14 1 1 14 14 1 1 14 18 10 10 16 16 16 14 15
9 9 9 14 16 16 16 18 14 4 1 1 1 1 4 14 18 16 16 16 14 14 9 9
9 9 14 14 14 16 16 18 14 4 4 1 1 4 4 14 18 16 16 14 14 14 9 9
9 14 16 16 16 16 14 18 14 4 4 4 4 4 4 14 18 14 16 16 16 16 14 9
14 16 16 14 14 14 14 3 18 14 4 4 4 4 14 18 3 14 14 14 14 16 16 14
14 16 14 14 3 3 3 3 3 18 14 14 14 14 18 3 3 3 3 3 14 14 16 14
16 10 11 14 3 3 3 3 3 3 18 18 18 18 3 3 3 3 3 3 14 11 10 16
16 10 10 11 11 11 11 14 14 3 3 3 3 3 3 14 14 11 11 11 11 10 10 16
14 16 16 10 10 10 10 11 11 11 11 11 11 11 11 11 11 10 10 10 10 16 16 14
15 14 16 16 10 10 10 10 10 10 10 10 10 10 10 10 10 10 10 10 16 16 14 15
15 9 14 14 16 16 16 10 10 10 10 10 10 10 10 10 10 16 16 16 14 14 9 15
9 9 15 15 14 14 14 16 16 16 16 16 16 16 16 16 16 14 14 14 15 15 9 9
---
15 10 10 10 15 15 15 15 15 14 14 14 14 14 14 3 3 16 16 16 16 16 16 1
10 15 10 10 10 15 15 14 14 16 16 16 16 16 16 14 14 3 16 16 16 16 1 16
10 10 15 10 15 15 14 14 16 16 10 10 10 10 16 16 14 14 3 3 16 1 16 16
10 10 10 15 14 14 14 16 16 10 11 11 11 11 10 16 16 14 14 14 3 16 16 16
4 10 15 14 16 16 16 16 10 10 11 4 4 11 10 10 16 16 16 16 14 3 16 11
4 4 15 14 16 10 10 10 11 10 11 11 11 11 10 11 10 10 10 16 14 3 11 11
4 15 14 16 16 10 10 11 15 11 10 11 11 10 11 9 11 10 10 16 16 14 3 11
15 14 16 16 10 10 10 11 11 11 11 11 11 11 11 11 11 10 10 10 16 16 14 3
15 14 16 10 11 11 11 9 11 11 11 11 11 11 11 11 10 16 16 11 10 16 14 3
15 14 16 10 11 11 11 11 9 11 16 16 16 16 11 10 14 16 11 11 10 16 14 3
15 14 16 16 10 11 11 11 11 16 9 9 9 9 16 11 11 11 11 10 16 16 14 3
14 15 14 16 16 10 10 11 16 9 18 18 18 18 9 16 11 10 10 16 16 14 3 4
14 15 14 14 14 16 16 16 9 18 18 16 18 18 18 9 16 16 16 14 14 14 3 4
14 14 14 15 14 14 14 16 9 9 18 18 18 18 9 9 16 14 14 14 3 3 14 14
14 14 15 15 15 14 14 16 9 9 9 18 18 9 9 9 16 14 14 3 3 3 14 14
14 15 14 14 14 14 4 16 9 9 9 9 9 9 9 9 16 15 14 14 14 14 3 14
15 14 14 4 4 4 4 10 16 9 9 9 9 9 9 16 10 15 15 15 15 14 14 3
15 14 4 4 10 10 10 10 10 16 9 9 9 9 16 10 10 10 10 10 15 15 14 3
14 3 3 4 10 10 10 10 10 10 16 16 16 16 10 10 10 10 10 10 15 3 3 14
14 3 3 3 3 3 3 15 15 10 10 10 10 10 10 10 10 3 3 3 3 3 3 14
18 14 14 3 3 3 3 3 3 3 3 3 3 3 3 3 3 3 3 3 3 14 14 1
11 18 14 14 3 3 3 3 3 3 3 3 3 3 3 3 3 3 3 3 14 14 1 1
11 3 18 18 14 14 14 3 3 3 3 3 3 3 3 3 3 14 14 14 1 1 14 1
3 3 18 18 18 18 18 14 14 14 14 14 14 14 14 14 14 1 1 1 1 1 14 14
