0 0 0 0 0 18 18 18 18 18 18 18 18 18 0 0 0 0
0 0 0 18 18 14 14 14 14 15 15 15 9 9 18 0 0 0
0 0 18 15 14 15 15 15 15 15 15 15 15 9 9 18 0 0
0 0 18 15 15 18 18 18 18 18 18 15 15 15 9 18 0 0
0 0 18 15 18 14 14 14 14 14 3 18 15 15 9 18 0 0
0 0 18 18 18 14 18 18 18 14 3 18 18 18 18 18 0 0
0 0 18 18 18 14 18 18 18 14 3 18 18 18 18 18 0 0
0 0 18 15 18 14 3 3 3 3 18 18 15 15 9 18 0 0
0 0 18 15 15 18 18 18 18 18 12 12 15 9 9 18 0 0
0 0 0 18 15 15 12 12 12 12 12 15 9 1 1 1 0 0
0 18 9 1 1 1 15 15 15 15 15 1 4 4 9 9 18 0
18 15 15 9 9 1 1 1 1 1 1 4 9 9 9 15 15 18
18 15 9 18 1 1 1 1 1 1 1 1 9 9 15 9 15 18
0 18 18 18 1 4 4 4 4 4 4 1 1 9 9 18 18 0
0 0 18 18 1 1 4 4 4 4 1 1 1 4 18 18 0 0
0 0 0 18 1 1 1 1 1 1 1 1 1 4 18 0 0 0
0 0 0 18 1 1 18 18 18 18 18 1 1 1 18 0 0 0
0 0 0 0 18 18 18 0 0 0 0 18 18 18 0 0 0 0
---
0 0 0 0 0 1 1 1 1 1 1 1 1 1 0 0 0 0
0 0 0 1 1 18 18 18 18 18 18 18 18 18 1 0 0 0
0 0 1 18 18 18 18 18 18 18 18 18 18 18 18 1 0 0
0 0 1 18 18 1 1 1 1 1 1 18 18 18 18 1 0 0
0 0 1 18 1 15 15 15 15 15 12 1 18 18 18 1 0 0
0 0 1 1 1 15 9 9 9 15 12 1 1 1 1 1 0 0
0 0 1 1 1 15 9 9 9 15 12 4 4 4 4 4 0 0
0 0 1 18 1 15 12 12 12 12 4 4 18 18 18 4 0 0
0 0 1 18 18 1 1 4 4 4 18 18 18 18 18 4 0 0
0 0 0 1 18 18 18 18 18 18 18 18 18 4 4 4 0 0
0 15 3 18 18 18 18 18 18 18 18 18 18 18 18 18 15 0
15 3 3 3 3 18 18 18 18 18 18 18 18 18 18 18 18 15
15 3 3 15 9 18 18 18 18 18 18 18 18 18 18 18 18 15
0 15 15 15 9 14 14 14 14 14 14 14 14 18 18 15 15 0
0 0 15 15 9 9 14 14 14 14 14 14 14 18 15 15 0 0
0 0 0 15 9 9 9 9 9 9 9 9 9 18 15 0 0 0
0 0 0 15 9 9 15 15 15 15 15 9 9 9 15 0 0 0
0 0 0 0 15 15 15 0 0 0 0 15 15 15 0 0 0 0
