15 15 15 15 15 18 18 18 15 15 18 18 18 15 15 15 15 15
15 15 15 18 18 7 7 7 18 18 9 9 9 18 18 15 15 15
15 15 15 18 7 7 7 7 16 9 9 9 9 9 18 15 15 15
15 18 18 7 7 7 7 7 7 16 9 9 9 9 9 18 18 15
15 18 13 16 7 7 7 7 16 9 9 9 9 9 16 6 18 15
18 13 13 13 16 7 16 16 16 16 16 16 9 16 6 6 6 18
18 13 13 13 13 16 8 8 8 8 8 8 16 6 6 6 6 18
18 13 13 13 16 8 8 12 8 8 12 8 8 16 6 6 6 18
18 13 13 13 16 8 8 8 8 8 8 8 8 16 6 6 6 18
15 18 16 16 16 8 12 8 8 8 8 12 8 16 16 16 18 15
18 10 10 10 16 8 8 12 12 12 12 8 8 16 5 5 5 18
18 10 10 10 10 16 8 8 8 8 8 8 16 5 5 5 5 18
18 10 10 10 16 1 16 16 16 16 16 16 3 16 5 5 5 18
15 18 10 16 1 1 1 1 1 16 3 3 3 3 16 5 18 15
15 18 18 1 1 1 1 1 16 3 3 3 3 3 3 18 18 15
15 15 15 18 1 1 1 1 1 16 3 3 3 3 18 15 15 15
15 15 15 18 18 1 1 1 18 18 3 3 3 18 18 15 15 15
15 15 15 15 15 18 18 18 15 15 18 18 18 15 15 15 15 15
---
18 18 18 18 18 15 15 15 8 8 15 15 15 3 3 3 3 3
18 18 18 15 15 1 1 1 15 15 8 8 8 15 15 3 3 3
18 18 18 15 1 1 1 1 18 8 8 8 8 8 15 3 3 3
18 15 15 1 1 1 1 1 1 18 8 8 8 8 8 15 15 3
18 15 6 18 1 1 1 1 18 8 8 8 8 8 18 10 15 3
15 6 6 6 18 1 18 18 18 18 18 18 8 18 10 10 10 15
15 6 6 6 6 18 16 16 16 16 16 16 18 10 10 10 10 15
15 6 6 6 18 16 16 3 16 16 3 16 16 18 10 10 10 15
15 6 6 6 18 16 16 16 16 16 16 16 16 18 18 15 15 15
13 15 18 18 18 16 16 16 16 16 16 16 16 18 18 18 15 1
15 5 5 5 18 16 16 16 16 16 16 16 16 18 12 12 12 15
15 5 5 5 5 18 16 16 16 16 16 16 18 12 12 12 12 15
15 5 5 5 18 9 18 18 18 18 18 18 7 18 3 12 3 15
8 15 5 18 9 9 9 9 9 18 7 7 7 7 18 3 15 13
8 15 15 9 9 9 9 9 18 7 7 7 7 7 7 15 15 13
8 8 8 15 9 9 9 9 9 18 7 7 7 7 15 13 13 13
8 8 8 15 15 9 9 9 15 15 7 7 7 15 15 13 13 13
8 8 8 8 8 15 15 15 8 8 15 15 15 13 13 13 13 13
