1 1 1 1 1 1 1 1 1 1 1 1 1 1 1 1 1 1
1 1 9 1 1 1 16 16 16 1 16 16 16 1 1 1 9 1
1 9 3 9 1 16 14 7 7 16 16 14 14 16 1 1 1 1
1 3 9 3 3 16 14 7 16 14 14 10 14 16 1 1 1 1
3 3 3 3 3 16 14 7 16 14 10 10 14 16 1 1 1 3
3 3 3 16 16 14 14 16 16 14 10 14 16 16 1 1 9 3
9 3 16 14 14 14 14 14 14 14 16 16 16 3 3 9 3 9
3 3 16 14 14 14 14 14 14 14 14 16 3 3 3 3 9 3
3 16 14 14 14 14 16 14 14 14 14 16 16 16 3 3 3 3
3 16 10 14 14 14 10 10 14 14 14 14 14 16 16 3 16 3
3 16 14 14 14 14 14 14 14 14 14 14 14 14 14 16 14 16
3 3 16 14 14 14 14 14 7 14 14 14 14 14 14 16 14 7
3 3 3 16 16 14 7 7 14 14 14 14 14 14 14 7 7 16
3 3 3 3 3 16 14 14 14 7 7 7 14 14 14 16 16 3
3 5 3 3 5 16 7 14 7 14 14 14 14 7 7 16 3 5
5 6 5 6 6 16 7 7 16 7 7 7 7 7 16 16 6 6
6 5 6 6 6 6 16 16 5 16 16 16 16 16 16 6 5 6
6 6 6 5 5 5 6 6 6 6 6 6 5 5 6 5 6 5
---
14 14 14 14 14 14 14 14 14 14 14 14 14 14 14 14 14 14
14 14 7 14 14 14 14 14 14 14 14 14 14 14 14 14 10 14
14 7 1 7 14 14 16 6 6 14 14 16 16 14 14 14 14 14
14 1 7 1 1 14 16 6 6 16 16 6 16 14 14 14 14 14
1 1 1 1 1 14 16 6 6 16 6 6 16 14 14 14 14 7
1 1 1 14 14 16 16 6 6 16 6 16 14 14 14 14 6 7
10 1 14 16 16 16 16 16 16 16 14 14 14 7 7 6 7 6
1 1 14 16 16 16 16 16 16 16 16 14 7 7 7 7 6 7
1 14 16 16 16 16 14 16 16 16 16 14 14 14 7 7 7 7
1 14 9 16 16 16 9 9 16 16 16 16 16 14 14 7 14 7
1 14 16 16 16 16 16 16 16 16 16 3 3 3 3 14 16 14
1 1 14 16 16 16 16 16 6 3 3 3 3 3 3 14 16 10
1 1 1 14 14 16 6 6 3 3 3 3 3 3 3 10 10 14
1 1 1 1 1 14 3 3 3 5 5 5 3 3 3 14 14 6
1 7 1 1 10 14 5 3 5 3 3 3 3 5 5 14 6 5
7 3 7 3 1 1 5 5 1 5 5 5 5 5 1 1 9 9
3 7 3 3 3 3 1 1 10 1 1 1 1 1 1 9 9 9
3 3 3 3 3 3 3 3 3 3 3 3 6 6 9 3 9 3
