0 0 0 0 0 0 16 16 16 16 16 16 16 16 0 0 0 0 0 0
0 0 0 0 16 16 15 15 15 14 14 14 14 14 16 0 0 0 0 0
0 0 0 16 15 14 14 15 14 14 14 14 14 14 14 16 0 0 0 0
0 0 0 16 15 15 15 15 15 15 15 15 15 14 14 14 16 0 0 0
0 0 16 15 15 15 16 16 15 15 15 15 15 16 16 14 16 0 0 0
0 0 16 15 15 15 16 16 15 16 16 16 15 16 16 14 16 0 0 0
0 0 16 15 15 15 15 15 16 9 9 9 16 15 15 14 16 0 0 0
0 0 16 15 15 15 15 16 16 16 16 16 16 16 15 14 16 0 0 0
0 16 15 15 15 15 15 16 9 9 9 9 9 16 15 15 16 16 0 0
16 15 15 15 16 15 15 15 16 16 16 16 16 15 15 15 15 14 16 0
16 15 15 16 15 15 15 15 15 15 15 15 15 15 15 15 15 15 14 16
16 15 15 16 18 18 18 18 18 18 18 18 15 15 15 15 16 15 14 16
0 16 15 16 2 2 14 14 14 14 14 18 15 15 15 15 16 16 14 16
0 0 16 16 18 18 14 14 14 18 18 15 15 15 15 15 16 16 16 0
0 0 16 15 15 15 18 18 18 15 15 15 15 15 15 16 16 0 0 0
0 0 0 16 9 9 15 15 15 15 15 15 15 9 9 9 16 0 0 0
0 0 0 16 16 9 9 16 16 16 16 16 16 9 9 16 16 0 0 0
0 0 0 0 16 16 16 0 0 0 0 0 16 16 16 16 0 0 0 0
---
0 0 0 0 0 0 15 15 15 15 15 15 15 15 0 0 0 0 0 0
0 0 0 0 15 15 16 16 16 15 15 15 15 15 15 0 0 0 0 0
0 0 0 15 16 2 2 16 15 15 15 15 15 15 15 15 0 0 0 0
0 0 0 15 16 16 16 16 16 16 16 16 16 15 15 15 15 0 0 0
0 0 15 16 16 16 14 14 16 16 16 16 16 14 14 15 15 0 0 0
0 0 15 16 16 16 14 14 16 14 14 14 16 14 14 15 15 0 0 0
0 0 15 16 16 16 16 16 14 16 16 16 14 16 16 15 15 0 0 0
0 0 15 16 16 16 16 14 14 14 14 14 14 14 16 15 15 0 0 0
0 15 16 16 16 16 16 14 16 16 16 16 16 14 16 16 15 15 0 0
15 16 16 16 15 16 16 16 14 14 14 14 14 14 14 14 14 16 15 0
15 16 16 15 16 16 16 16 16 16 16 16 16 14 14 9 9 9 16 15
15 16 16 15 15 15 15 15 15 15 15 15 9 9 9 9 15 9 16 15
0 15 16 15 15 15 16 16 16 16 16 15 9 9 9 9 15 15 16 15
0 0 15 15 15 15 16 16 16 15 15 9 9 9 9 9 15 15 15 0
0 0 15 18 18 18 15 15 15 18 18 18 18 18 18 15 15 0 0 0
0 0 0 15 16 16 18 18 18 18 18 18 18 16 16 16 15 0 0 0
0 0 0 15 15 16 16 15 15 15 15 15 15 16 16 15 15 0 0 0
0 0 0 0 15 15 15 0 0 0 0 0 15 15 15 15 0 0 0 0
