0 0 18 18 0 0 0 0 0 0 18 18 0 0
0 18 14 14 18 18 18 18 18 18 14 14 18 0
0 18 14 14 14 14 14 14 14 14 14 14 18 0
0 18 14 14 8 8 8 8 8 8 14 14 18 0
0 18 14 8 8 18 8 8 18 8 8 14 18 0
0 18 14 8 8 18 8 8 18 8 8 14 18 0
0 18 14 14 8 8 8 8 8 8 14 14 18 0
18 5 5 14 14 14 14 14 14 14 14 5 5 18
18 14 5 3 3 3 3 3 3 3 3 5 14 18
18 14 5 3 3 3 3 3 3 3 3 5 14 18
18 14 5 3 3 3 3 3 3 3 3 5 14 18
0 18 1 1 1 1 1 1 1 1 1 1 18 0
0 18 1 1 1 18 18 18 18 1 1 1 18 0
0 0 18 18 18 0 0 0 0 18 18 18 0 0
---
0 0 3 3 0 0 0 0 0 0 3 3 0 0
0 3 5 5 3 3 3 3 3 3 5 5 3 0
0 3 1 1 5 5 5 5 5 5 1 1 3 0
0 3 3 3 1 1 1 1 1 1 3 3 3 0
0 3 18 1 14 14 1 1 14 14 1 18 3 0
0 3 18 14 14 14 1 1 14 14 14 18 3 0
0 8 18 18 14 14 14 14 14 14 18 18 8 0
8 18 18 18 18 18 18 18 18 18 18 18 18 8
8 18 18 14 14 14 14 14 14 14 14 18 18 8
8 18 18 14 14 14 14 14 14 14 14 18 18 8
8 18 18 14 14 14 14 14 14 14 14 18 18 8
0 8 18 18 18 18 18 18 18 18 18 18 8 0
0 8 18 18 18 8 8 8 8 18 18 18 8 0
0 0 8 8 8 0 0 0 0 8 8 8 0 0
