0 0 0 0 0 0 0 18 18 18 0 0 0 0 0 0 0
0 0 0 0 0 0 18 7 10 10 18 0 0 0 0 0 0
0 0 0 0 18 18 7 18 18 18 10 18 18 0 0 0 0
0 0 0 18 10 10 10 10 10 10 10 10 10 18 0 0 0
0 0 18 10 7 7 7 7 7 7 7 7 7 10 18 0 0
0 0 18 10 10 7 7 3 3 3 7 7 10 10 18 0 0
0 0 18 12 10 10 7 1 1 1 7 10 10 12 18 0 0
0 0 18 10 12 10 10 10 7 10 10 10 12 10 18 0 0
0 18 3 7 10 12 10 14 14 14 10 12 10 7 3 18 0
18 15 3 7 7 10 12 7 7 7 12 10 7 7 3 15 18
18 15 1 10 10 10 10 10 10 10 10 10 10 10 1 15 18
18 1 1 10 15 1 15 1 15 1 15 1 15 10 1 1 18
18 15 1 10 1 15 1 15 1 15 1 15 1 10 1 15 18
18 1 1 10 1 1 7 1 1 1 1 1 1 10 1 1 18
18 15 1 10 1 1 10 1 1 1 1 1 1 10 1 15 18
18 1 1 10 1 1 1 1 1 1 1 1 1 10 1 1 18
0 18 12 12 12 12 12 12 12 12 12 12 12 12 12 18 0
0 0 18 18 18 18 18 18 18 18 18 18 18 18 18 0 0
---
0 0 0 0 0 0 0 12 12 12 0 0 0 0 0 0 0
0 0 0 0 0 0 12 18 15 15 12 0 0 0 0 0 0
0 0 0 0 12 12 18 12 12 12 15 12 12 0 0 0 0
0 0 0 12 15 15 15 15 15 15 15 15 15 12 0 0 0
0 0 12 1 18 18 18 18 18 18 18 18 18 14 12 0 0
0 0 12 1 1 18 18 12 12 12 18 18 14 14 12 0 0
0 0 7 18 1 1 18 18 18 18 18 1 1 18 7 0 0
0 0 7 1 18 1 1 1 18 1 1 1 18 1 7 0 0
0 7 18 18 1 18 1 18 18 18 1 18 1 15 15 7 0
7 18 18 18 18 1 18 18 18 18 18 1 15 15 15 10 7
7 18 18 1 1 1 1 1 1 1 1 1 1 1 10 10 7
7 18 18 1 10 10 10 10 10 10 10 10 10 1 10 10 7
7 18 18 1 10 10 10 10 10 10 10 10 10 1 10 10 7
7 18 18 1 10 10 10 10 10 10 10 10 10 1 10 10 7
7 18 18 1 10 10 10 10 10 10 10 10 10 1 10 10 7
7 18 18 1 10 10 10 10 10 10 10 10 10 1 10 10 7
0 7 1 1 1 1 1 1 1 1 1 1 1 1 1 7 0
0 0 7 7 7 3 3 3 3 3 3 3 7 7 7 0 0
