0 0 0 0 0 0 18 18 18 18 18 18 0 0 0 0 0 0
0 0 0 0 18 18 9 12 12 12 12 12 18 18 0 0 0 0
0 0 18 18 9 9 9 12 12 12 12 12 12 12 18 18 0 0
0 0 18 9 9 12 12 12 12 12 10 10 14 12 12 18 18 0
0 18 9 9 12 12 12 12 12 12 12 10 10 14 12 12 18 0
0 18 9 9 12 12 10 12 12 12 12 10 10 14 10 12 18 18
18 9 9 12 12 12 10 12 12 12 12 10 10 10 12 12 12 18
18 9 12 12 10 10 10 12 12 12 12 12 12 10 12 12 12 18
18 9 12 10 10 10 10 12 12 12 12 12 12 12 12 12 12 18
18 12 12 12 12 10 10 12 12 12 12 12 12 12 12 12 12 18
18 12 12 12 10 10 10 10 12 12 12 12 12 10 10 12 12 18
18 9 12 12 10 10 10 10 10 10 12 12 12 10 10 12 12 18
0 18 9 12 12 10 10 10 10 10 10 10 10 12 12 12 9 18
0 18 9 12 12 12 10 10 10 10 10 10 10 12 12 9 18 0
0 0 18 12 9 12 12 10 10 10 10 10 12 12 12 9 18 0
0 0 18 9 9 9 12 12 12 12 12 12 12 12 9 18 0 0
0 0 0 18 18 9 9 9 9 9 9 9 9 18 18 0 0 0
0 0 0 0 0 18 18 18 18 18 18 18 18 0 0 0 0 0
---
0 0 0 0 0 0 12 12 12 12 12 12 0 0 0 0 0 0
0 0 0 0 12 12 12 9 9 9 10 10 12 12 0 0 0 0
0 0 12 12 12 12 12 9 9 9 10 10 10 10 12 12 0 0
0 0 12 12 12 18 9 9 9 9 12 12 12 10 10 12 12 0
0 12 12 12 18 18 9 9 9 9 10 12 12 12 10 10 12 0
0 12 12 12 18 18 12 9 9 9 10 12 12 12 12 10 12 12
12 12 12 18 18 18 12 9 9 9 10 12 12 12 10 10 10 12
12 12 18 18 12 12 12 9 9 9 9 10 10 12 10 10 10 12
12 12 18 12 12 12 12 9 9 9 9 10 10 10 10 10 10 12
12 18 18 18 18 12 12 9 9 9 14 18 18 18 10 10 10 12
10 18 18 18 12 12 12 12 9 9 14 18 18 12 12 18 10 10
10 12 18 18 12 12 12 12 12 12 14 18 18 12 12 18 18 10
0 10 12 18 18 12 12 12 12 12 12 12 12 18 18 18 12 10
0 10 12 18 18 18 12 12 12 12 12 12 12 18 18 12 10 0
0 0 10 18 12 18 18 12 12 12 12 12 18 18 18 12 10 0
0 0 10 12 12 12 18 18 18 18 18 18 18 18 12 10 0 0
0 0 0 10 10 12 12 12 12 12 12 12 12 10 10 0 0 0
0 0 0 0 0 10 10 10 10 10 10 10 10 0 0 0 0 0
