1 1 1 1 1 16 16 16 1 1 1 1
1 1 1 1 16 9 14 14 16 1 1 1
1 1 16 16 9 9 15 15 14 16 1 1
1 16 15 15 9 9 9 15 9 14 16 1
16 15 15 15 15 15 9 9 15 15 14 16
15 15 15 4 4 15 15 15 15 15 4 14
15 9 15 15 4 15 13 13 13 15 4 15
15 9 15 15 15 13 13 13 13 13 15 9
9 9 9 15 15 15 13 13 13 15 15 9
9 9 9 9 15 15 15 15 15 15 9 9
16 16 9 9 9 9 9 9 9 9 9 16
1 16 16 16 16 16 16 16 16 16 16 1
---
16 16 16 16 16 15 15 15 13 13 13 13
16 16 16 16 15 15 16 4 15 13 13 13
16 16 15 15 15 15 16 16 4 15 13 13
16 15 9 9 15 15 15 16 14 4 15 13
15 9 9 9 9 9 15 14 16 16 4 15
9 9 9 14 14 9 16 16 16 16 16 4
9 15 9 9 14 16 1 1 1 16 13 9
9 15 9 9 9 1 1 1 1 15 9 15
15 15 15 9 9 9 1 1 1 9 9 15
15 15 15 15 9 9 9 9 9 9 15 15
1 1 15 15 15 15 15 15 15 15 15 1
1 1 1 1 1 1 1 1 1 1 1 14
