0 0 0 0 0 0 0 0 0 17 0 0 0 0 0 0 0 0
0 0 0 0 0 0 0 0 17 6 17 0 0 0 0 0 0 0
0 0 0 0 0 0 0 0 17 5 6 17 0 0 0 0 0 0
0 0 0 0 0 0 17 0 17 5 5 6 17 0 0 0 0 0
0 0 0 0 0 17 6 17 5 17 5 6 17 0 0 0 0 0
0 0 0 0 0 17 5 6 5 5 5 6 17 17 0 0 0 0
0 0 0 0 17 5 5 6 16 16 5 5 5 5 17 0 0 0
0 0 0 17 5 5 16 16 12 12 16 16 5 5 17 0 0 0
0 0 0 17 5 16 12 14 14 14 7 12 16 5 17 0 0 0
0 17 0 0 16 12 14 14 14 14 14 7 12 16 17 0 0 0
17 6 17 16 12 14 14 14 18 14 14 14 7 12 16 0 17 0
17 5 16 12 14 14 14 14 14 14 14 14 14 7 12 16 6 17
17 5 16 12 14 14 18 14 14 14 18 14 14 14 7 16 5 17
0 16 12 14 14 14 14 14 14 14 14 14 14 14 7 12 16 17
0 16 12 14 18 14 14 14 18 14 14 14 18 14 7 12 16 0
0 16 12 14 14 14 14 14 14 14 14 14 14 14 7 12 16 0
0 16 12 14 14 14 18 14 14 14 18 14 14 14 7 12 16 0
0 0 16 12 14 14 14 14 14 14 14 14 14 7 12 16 0 0
0 0 16 12 12 7 14 14 18 14 14 14 7 12 12 16 0 0
0 0 0 16 12 12 7 7 7 7 7 7 12 12 16 0 0 0
0 0 0 0 16 16 12 12 12 12 12 12 16 16 0 0 0 0
0 0 0 0 0 0 16 16 16 16 16 16 0 0 0 0 0 0
---
0 0 0 0 0 0 0 0 0 14 0 0 0 0 0 0 0 0
0 0 0 0 0 0 0 0 14 12 14 0 0 0 0 0 0 0
0 0 0 0 0 0 0 0 14 14 12 14 0 0 0 0 0 0
0 0 0 0 0 0 14 0 14 14 14 12 14 0 0 0 0 0
0 0 0 0 0 14 12 14 14 14 14 12 14 0 0 0 0 0
0 0 0 0 0 14 12 12 14 14 14 12 14 14 0 0 0 0
0 0 0 0 14 12 12 12 14 14 14 14 14 14 14 0 0 0
0 0 0 14 12 12 14 14 17 17 14 14 14 5 14 0 0 0
0 0 0 14 12 14 17 16 16 16 5 5 14 5 14 0 0 0
0 14 0 0 14 17 16 16 16 16 16 5 5 14 14 0 0 0
14 6 14 14 17 16 16 16 6 16 16 16 5 5 14 0 14 0
14 12 14 17 7 7 16 16 16 16 16 16 12 5 5 14 12 14
14 12 14 17 7 7 6 16 16 16 6 12 12 12 5 14 12 14
0 14 17 7 7 7 16 16 16 16 16 12 12 12 5 17 14 14
0 14 17 7 6 7 16 16 6 16 16 12 6 12 5 17 14 0
0 14 17 7 7 7 16 16 16 16 16 12 12 12 5 17 14 0
0 14 17 7 7 7 6 16 16 16 6 12 12 12 5 17 14 0
0 0 14 17 7 7 7 18 18 18 18 12 12 5 17 14 0 0
0 0 14 17 17 5 18 18 6 18 18 18 5 17 17 14 0 0
0 0 0 14 17 17 5 5 5 5 5 5 17 17 14 0 0 0
0 0 0 0 14 14 17 17 17 17 17 17 14 14 0 0 0 0
0 0 0 0 0 0 14 14 14 14 14 14 0 0 0 0 0 0
