18 18 18 18 18 18 18 18 18 18 18 18 18 18 18 18 0 0 0
18 14 14 14 14 14 14 14 14 14 14 14 14 14 14 18 0 0 0
18 14 14 14 14 14 14 14 14 14 14 14 14 14 18 18 18 0 0
18 14 14 14 14 14 14 14 14 14 14 14 14 18 11 10 10 18 0
18 14 14 14 14 14 14 14 14 14 14 14 18 18 18 18 18 18 18
18 8 14 14 14 14 14 14 14 14 14 18 18 9 9 15 15 15 18
18 8 8 14 14 14 14 14 14 14 18 9 18 18 18 18 18 18 18
18 8 8 8 14 14 14 14 14 14 18 9 9 18 11 10 10 18 0
18 8 8 8 8 14 14 14 14 14 18 9 18 18 11 10 10 18 0
18 8 8 8 8 8 14 14 14 14 18 9 18 18 11 10 10 18 0
18 8 8 8 8 8 8 14 14 14 18 9 18 18 11 10 10 18 0
18 8 8 8 8 8 8 8 14 14 18 9 18 18 11 10 10 18 0
18 8 8 8 8 8 8 8 8 14 18 18 14 18 11 10 10 18 0
18 8 8 8 8 8 8 8 8 8 14 14 14 18 11 10 10 18 0
18 18 18 18 18 8 8 8 8 8 8 14 14 18 18 18 18 18 0
18 19 19 19 18 8 8 8 8 8 8 8 18 9 9 15 15 15 18
0 18 19 19 18 8 8 8 8 8 8 8 8 18 18 18 18 18 0
0 0 18 19 18 8 8 8 8 8 8 8 8 18 11 10 10 18 0
0 0 0 18 18 18 18 18 18 18 18 18 18 18 11 10 10 18 0
0 0 0 0 0 0 0 0 0 0 0 0 0 18 11 10 10 18 0
0 0 0 0 0 0 0 0 0 0 0 0 0 0 18 18 18 0 0
0 0 0 0 0 0 0 0 0 0 0 0 0 0 0 18 0 0 0
---
14 14 14 14 14 14 14 14 14 14 14 14 14 14 14 14 0 0 0
14 8 8 8 8 8 8 8 8 8 8 8 8 8 8 14 0 0 0
14 8 8 8 8 8 8 8 8 8 8 8 8 8 8 8 8 0 0
14 8 8 8 8 8 8 8 8 8 8 8 8 8 18 18 18 8 0
14 8 8 8 8 8 8 8 11 11 11 11 8 8 8 8 8 8 8
14 18 10 10 11 11 11 11 11 11 11 8 8 18 18 18 18 18 8
14 18 18 10 10 10 10 10 10 10 8 18 8 8 8 8 8 8 8
14 18 18 18 10 10 10 10 10 10 8 18 18 14 18 18 18 14 0
14 18 18 18 18 10 10 10 10 9 8 18 14 14 18 18 18 14 0
14 18 18 18 18 18 9 9 9 9 8 18 14 14 18 18 18 14 0
14 18 18 18 18 18 18 9 9 9 8 18 14 14 18 18 18 14 0
14 18 18 18 18 18 18 18 9 9 8 18 14 14 18 18 18 14 0
14 18 18 18 18 18 18 18 18 9 14 14 19 14 18 18 18 14 0
14 18 18 18 18 18 18 18 18 18 19 19 19 14 18 18 18 14 0
14 14 14 14 14 18 18 18 18 18 18 19 19 14 14 14 14 14 0
14 15 15 15 14 18 18 18 18 18 18 18 14 18 18 18 18 18 14
0 14 15 15 14 18 18 18 18 18 18 18 18 14 14 14 14 14 0
0 0 14 15 14 18 18 18 18 18 18 18 18 14 10 18 18 14 0
0 0 0 14 14 14 14 14 14 14 14 14 14 14 10 18 18 14 0
0 0 0 0 0 0 0 0 0 0 0 0 0 14 10 18 18 14 0
0 0 0 0 0 0 0 0 0 0 0 0 0 0 14 14 14 0 0
0 0 0 0 0 0 0 0 0 0 0 0 0 0 0 14 0 0 0
