0 0 0 17 17 17 17 17 17 0 0 0 0 0 0 0 0
0 0 17 5 5 6 6 6 17 17 0 0 0 0 0 0 0
0 0 17 5 6 6 16 6 6 17 0 0 0 0 0 0 0
0 17 5 6 6 6 16 6 6 17 0 0 0 0 0 0 0
0 17 5 6 9 6 6 6 6 17 0 0 0 0 0 0 0
17 5 6 9 6 6 5 5 17 0 0 0 0 0 0 0 0
17 5 6 6 5 5 17 17 0 0 0 0 0 0 0 0 0
17 5 6 6 5 0 0 0 0 0 0 0 0 0 0 0 0
17 5 6 6 6 17 0 0 0 0 0 0 0 0 0 0 0
17 5 6 6 6 17 17 17 17 17 17 17 0 0 0 0 0
17 5 6 6 6 6 9 9 6 9 9 6 17 0 0 0 0
17 17 5 6 6 9 9 6 9 6 6 9 17 0 0 0 0
0 17 5 6 6 6 6 6 6 6 6 6 5 17 0 0 0
0 17 5 6 6 6 6 6 6 6 6 6 6 17 17 0 0
0 0 17 6 6 6 6 6 6 6 6 6 6 5 17 17 17
0 0 17 5 6 17 6 6 17 5 6 17 6 6 5 5 17
0 0 17 5 2 17 2 2 17 5 5 17 2 2 17 17 0
0 0 0 17 2 17 2 2 17 17 17 17 2 17 0 0 0
0 0 0 17 17 17 17 17 17 0 17 17 17 17 0 0 0
---
0 0 0 6 6 6 6 6 6 0 0 0 0 0 0 0 0
0 0 6 17 17 17 17 17 6 6 0 0 0 0 0 0 0
0 0 6 17 17 17 17 17 17 6 0 0 0 0 0 0 0
0 6 17 17 17 17 2 17 17 6 0 0 0 0 0 0 0
0 6 17 17 16 17 17 17 17 6 0 0 0 0 0 0 0
6 17 17 16 17 17 2 2 6 0 0 0 0 0 0 0 0
6 17 17 17 2 2 6 6 0 0 0 0 0 0 0 0 0
6 17 17 17 2 0 0 0 0 0 0 0 0 0 0 0 0
6 17 17 17 17 6 0 0 0 0 0 0 0 0 0 0 0
6 17 17 17 17 6 6 6 6 6 6 6 0 0 0 0 0
6 17 17 17 17 17 17 17 5 17 17 5 6 0 0 0 0
6 6 17 17 17 17 17 5 17 5 5 17 6 0 0 0 0
0 6 17 17 17 17 17 5 5 5 5 5 6 6 0 0 0
0 6 17 17 17 17 17 5 5 5 5 5 5 6 6 0 0
0 0 6 17 17 17 5 5 5 5 5 5 5 9 6 6 6
0 0 6 17 17 6 5 5 6 2 5 6 5 5 9 9 6
0 0 6 17 6 6 9 9 6 2 2 6 9 9 6 6 0
0 0 0 6 6 6 9 9 6 6 6 6 9 6 0 0 0
0 0 0 6 6 6 6 6 6 0 6 6 6 6 0 0 0
