0 0 0 0 0 0 2 2 2 2 2 2 0 0
0 0 0 0 0 2 2 2 19 19 19 19 2 0
0 0 0 0 0 2 2 19 19 19 19 19 19 0
0 0 0 0 19 19 2 9 19 18 19 19 18 0
0 0 0 0 19 9 2 9 19 19 19 19 19 19
0 0 0 0 0 2 2 2 9 19 19 19 19 19
0 0 0 0 2 2 2 2 16 16 16 0 0 0
2 2 0 0 2 2 2 2 2 19 16 16 0 0
2 0 0 2 2 2 9 2 2 9 16 16 0 0
2 0 0 2 2 9 9 2 2 0 16 16 0 0
0 2 2 2 2 0 16 16 2 2 0 16 16 0
0 0 0 2 2 0 16 9 2 2 9 16 16 0
---
0 0 0 0 0 0 9 9 9 9 9 9 0 0
0 0 0 0 0 9 9 9 2 2 2 2 9 0
0 0 0 0 0 16 16 2 2 2 2 2 2 0
0 0 0 0 2 2 16 16 2 16 2 2 16 0
0 0 0 0 2 16 16 16 2 2 2 2 2 2
0 0 0 0 0 16 16 16 16 2 2 2 2 2
0 0 0 0 19 19 16 16 2 2 2 0 0 0
18 18 0 0 19 19 19 19 19 16 2 2 0 0
19 0 0 19 19 19 2 19 19 2 2 2 0 0
19 0 0 19 19 2 2 19 19 0 2 2 0 0
0 19 19 19 19 0 2 2 19 19 0 2 2 0
0 0 0 19 19 0 2 2 19 19 2 2 2 0
