0 0 0 0 0 0 0 0 0 0 0 0 0 0 0 18 18 18 18 18 0 0 0 0 0 0 0 0 0 0 0 0 0 0 0 0 0 0 0 0
0 0 0 0 0 0 0 0 0 18 18 18 0 18 18 1 14 14 14 14 18 18 0 0 0 0 0 0 0 0 0 0 0 0 0 0 0 0 0 0
0 0 0 0 0 0 0 0 18 15 15 15 18 1 1 1 1 14 14 14 14 14 18 0 0 0 0 0 0 0 0 0 0 0 0 0 0 0 0 0
0 0 0 0 0 0 0 0 18 15 15 9 18 1 1 1 1 1 14 14 14 14 14 18 0 0 0 0 0 0 0 0 0 0 0 0 0 0 0 0
0 0 0 0 0 0 0 0 18 9 9 9 18 1 1 18 1 1 1 1 1 14 14 14 18 0 0 0 0 0 0 0 0 0 0 0 0 0 0 0
0 0 0 0 0 0 0 0 0 18 18 18 0 18 18 14 1 1 1 1 1 14 14 14 18 0 0 0 0 0 0 0 0 0 0 0 0 0 0 0
0 0 0 0 0 0 0 0 0 0 0 0 0 0 18 14 1 1 1 1 1 1 1 1 1 18 18 18 0 0 0 0 0 0 0 0 0 0 0 0
0 0 0 0 0 0 0 0 0 0 0 0 0 18 14 1 1 1 1 1 1 1 1 1 1 18 15 15 18 0 0 0 0 0 0 0 0 0 0 0
0 0 0 0 0 0 0 0 0 0 0 0 0 18 1 14 14 14 1 1 1 1 1 1 18 15 15 9 18 0 0 0 0 0 0 0 0 0 0 0
0 0 0 0 0 0 0 0 0 18 18 18 18 1 1 14 14 14 14 1 1 1 18 18 15 15 9 9 18 18 18 0 0 0 0 0 0 0 0 0
0 0 0 0 0 0 0 0 18 14 7 12 18 1 1 1 14 14 14 18 18 18 15 15 9 9 18 18 12 7 14 18 0 0 0 0 0 0 0 0
0 0 0 0 0 0 0 0 18 7 7 18 9 18 18 18 18 18 18 15 15 15 9 9 18 18 12 12 7 7 7 18 0 0 0 0 0 0 0 0
0 0 0 0 0 18 18 18 7 7 7 18 9 9 9 9 9 15 15 15 9 18 18 18 12 12 7 7 14 7 7 7 18 18 18 0 0 0 0 0
0 0 0 0 18 14 14 7 7 14 7 7 18 18 18 18 18 18 18 18 18 12 12 12 7 7 7 7 7 7 7 7 7 14 14 18 0 0 0 0
0 0 0 18 14 7 7 7 7 7 7 7 7 7 7 7 12 18 12 12 12 12 18 12 7 7 7 7 7 7 7 7 7 7 7 14 18 0 0 0
0 0 18 14 7 7 7 7 7 12 7 7 7 12 12 12 18 7 18 18 18 18 7 18 12 12 12 7 7 7 12 7 7 7 7 7 14 18 0 0
0 0 18 7 7 7 7 7 7 18 12 12 12 18 18 18 7 7 7 7 7 7 7 7 18 18 18 12 12 12 18 7 7 7 14 7 7 18 0 0
0 0 18 7 7 7 7 7 7 12 18 18 18 7 7 7 14 14 14 14 14 14 14 14 7 7 7 18 18 18 12 7 7 7 7 7 7 18 0 0
0 0 18 7 7 7 7 7 7 12 18 7 7 14 14 14 14 14 14 14 14 14 14 14 14 14 14 7 7 18 12 7 7 7 7 7 7 18 0 0
0 0 18 7 7 7 7 7 12 12 18 7 14 1 14 14 14 14 14 14 14 14 14 14 14 14 1 14 7 18 12 12 7 7 7 7 7 18 0 0
0 18 7 7 7 7 12 18 18 18 7 14 14 1 14 14 14 14 14 14 14 14 14 14 14 14 1 14 14 7 18 18 18 12 7 7 7 7 18 0
18 7 7 7 7 7 7 12 18 7 14 14 1 1 1 14 14 14 14 14 14 14 14 14 14 1 1 1 14 14 7 18 12 7 7 7 7 7 7 18
18 7 7 7 7 7 7 12 18 7 14 14 1 1 1 14 14 14 18 18 18 18 14 14 14 1 1 1 14 14 7 18 12 7 7 7 7 7 7 18
18 12 7 7 7 7 7 12 18 7 14 14 18 18 18 14 14 18 13 7 13 13 18 14 14 18 18 18 14 14 7 18 12 7 7 7 7 7 12 18
18 12 7 7 7 7 7 18 7 14 14 18 1 1 14 18 14 18 13 13 13 13 18 14 18 14 1 1 18 14 7 7 18 7 7 7 7 7 12 18
18 12 12 7 7 7 12 18 7 14 14 7 18 7 14 14 14 18 13 13 13 13 18 14 14 14 7 18 7 14 14 7 18 12 7 7 7 12 12 18
0 18 12 12 12 12 12 18 7 14 7 7 7 7 7 14 14 14 18 18 18 18 14 14 14 7 7 7 7 7 14 7 18 12 12 12 12 12 18 0
0 18 12 12 12 12 12 18 7 14 7 7 7 7 7 14 18 18 12 12 12 12 18 18 14 7 7 7 7 7 14 7 18 12 12 12 12 12 18 0
0 0 18 12 12 12 12 12 18 7 14 7 7 7 14 14 18 12 12 12 12 12 12 18 14 14 7 7 7 14 7 18 12 12 12 12 12 18 0 0
0 0 18 12 12 12 12 12 18 7 14 14 14 14 14 14 18 12 7 7 7 7 12 18 14 14 14 14 14 14 7 18 12 12 12 12 12 18 0 0
0 0 0 18 12 12 12 12 12 18 7 14 14 14 14 14 14 18 7 7 7 7 18 14 14 14 14 14 14 7 18 12 12 12 12 12 18 0 0 0
0 0 0 0 18 18 12 18 18 14 18 7 7 14 14 14 14 14 18 18 18 18 14 14 14 14 14 7 7 18 14 18 18 12 18 18 0 0 0 0
0 0 0 0 0 0 18 14 18 14 14 18 18 7 7 7 18 18 7 7 7 7 18 18 7 7 7 18 18 14 14 18 14 18 0 0 0 0 0 0
0 0 0 0 0 0 18 14 14 18 18 14 14 18 18 18 1 1 18 18 18 18 1 1 18 18 18 14 14 18 18 14 14 18 0 0 0 0 0 0
0 0 0 0 0 0 18 14 14 14 14 14 18 15 9 18 1 1 18 1 1 18 1 1 18 9 15 18 14 14 14 14 14 18 0 0 0 0 0 0
0 0 0 0 0 0 0 18 14 14 18 14 18 9 9 18 4 1 18 4 4 18 1 4 18 9 9 18 14 18 14 14 18 0 0 0 0 0 0 0
0 0 0 0 0 0 0 0 18 18 0 18 0 18 18 18 4 4 4 18 18 4 4 4 18 18 18 0 18 0 18 18 0 0 0 0 0 0 0 0
0 0 0 0 0 0 0 0 0 0 0 0 0 0 18 4 18 18 18 4 9 18 18 18 9 18 0 0 0 0 0 0 0 0 0 0 0 0 0 0
0 0 0 0 0 0 0 0 0 0 0 0 0 0 18 4 4 4 4 1 15 9 9 9 9 18 0 0 0 0 0 0 0 0 0 0 0 0 0 0
0 0 0 0 0 0 0 0 0 0 0 0 0 18 18 1 18 18 18 18 18 18 18 18 15 18 18 0 0 0 0 0 0 0 0 0 0 0 0 0
0 0 0 0 0 0 0 0 0 0 0 0 0 0 0 18 0 0 0 0 0 0 0 0 18 0 0 0 0 0 0 0 0 0 0 0 0 0 0 0
---
0 0 0 0 0 0 0 0 0 0 0 0 0 0 0 12 12 12 12 12 0 0 0 0 0 0 0 0 0 0 0 0 0 0 0 0 0 0 0 0
0 0 0 0 0 0 0 0 0 12 12 12 0 12 12 7 7 7 7 7 12 12 0 0 0 0 0 0 0 0 0 0 0 0 0 0 0 0 0 0
0 0 0 0 0 0 0 0 12 14 14 14 12 7 7 7 7 7 7 7 7 7 12 0 0 0 0 0 0 0 0 0 0 0 0 0 0 0 0 0
0 0 0 0 0 0 0 0 12 14 14 14 12 7 7 7 7 7 7 7 7 7 7 12 0 0 0 0 0 0 0 0 0 0 0 0 0 0 0 0
0 0 0 0 0 0 0 0 12 14 14 14 12 7 7 12 7 7 7 7 7 7 7 7 12 0 0 0 0 0 0 0 0 0 0 0 0 0 0 0
0 0 0 0 0 0 0 0 0 12 12 12 0 12 12 7 7 7 7 7 7 7 7 7 12 0 0 0 0 0 0 0 0 0 0 0 0 0 0 0
0 0 0 0 0 0 0 0 0 0 0 0 0 0 12 7 7 7 7 7 7 7 7 7 7 12 12 12 0 0 0 0 0 0 0 0 0 0 0 0
0 0 0 0 0 0 0 0 0 0 0 0 0 12 7 7 7 7 7 7 7 7 7 7 7 12 18 18 14 0 0 0 0 0 0 0 0 0 0 0
0 0 0 0 0 0 0 0 0 0 0 0 0 12 7 7 7 7 7 7 7 7 7 7 12 18 18 18 14 0 0 0 0 0 0 0 0 0 0 0
0 0 0 0 0 0 0 0 0 12 12 12 12 7 7 7 7 7 7 7 7 7 12 12 18 18 18 18 14 14 14 0 0 0 0 0 0 0 0 0
0 0 0 0 0 0 0 0 14 7 18 18 12 7 7 7 7 7 7 12 12 12 18 18 18 18 14 14 18 18 7 14 0 0 0 0 0 0 0 0
0 0 0 0 0 0 0 0 14 18 18 14 18 12 12 12 12 12 12 18 18 18 18 18 14 14 18 18 18 18 18 14 0 0 0 0 0 0 0 0
0 0 0 0 0 14 14 14 18 18 18 14 18 18 18 18 18 18 18 18 18 14 14 14 18 18 18 18 18 18 18 18 14 14 14 0 0 0 0 0
0 0 0 0 14 7 7 18 18 18 18 18 14 14 14 14 14 14 14 14 14 18 18 18 18 18 18 18 18 18 18 18 18 7 7 14 0 0 0 0
0 0 0 14 7 18 18 18 18 18 18 18 18 18 18 18 18 14 18 18 18 18 14 18 18 18 18 18 18 18 18 18 18 18 18 7 14 0 0 0
0 0 14 7 18 18 18 18 18 18 18 18 18 18 18 18 14 1 14 14 14 14 1 14 18 18 18 18 18 18 18 18 18 18 18 18 7 14 0 0
0 0 14 18 18 18 18 18 18 14 18 18 18 14 14 14 1 1 1 1 1 1 1 1 14 14 14 18 18 18 14 18 18 18 18 18 18 14 0 0
0 0 14 18 18 18 18 18 18 18 14 14 14 1 1 1 12 12 12 12 12 12 12 12 1 1 1 14 14 14 18 18 18 18 18 18 18 14 0 0
0 0 14 18 18 18 18 18 18 18 14 1 1 12 12 12 12 12 12 12 12 12 12 12 12 12 12 1 1 14 18 18 18 18 18 18 18 14 0 0
0 0 14 18 18 18 18 18 18 18 14 1 12 15 12 12 12 12 12 12 12 12 12 12 12 12 15 12 1 14 18 18 18 18 18 18 18 14 0 0
0 14 18 18 18 18 18 14 14 14 1 13 12 15 12 12 12 12 12 12 12 12 12 12 12 12 15 12 12 1 14 14 14 18 18 18 18 18 14 0
14 18 18 18 18 18 18 18 14 1 13 13 15 15 15 9 9 9 9 9 9 9 9 9 9 15 15 15 15 15 1 14 18 18 18 18 18 18 18 14
14 18 18 18 18 18 18 18 14 1 13 13 15 15 15 4 4 4 14 14 14 14 4 4 4 15 15 15 15 15 1 14 18 18 18 18 18 18 18 14
14 18 18 18 18 18 18 18 14 1 13 13 7 7 7 4 4 14 7 7 7 7 14 4 4 7 7 7 15 15 1 14 18 18 18 18 18 18 18 14
14 18 18 18 18 18 18 14 1 7 7 7 7 7 7 7 4 14 7 7 7 7 14 4 7 7 7 7 7 15 1 1 14 18 18 18 18 18 18 14
14 18 18 18 18 18 18 14 1 7 7 1 7 1 7 4 4 14 7 7 7 7 14 4 4 7 12 7 12 7 7 1 14 18 18 18 18 18 18 14
0 14 18 18 18 18 18 14 1 7 1 1 1 1 1 7 7 7 14 14 14 14 7 7 7 12 12 12 12 12 7 1 14 18 18 18 18 18 14 0
0 14 18 18 18 18 18 14 1 7 1 1 1 1 1 7 14 14 9 9 9 9 14 14 7 12 12 12 12 12 7 1 14 18 18 18 18 18 14 0
0 0 14 18 18 18 18 18 14 1 7 1 1 1 7 7 14 9 9 9 9 9 9 14 7 7 12 12 12 7 12 14 18 18 18 18 18 14 0 0
0 0 14 18 18 18 18 18 14 1 7 7 7 7 7 7 14 9 9 9 9 9 9 14 7 7 7 7 7 7 1 14 18 18 18 18 18 14 0 0
0 0 0 14 18 18 18 18 18 14 1 7 7 7 7 7 7 14 9 9 9 9 14 7 7 7 7 7 7 1 14 18 18 18 18 18 14 0 0 0
0 0 0 0 14 14 18 14 14 7 14 1 1 7 7 7 7 7 14 14 14 14 7 7 7 7 7 1 1 14 7 14 14 18 14 14 0 0 0 0
0 0 0 0 0 0 14 7 14 7 7 14 14 1 1 1 14 14 13 13 13 13 14 14 1 1 1 14 14 7 7 14 7 14 0 0 0 0 0 0
0 0 0 0 0 0 14 7 7 14 14 7 7 14 14 14 7 7 14 14 14 14 7 7 14 14 14 7 7 14 14 7 7 14 0 0 0 0 0 0
0 0 0 0 0 0 14 7 7 7 7 7 14 7 7 14 7 7 14 7 7 14 7 7 14 7 7 14 7 7 7 7 7 14 0 0 0 0 0 0
0 0 0 0 0 0 0 14 7 7 14 7 14 7 7 14 7 7 14 7 7 14 7 7 14 7 7 14 7 14 7 7 14 0 0 0 0 0 0 0
0 0 0 0 0 0 0 0 14 14 0 14 0 1 1 14 7 7 7 14 14 7 7 7 14 14 1 0 14 0 14 14 0 0 0 0 0 0 0 0
0 0 0 0 0 0 0 0 0 0 0 0 0 0 1 7 14 14 14 7 7 14 14 14 7 1 0 0 0 0 0 0 0 0 0 0 0 0 0 0
0 0 0 0 0 0 0 0 0 0 0 0 0 0 1 7 7 7 7 7 7 7 7 7 7 1 0 0 0 0 0 0 0 0 0 0 0 0 0 0
0 0 0 0 0 0 0 0 0 0 0 0 0 1 1 7 1 1 1 1 1 1 1 1 7 1 1 0 0 0 0 0 0 0 0 0 0 0 0 0
0 0 0 0 0 0 0 0 0 0 0 0 0 0 0 1 0 0 0 0 0 0 0 0 1 0 0 0 0 0 0 0 0 0 0 0 0 0 0 0
