0 0 0 0 0 16 16 0 0 0 0 0
0 0 16 16 16 5 5 16 16 16 0 0
0 16 16 6 6 5 5 6 6 16 16 0
16 13 13 6 6 6 6 6 6 13 13 16
16 13 13 13 6 6 6 6 13 13 13 16
16 13 13 13 13 6 6 13 13 13 13 16
16 13 13 15 13 13 13 13 13 15 13 16
0 16 13 13 13 13 15 13 13 13 16 0
0 16 13 13 15 13 13 13 15 13 16 0
0 0 16 13 13 13 15 13 13 16 0 0
0 0 0 16 13 13 13 13 16 0 0 0
0 0 0 0 16 16 16 16 0 0 0 0
---
0 0 0 0 0 13 13 0 0 0 0 0
0 0 13 13 13 13 13 13 13 13 0 0
0 13 13 13 13 13 13 13 13 13 13 0
13 5 5 13 13 13 13 13 13 15 15 13
13 5 5 16 13 13 13 13 16 15 15 13
13 16 16 16 16 13 13 16 16 16 15 13
13 16 16 13 16 16 16 16 16 13 15 13
0 13 16 16 16 16 13 16 16 16 13 0
0 6 16 16 13 16 16 16 13 16 6 0
0 0 6 6 16 16 13 16 6 6 0 0
0 0 0 6 6 6 6 6 6 0 0 0
0 0 0 0 6 6 6 6 0 0 0 0
