0 0 0 0 1 0 0 0 0 0 0 0 18 18 18 18 18 18 18 18 18 18 18 18
0 0 0 1 1 1 0 0 0 0 0 18 18 18 18 18 18 18 18 18 18 18 18 18
0 1 0 0 1 0 0 0 0 9 18 18 18 18 18 18 18 18 18 18 18 18 18 18
0 0 0 0 0 0 0 0 9 9 9 9 9 9 18 18 18 18 18 18 18 18 18 0
18 18 18 18 18 18 18 18 18 18 9 9 9 9 9 9 9 9 18 18 18 18 18 0
18 10 10 10 18 18 18 18 18 18 18 18 18 18 18 9 9 9 9 9 9 18 18 0
18 10 10 10 10 10 12 12 12 18 18 18 18 18 18 18 18 18 18 9 9 9 9 0
0 18 10 10 10 10 12 12 12 12 12 12 18 18 18 18 18 18 18 18 18 9 9 0
0 18 10 10 10 12 12 12 12 12 12 12 12 12 12 12 18 18 18 18 18 18 18 18
0 0 18 18 18 12 12 12 5 5 12 12 12 12 12 12 12 18 18 18 18 18 18 18
0 0 0 0 0 12 12 5 6 5 5 12 12 12 12 12 12 12 12 18 18 18 18 18
0 0 0 0 0 12 12 14 6 6 6 5 5 5 5 5 12 12 12 12 12 12 18 18
0 1 0 0 0 12 12 14 12 6 6 6 6 12 6 5 5 5 12 12 12 12 12 12
1 1 1 0 0 12 12 14 12 6 6 6 6 12 6 6 5 5 12 12 12 12 12 12
0 1 0 0 0 12 12 6 6 6 13 13 6 6 6 6 5 5 12 12 12 12 12 0
0 0 0 1 0 0 7 7 7 7 6 13 6 6 6 6 5 5 12 12 12 12 12 0
0 0 0 0 0 7 7 10 10 7 7 6 6 6 6 5 5 18 12 12 12 12 0 0
0 0 0 0 0 7 10 8 10 10 7 6 6 6 5 18 18 18 12 12 12 12 12 0
0 0 0 0 12 7 10 10 10 10 7 5 5 9 18 18 9 9 9 18 12 12 12 12
0 0 0 0 12 14 7 10 10 14 7 9 9 18 18 18 6 5 5 9 18 12 12 12
0 1 0 0 14 6 6 7 14 14 14 14 14 14 6 14 6 6 5 9 18 12 12 0
0 0 0 0 14 6 6 18 14 6 6 6 6 6 6 6 6 6 5 9 18 18 18 0
0 0 0 0 6 6 6 18 6 6 6 6 6 6 6 6 6 6 5 9 18 18 18 0
0 0 0 0 0 18 18 18 18 18 18 18 18 18 18 18 18 18 18 18 18 18 18 18
---
0 0 0 0 10 0 0 0 0 0 0 0 6 6 6 6 6 6 6 6 6 6 6 6
0 0 0 10 10 10 0 0 0 0 0 6 6 6 6 6 6 6 6 6 6 6 6 6
0 10 0 0 10 0 0 0 0 12 6 6 6 6 6 6 6 6 6 6 6 6 6 6
0 0 0 0 0 0 0 0 12 12 12 12 12 12 6 6 6 6 6 6 6 6 6 0
12 12 12 12 12 12 12 12 12 12 12 12 12 12 12 12 12 12 6 6 6 6 6 0
12 18 18 18 12 12 12 12 12 12 12 12 12 12 12 12 12 12 12 12 12 6 6 0
12 18 18 18 18 18 18 18 18 12 12 12 12 12 12 12 12 12 12 12 12 12 12 0
0 12 18 18 18 18 18 18 18 18 18 18 12 12 12 12 12 12 12 12 12 12 12 0
0 12 18 18 18 18 18 18 18 18 18 18 18 18 18 18 12 12 12 12 12 12 12 12
0 0 12 12 12 18 18 18 10 10 18 18 18 18 18 18 18 12 12 12 12 12 12 12
0 0 0 0 0 18 18 10 5 10 10 18 18 18 18 18 18 18 18 12 12 12 12 12
0 0 0 0 0 18 18 5 5 5 5 10 10 10 10 10 18 18 18 18 18 18 12 12
0 9 0 0 0 18 18 5 12 5 5 5 5 12 5 10 10 10 18 18 18 18 18 18
9 9 9 0 0 18 18 5 12 5 5 5 5 12 5 5 10 10 18 18 18 18 18 18
0 9 0 0 0 18 18 5 5 5 13 13 5 5 5 5 10 10 18 18 18 18 18 0
0 0 0 9 0 0 18 18 18 18 14 13 5 5 5 5 10 10 18 18 18 18 18 0
0 0 0 0 0 18 18 18 18 18 18 14 14 14 14 14 10 6 18 18 18 18 0 0
0 0 0 0 0 18 18 1 18 18 18 14 14 14 14 6 6 6 18 18 18 18 18 0
0 0 0 0 1 18 18 18 18 18 18 14 14 14 6 6 7 7 7 9 18 18 18 18
0 0 0 0 1 1 18 18 18 18 18 14 14 6 6 6 7 7 7 7 9 18 18 18
0 9 0 0 1 1 1 18 18 18 18 18 18 18 18 8 7 7 7 7 9 18 18 0
0 0 0 0 1 1 1 9 18 18 18 18 18 18 18 18 18 18 7 7 9 9 9 0
0 0 0 0 1 1 1 9 18 18 18 18 18 18 18 18 18 18 7 7 9 9 9 0
0 0 0 0 0 9 9 9 9 9 9 9 9 9 9 9 9 9 9 9 9 9 9 9
