0 0 0 0 18 18 18 18 18 18 18 18 18 18 18 0 0 0 0 0 0
0 0 0 18 14 1 14 14 1 1 1 1 1 1 1 18 0 0 0 0 0
0 0 18 14 1 18 18 18 18 18 18 18 18 1 1 1 18 0 0 0 0
0 18 14 1 18 11 11 11 11 11 11 11 11 18 1 1 1 18 0 0 0
0 18 14 1 18 11 11 11 11 11 11 11 11 11 18 1 1 18 0 0 0
0 18 14 1 18 8 8 8 8 8 8 8 11 11 18 1 1 18 0 0 0
0 18 14 1 18 8 8 8 8 18 18 18 8 11 18 1 1 18 0 0 0
0 18 14 1 18 18 18 18 8 8 8 8 8 11 18 1 1 18 0 0 0
0 18 1 1 18 8 18 8 8 8 18 8 8 11 18 1 1 18 0 0 0
0 18 1 1 18 8 8 8 8 8 8 8 8 11 18 1 1 18 0 0 0
0 18 1 1 18 8 8 8 12 12 12 8 8 11 18 1 1 18 0 0 0
18 18 1 1 18 8 8 8 8 8 8 8 8 11 18 1 1 18 18 18 18
18 3 18 18 18 8 8 8 8 8 8 8 11 11 18 18 18 18 13 13 18
18 3 13 14 13 18 18 18 18 18 18 18 18 18 18 13 14 13 3 3 18
18 3 11 11 18 3 3 4 4 4 4 3 3 3 3 18 11 11 3 3 18
18 3 11 18 14 18 3 13 3 3 13 3 3 3 18 14 18 11 3 3 18
18 13 18 18 11 18 3 3 3 3 3 3 3 3 18 11 18 18 3 3 18
18 18 0 18 14 18 1 1 1 1 1 1 1 1 18 14 18 0 18 18 0
0 0 0 0 18 18 14 14 14 14 14 14 14 18 18 18 0 0 0 0 0
0 0 0 0 0 18 11 14 14 14 14 14 11 18 0 0 0 0 0 0 0
0 0 0 0 0 18 3 11 18 18 18 11 3 18 0 0 0 0 0 0 0
0 0 0 0 18 3 3 3 18 0 18 3 3 3 18 0 0 0 0 0 0
0 0 0 0 18 18 18 18 0 0 0 18 18 18 18 0 0 0 0 0 0
---
0 0 0 0 8 8 8 8 8 8 8 8 8 14 14 0 0 0 0 0 0
0 0 0 8 18 18 18 18 18 18 18 18 18 18 18 14 0 0 0 0 0
0 0 8 18 18 3 3 3 3 3 3 3 3 18 18 18 14 0 0 0 0
0 8 18 18 3 18 18 18 18 18 18 18 18 3 18 18 18 14 0 0 0
0 8 18 18 3 18 18 18 18 18 18 18 18 18 3 18 18 14 0 0 0
0 8 18 18 3 1 1 1 1 1 1 1 18 18 3 18 18 14 0 0 0
0 8 18 18 3 1 1 1 1 8 8 8 1 18 3 18 18 14 0 0 0
0 8 18 18 3 3 3 3 1 1 1 1 1 18 3 18 18 14 0 0 0
0 8 18 18 3 1 3 1 1 1 13 1 1 18 3 18 18 14 0 0 0
0 8 18 18 3 1 1 1 1 1 1 1 1 18 3 18 18 14 0 0 0
0 8 18 18 3 1 1 1 1 1 1 1 1 18 3 18 18 14 0 0 0
8 8 18 18 8 1 1 1 1 1 1 1 1 18 3 18 18 14 14 14 14
8 18 8 8 8 12 12 12 4 4 4 4 18 18 3 14 14 14 18 18 14
8 18 18 18 18 3 3 3 3 3 3 3 3 3 3 18 18 18 18 18 14
8 18 18 18 11 18 18 1 1 1 1 18 18 18 18 11 18 18 18 18 14
8 18 18 11 18 11 18 18 18 18 1 18 18 18 11 18 11 18 18 18 14
8 18 11 11 18 11 18 18 18 18 18 18 18 18 11 18 11 14 18 18 14
8 8 0 11 18 11 13 13 13 13 13 13 13 13 11 18 11 0 14 14 0
0 0 0 0 11 11 8 8 8 8 8 8 8 11 11 11 0 0 0 0 0
0 0 0 0 0 11 8 8 8 8 8 8 8 11 0 0 0 0 0 0 0
0 0 0 0 0 11 18 8 11 11 11 8 18 11 0 0 0 0 0 0 0
0 0 0 0 11 18 18 18 11 0 11 18 18 18 11 0 0 0 0 0 0
0 0 0 0 11 11 11 11 0 0 0 11 11 11 11 0 0 0 0 0 0
