0 0 0 0 0 0 16 16 0 0 0 0 0 0 0
0 0 0 0 0 0 16 13 16 0 0 0 0 0 0
0 0 16 16 0 0 16 13 13 16 0 0 0 0 0
0 0 16 13 16 16 13 9 9 13 16 0 16 0 0
0 0 16 13 16 13 9 15 9 9 16 16 13 16 0
0 16 13 13 13 15 9 15 15 9 16 16 13 9 16
16 13 9 9 13 9 15 15 15 15 9 16 9 9 16
16 9 9 15 15 15 15 15 15 15 15 9 15 9 16
0 16 9 15 16 16 16 16 16 16 15 15 9 16 0
0 0 16 16 8 16 8 8 16 8 16 16 16 0 0
0 0 16 8 8 16 8 8 16 8 8 8 16 0 0
0 0 16 8 8 8 8 8 8 8 8 8 16 0 0
0 0 0 16 8 8 8 8 8 8 8 16 0 0 0
0 0 0 0 16 16 16 16 16 16 16 0 0 0 0
---
0 0 0 0 0 0 9 9 0 0 0 0 0 0 0
0 0 0 0 0 0 9 16 9 0 0 0 0 0 0
0 0 9 9 0 0 9 16 16 9 0 0 0 0 0
0 0 9 16 9 9 16 16 16 16 9 0 9 0 0
0 0 8 16 9 16 16 16 16 16 9 9 16 9 0
0 8 16 16 16 16 16 16 16 16 9 9 16 16 8
8 16 13 13 16 16 16 16 16 16 16 9 16 16 8
8 13 13 16 16 16 16 16 16 16 16 16 16 16 8
0 8 13 16 13 13 13 13 13 13 16 16 16 8 0
0 0 8 8 15 13 15 15 13 16 8 8 8 0 0
0 0 8 15 15 13 15 15 13 16 16 16 8 0 0
0 0 8 15 15 15 15 15 15 15 16 16 8 0 0
0 0 0 8 15 15 15 15 15 15 16 8 0 0 0
0 0 0 0 8 8 8 8 8 8 8 0 0 0 0
