0 16 16 16 16 0 16 16 16 16 16 0 16 16 16 16 0
16 14 14 14 14 16 9 9 9 9 9 16 14 14 14 14 16
16 14 13 13 13 9 9 9 9 9 9 9 13 13 13 14 16
16 14 13 13 9 9 14 9 9 9 14 9 9 13 13 14 16
16 14 13 9 9 9 9 9 9 9 9 9 9 9 13 14 16
0 16 9 9 9 14 14 9 9 9 14 14 9 9 9 16 0
0 16 9 14 9 14 16 9 9 9 16 14 9 14 9 16 0
0 16 14 14 9 9 9 14 13 14 9 9 9 14 14 16 0
0 16 14 14 9 9 9 14 14 14 9 9 9 14 14 16 0
0 0 16 14 14 2 9 9 9 9 9 2 14 14 9 9 16
0 0 0 16 9 9 2 2 2 2 2 9 9 9 2 9 16
0 0 16 9 9 9 9 9 9 9 9 9 9 9 2 2 16
0 0 16 9 9 2 9 9 14 9 9 2 9 9 2 16 0
0 0 16 14 14 2 9 14 14 14 9 2 14 14 16 0 0
0 0 0 16 16 2 2 14 14 14 2 2 16 16 0 0 0
0 0 0 0 16 2 2 2 16 2 2 2 16 0 0 0 0
0 0 0 0 0 16 16 16 0 16 16 16 0 0 0 0 0
---
0 9 9 9 9 0 9 9 9 9 9 0 9 9 9 9 0
9 2 2 2 2 9 16 16 16 16 16 9 2 2 2 2 9
9 2 14 14 14 16 16 16 16 16 16 16 2 2 2 2 9
9 2 14 14 16 16 2 16 16 16 2 16 16 2 2 2 9
9 2 14 16 16 16 16 16 16 16 16 16 16 16 2 2 9
0 9 16 16 16 13 13 16 16 16 9 9 16 16 16 9 0
0 9 16 13 16 13 13 16 16 16 9 9 16 9 16 9 0
0 9 13 13 16 14 14 9 9 9 16 16 16 9 9 9 0
0 9 13 13 14 14 14 9 9 9 16 16 16 9 9 9 0
0 0 9 13 13 14 14 14 16 16 16 2 9 9 14 14 9
0 0 0 9 14 14 14 14 14 14 14 14 14 14 14 14 9
0 0 9 14 14 14 14 14 14 14 14 14 14 14 14 14 9
0 0 9 14 14 9 14 14 9 14 14 9 14 14 14 9 0
0 0 9 13 13 9 14 9 9 9 14 9 2 2 9 0 0
0 0 0 9 9 9 9 9 9 9 9 9 9 9 0 0 0
0 0 0 0 9 9 9 9 9 9 9 9 9 0 0 0 0
0 0 0 0 0 9 9 9 0 9 9 9 0 0 0 0 0
