0 0 0 16 0 0 0 0 0 0 16 0 0 0 0 0 0 0 0 0 0 0 0
0 0 16 16 16 0 0 0 0 16 19 16 0 0 0 0 0 0 0 0 0 0 0
0 0 16 19 2 16 16 16 16 2 19 16 0 0 0 0 0 0 0 0 16 16 0
0 16 19 19 19 2 2 19 2 19 19 2 16 0 0 0 0 0 0 16 19 19 16
0 16 19 19 19 19 19 19 19 19 19 19 16 0 0 0 0 0 0 16 19 19 16
16 19 19 16 19 19 12 19 19 16 19 19 2 16 16 16 16 0 0 0 16 2 16
16 10 10 19 19 12 19 12 19 19 10 10 19 2 2 2 2 16 0 0 16 19 16
16 19 19 19 19 19 19 19 19 19 19 19 19 2 19 2 2 19 16 16 16 2 16
16 19 19 19 19 19 19 19 19 19 19 19 19 2 19 2 19 19 2 16 19 16 0
16 2 2 19 19 19 19 19 19 19 19 19 19 19 19 2 19 19 19 16 19 16 0
16 19 19 19 19 19 19 19 19 19 19 19 19 19 19 19 19 19 19 2 16 0 0
16 2 19 14 14 14 14 14 19 19 19 19 19 19 19 19 19 19 19 2 16 0 0
16 19 14 14 14 14 14 14 14 19 19 19 19 19 19 19 19 2 2 2 16 0 0
16 19 14 14 14 14 14 14 14 14 14 19 19 19 19 19 19 19 19 2 16 0 0
16 19 14 14 14 14 14 14 14 14 14 14 14 14 19 19 19 19 2 2 16 0 0
0 16 2 14 14 14 14 14 14 14 14 14 14 14 14 14 19 19 2 16 0 0 0
0 0 16 2 14 14 14 14 14 14 14 14 14 14 14 14 19 2 16 0 0 0 0
0 0 0 16 2 16 16 19 16 16 16 16 16 2 16 16 19 16 0 0 0 0 0
0 0 0 16 16 0 0 16 16 0 0 0 16 16 0 0 16 16 0 0 0 0 0
---
0 0 0 19 0 0 0 0 0 0 19 0 0 0 0 0 0 0 0 0 0 0 0
0 0 19 19 19 0 0 0 0 19 14 19 0 0 0 0 0 0 0 0 0 0 0
0 0 19 14 19 19 19 19 19 19 14 19 0 0 0 0 0 0 0 0 19 19 0
0 19 14 14 14 19 19 14 19 14 14 19 19 0 0 0 0 0 0 19 14 14 19
0 19 14 14 14 14 14 14 14 14 14 14 19 0 0 0 0 0 0 19 14 14 19
19 14 14 19 14 14 10 14 14 19 14 14 19 19 19 19 19 0 0 0 19 19 19
19 19 19 14 14 10 14 10 14 14 19 19 16 19 19 19 19 19 0 0 19 10 19
19 14 14 14 14 14 14 14 14 14 14 14 16 19 16 19 19 16 19 19 19 19 19
19 14 14 14 14 14 14 14 14 14 14 14 16 19 16 19 16 16 19 19 12 19 0
19 19 19 16 16 16 16 16 16 16 16 16 16 16 16 19 16 16 16 19 12 19 0
19 16 16 16 16 16 16 16 16 16 16 16 16 16 16 16 16 16 16 19 19 0 0
19 19 16 19 19 19 2 2 16 16 16 16 16 16 16 16 16 16 16 19 19 0 0
19 16 19 19 19 19 2 2 2 16 16 16 16 16 16 16 16 19 19 19 19 0 0
19 16 19 19 19 19 2 2 2 2 2 16 16 16 16 16 16 16 16 19 19 0 0
19 16 19 19 19 19 2 2 2 2 2 2 2 2 16 16 16 16 19 19 19 0 0
0 19 19 19 19 19 2 2 2 2 2 2 2 2 2 2 16 16 19 19 0 0 0
0 0 19 19 19 19 19 2 2 2 2 2 2 2 2 2 16 19 19 0 0 0 0
0 0 0 19 19 19 19 12 19 19 19 19 19 19 19 19 16 19 0 0 0 0 0
0 0 0 19 19 0 0 19 19 0 0 0 19 19 0 0 19 19 0 0 0 0 0
