6 10 10 10 10 10 10 6 6 6 6 4 1 1 1 1 1 1 1 4 1 1 1 1
6 10 10 15 15 10 10 10 6 6 6 4 4 1 1 1 4 4 4 4 4 4 1 4
12 10 10 15 15 10 10 12 5 5 5 4 4 4 4 4 4 1 1 3 3 3 4 4
5 12 10 10 12 10 12 5 6 4 4 4 1 1 4 1 1 1 1 1 1 3 3 3
6 12 12 5 5 12 5 6 6 6 5 4 4 4 1 1 1 1 1 1 1 1 1 1
6 5 5 6 6 6 6 6 5 5 4 4 1 3 4 4 4 4 1 1 1 1 1 4
6 6 6 6 6 6 6 6 5 3 3 4 1 1 3 3 3 4 4 4 4 4 1 10
6 6 6 6 6 5 5 5 3 1 1 1 1 1 1 1 1 3 4 1 1 1 10 10
5 5 5 5 5 5 4 3 1 1 9 9 9 9 1 1 1 4 4 1 1 6 10 10
4 4 4 3 3 4 4 4 1 1 1 9 9 9 9 1 1 4 1 1 1 6 10 10
1 4 4 4 1 1 4 4 9 9 14 14 13 9 9 9 14 1 1 1 1 5 5 10
1 1 1 1 1 1 1 9 9 13 13 14 14 14 13 9 14 14 1 1 1 5 4 6
1 1 14 14 14 1 9 9 9 13 14 14 14 14 13 13 14 14 9 1 1 4 4 4
1 1 1 14 14 14 9 9 13 14 14 14 14 14 14 14 16 14 13 9 1 1 4 4
1 4 4 4 9 13 14 9 4 4 4 14 14 13 9 14 14 14 14 14 1 1 1 1
4 3 4 4 9 9 14 4 4 4 4 4 13 9 9 9 9 14 14 4 1 1 1 4
1 3 3 1 14 14 4 4 1 4 1 14 9 9 4 4 4 4 4 3 1 4 4 4
1 1 1 14 14 14 4 1 1 1 1 4 4 4 3 4 4 1 1 1 4 3 3 3
1 1 1 14 14 4 4 1 1 1 1 1 1 3 1 1 1 1 1 1 4 4 1 1
1 4 4 4 4 4 1 1 1 1 1 1 1 1 1 1 1 1 1 1 4 1 1 1
4 1 4 4 4 1 1 1 1 1 1 1 1 6 6 6 6 6 6 4 1 1 1 4
4 4 4 1 1 3 3 4 4 4 1 1 6 6 5 6 6 6 6 6 4 1 1 4
4 4 1 1 1 1 3 3 4 4 4 4 6 6 6 6 5 5 6 6 4 4 4 4
4 4 4 4 1 1 1 1 1 4 4 4 6 6 6 6 6 5 5 5 4 4 4 4
---
1 1 1 1 1 1 1 1 1 1 1 1 5 5 5 5 5 5 5 1 13 13 13 13
1 1 1 13 13 1 1 1 1 1 1 1 1 5 5 5 1 1 1 1 1 1 13 1
10 1 1 13 13 1 1 6 6 6 6 1 1 1 1 1 1 4 4 10 10 10 1 1
1 10 1 1 6 1 6 6 1 1 1 1 4 4 1 4 4 4 4 4 4 10 10 10
1 10 10 12 12 6 6 1 1 1 16 1 1 1 4 4 4 4 4 4 4 4 4 4
1 12 12 1 1 1 1 1 1 1 1 1 4 9 1 1 1 1 4 4 4 4 4 3
1 1 1 1 1 1 1 1 1 14 14 1 4 4 9 9 9 1 1 1 1 1 4 3
1 1 1 1 1 1 1 1 14 4 4 4 4 4 4 4 4 9 1 4 4 4 3 3
1 1 1 1 1 1 5 14 4 4 6 6 6 6 4 4 4 1 1 4 4 15 3 3
1 1 1 5 5 5 5 5 4 4 4 6 6 6 6 4 4 1 4 4 4 15 3 3
6 1 1 1 6 6 5 5 5 5 1 1 6 6 6 6 1 4 4 4 4 12 12 3
6 6 6 6 6 6 6 5 5 9 9 1 1 1 10 6 1 1 4 4 4 12 3 3
6 6 9 9 9 6 5 5 5 9 1 1 1 1 10 10 1 1 15 4 4 3 3 3
6 6 6 9 9 9 5 5 9 1 1 1 1 1 1 1 6 1 9 15 4 4 3 3
6 9 9 9 14 14 9 5 1 1 1 1 1 5 1 1 1 1 1 1 4 4 4 4
9 9 9 9 14 14 9 1 1 1 1 1 5 1 1 1 1 1 1 10 4 4 4 6
14 9 9 14 9 9 1 1 4 1 4 5 1 1 10 10 10 10 10 5 4 6 6 6
14 14 14 9 9 9 1 4 4 4 4 10 10 10 10 10 10 4 4 4 6 13 13 13
14 14 14 9 9 1 1 4 4 4 4 4 4 10 4 4 4 4 4 4 6 6 4 4
14 1 1 1 1 1 4 4 4 4 4 4 4 4 4 4 4 4 4 4 6 4 4 4
1 14 1 1 1 4 4 4 4 4 4 4 4 14 14 14 14 14 14 6 4 4 4 6
1 1 1 4 4 3 3 3 3 3 4 4 14 14 12 14 14 14 14 14 6 4 4 6
1 1 4 4 4 4 3 3 3 3 3 3 14 14 14 14 14 14 14 14 6 6 6 6
1 1 1 1 4 4 4 4 4 3 3 3 14 14 14 14 14 14 14 14 6 6 6 6
