0 0 16 16 16 16 16 16 16 16 16 16 16 16 16 0 0
0 16 19 19 19 19 19 19 19 19 9 19 19 19 19 16 0
16 9 9 9 9 9 9 9 9 9 9 9 9 9 9 9 16
16 9 9 16 16 16 16 16 16 16 16 16 16 16 9 9 16
0 16 16 9 9 9 9 9 16 9 9 9 9 9 16 16 0
0 16 9 9 5 6 5 5 16 5 5 6 5 9 9 16 0
0 16 9 6 5 6 5 5 16 5 5 6 5 6 9 16 0
0 16 9 6 5 6 5 5 16 5 5 6 5 6 9 16 0
0 16 9 6 5 6 5 5 16 5 5 6 5 6 9 16 0
0 16 9 6 5 6 5 15 16 15 5 6 5 6 9 16 0
0 16 9 6 5 6 15 2 16 2 15 6 5 6 9 16 0
0 16 9 6 5 6 5 15 16 15 5 6 5 6 9 16 0
0 16 9 6 5 6 5 5 16 5 5 6 5 6 9 16 0
0 16 9 6 5 6 5 5 16 5 5 6 5 6 9 16 0
0 16 9 6 5 6 5 5 16 5 5 6 5 6 9 16 0
0 16 9 9 9 9 9 9 16 9 9 9 9 9 9 16 0
0 16 9 9 16 16 16 16 16 16 16 16 16 9 9 16 0
0 0 16 16 0 0 0 0 0 0 0 0 0 16 16 0 0
---
0 0 6 6 6 6 6 6 6 6 6 6 6 6 6 0 0
0 6 16 16 16 16 16 16 16 16 16 16 16 16 16 6 0
6 16 16 16 16 16 16 16 16 16 16 16 16 16 16 16 6
6 16 16 6 6 6 6 6 6 6 6 6 6 6 16 16 6
0 6 6 16 16 16 16 16 6 16 16 16 16 16 6 6 0
0 6 16 16 9 9 19 19 6 16 16 9 9 16 16 6 0
0 5 16 9 9 9 19 19 5 15 16 9 9 9 16 5 0
0 5 16 9 9 9 19 19 5 15 15 9 9 9 16 5 0
0 5 16 9 9 9 19 19 5 15 15 9 9 9 16 5 0
0 5 16 9 9 9 19 19 5 5 15 9 9 9 16 5 0
0 5 16 9 9 9 19 5 5 5 5 9 9 9 16 5 0
0 5 16 9 9 9 2 19 5 5 2 9 9 9 16 5 0
0 5 16 9 9 9 9 5 5 5 9 9 9 9 16 5 0
0 5 16 9 9 9 9 9 5 9 9 9 9 9 16 5 0
0 5 16 9 9 9 9 9 5 9 9 9 9 9 16 5 0
0 5 16 16 16 16 16 16 5 16 16 16 16 16 16 5 0
0 5 16 16 5 5 5 5 5 5 5 5 5 16 16 5 0
0 0 5 5 0 0 0 0 0 0 0 0 0 5 5 0 0
