0 0 0 0 0 18 18 18 18 18 18 18 0 0 0 0 0 0
0 0 0 0 18 2 2 2 2 2 2 2 18 18 0 18 0 0
0 0 0 18 2 2 2 18 18 2 2 2 2 18 18 10 18 0
0 0 18 2 2 18 18 8 8 18 18 2 2 2 10 18 18 0
0 0 18 2 18 8 8 8 8 8 8 18 18 2 18 10 18 0
0 0 18 2 18 8 8 8 8 8 8 8 8 18 2 18 0 0
0 0 18 2 18 8 18 8 8 8 8 18 8 18 2 18 0 0
0 0 18 2 18 8 18 8 8 8 8 18 8 18 2 18 0 0
0 0 18 2 18 7 6 5 6 6 5 6 7 18 2 18 0 0
0 18 2 2 18 18 6 5 6 6 5 6 18 18 2 2 18 0
0 18 2 2 18 2 18 18 8 8 18 18 2 18 2 2 18 0
18 2 2 18 2 18 18 10 18 18 10 18 18 2 18 2 2 18
18 9 2 18 18 2 18 10 7 10 10 18 2 18 18 2 9 18
18 9 9 18 2 2 18 11 11 11 11 18 2 2 18 9 9 18
18 9 18 2 2 2 18 12 7 12 12 18 2 2 2 18 9 18
0 18 18 8 18 2 18 7 10 10 10 18 2 18 8 18 18 0
0 0 0 18 2 2 18 10 10 10 10 18 2 2 18 0 0 0
0 0 0 18 18 18 10 7 7 7 7 10 18 18 18 0 0 0
0 0 0 0 0 18 16 16 18 18 16 16 18 0 0 0 0 0
0 0 0 0 0 0 18 18 0 0 18 18 0 0 0 0 0 0
---
0 0 0 0 0 8 8 8 8 8 8 8 0 0 0 0 0 0
0 0 0 0 8 18 18 18 18 18 18 18 8 8 0 8 0 0
0 0 0 8 18 18 18 2 2 18 18 18 18 8 8 18 8 0
0 0 8 18 18 2 2 18 18 2 2 18 18 18 18 8 8 0
0 0 8 18 2 18 18 18 18 18 18 2 2 18 8 18 8 0
0 0 8 18 2 18 18 18 18 18 18 18 18 2 18 8 0 0
0 0 8 18 2 18 5 18 18 18 18 5 18 2 18 8 0 0
0 0 8 18 2 18 5 18 18 18 18 5 18 2 18 8 0 0
0 0 8 18 2 18 18 18 18 18 18 18 18 2 18 8 0 0
0 8 18 18 2 2 18 18 18 18 18 18 2 2 18 18 8 0
0 2 18 18 2 18 2 2 18 18 2 2 18 2 18 18 8 0
2 18 18 2 18 2 2 6 2 2 12 2 2 18 2 18 18 2
2 18 18 2 2 18 2 6 6 12 12 2 18 2 2 18 18 2
2 18 18 2 18 18 2 16 16 16 16 2 18 18 2 18 18 2
2 18 2 18 18 18 2 6 6 6 6 2 18 18 18 2 18 2
0 2 2 10 2 18 2 6 7 7 7 2 18 9 10 9 9 0
0 0 0 10 18 18 2 7 7 7 7 2 18 18 9 0 0 0
0 0 0 10 10 10 7 11 11 11 11 7 9 9 9 0 0 0
0 0 0 0 0 10 10 10 10 10 10 10 9 0 0 0 0 0
0 0 0 0 0 0 10 10 0 0 10 10 0 0 0 0 0 0
