0 0 0 0 16 16 16 16 16 16 16 16 16 0 0 0 0 0 0 0 0
0 0 0 16 13 14 14 14 14 14 13 13 13 16 0 0 0 0 0 0 0
0 0 16 13 14 14 14 14 14 13 13 13 13 14 16 0 0 0 0 0 0
0 16 13 14 14 14 14 14 13 13 13 13 14 14 14 16 0 0 0 0 0
0 16 14 14 14 14 14 13 13 13 13 14 14 14 14 14 16 0 0 0 0
16 14 14 14 14 14 13 13 13 13 14 14 14 14 14 13 16 0 0 0 0
16 14 14 14 14 13 13 13 13 14 14 14 14 14 13 13 16 0 0 0 0
16 14 14 14 13 13 13 16 16 16 14 14 14 13 13 13 16 0 0 0 0
16 14 14 13 13 13 16 0 0 0 16 14 13 13 13 13 16 0 0 0 0
0 16 13 13 13 13 16 0 0 0 16 13 13 13 13 14 16 0 0 0 0
0 16 16 16 16 16 0 0 0 0 16 13 13 13 14 14 16 0 0 0 0
0 0 0 0 0 0 0 5 0 0 16 13 13 14 14 14 16 16 16 0 0
0 0 0 0 0 0 0 0 0 0 16 13 14 16 16 16 14 13 13 16 0
0 0 5 0 0 0 0 0 0 0 16 14 16 14 13 13 16 13 13 16 0
0 0 5 0 0 0 0 0 0 0 16 14 16 13 13 13 16 13 13 16 0
5 5 15 5 5 0 0 0 0 0 17 17 16 13 13 13 16 16 16 17 0
0 0 5 0 0 0 0 0 0 17 17 5 5 16 16 16 17 17 5 5 17
0 0 5 0 0 0 0 0 0 17 5 5 5 17 5 5 17 17 5 5 17
0 0 0 0 0 0 0 0 0 17 5 5 17 5 5 5 17 5 17 5 17
0 0 0 0 0 5 0 0 0 17 5 5 5 5 5 17 17 5 5 5 17
5 0 0 0 5 15 5 0 0 17 5 5 5 5 17 17 17 17 17 17 17
0 0 0 0 0 5 0 0 0 17 17 17 17 17 17 14 16 0 0 0 0
0 0 0 0 0 0 0 0 0 0 0 16 14 14 14 16 0 0 0 0 0
0 0 0 0 0 0 0 0 0 0 0 0 16 16 16 0 0 0 0 0 0
---
0 0 0 0 14 14 14 14 14 14 14 14 14 0 0 0 0 0 0 0 0
0 0 0 14 17 16 16 16 16 16 5 5 5 14 0 0 0 0 0 0 0
0 0 14 17 16 16 16 16 16 5 5 5 5 16 14 0 0 0 0 0 0
0 14 17 16 16 16 16 16 5 5 5 5 16 16 16 14 0 0 0 0 0
0 14 16 16 16 16 16 5 5 5 5 16 16 16 16 16 14 0 0 0 0
14 16 16 16 16 16 5 5 5 5 16 16 16 16 16 17 14 0 0 0 0
14 16 16 16 16 5 5 5 5 16 16 16 16 16 17 17 14 0 0 0 0
14 16 16 16 5 5 5 14 14 14 16 16 16 17 17 17 14 0 0 0 0
14 16 16 5 5 5 14 0 0 0 14 16 17 17 17 17 14 0 0 0 0
0 14 5 5 5 5 14 0 0 0 14 17 17 17 17 17 14 0 0 0 0
0 14 14 14 14 14 0 0 0 0 14 17 17 17 17 17 14 0 0 0 0
0 0 0 0 0 0 0 14 0 0 14 17 17 17 17 17 14 14 14 0 0
0 0 0 0 0 0 0 0 0 0 14 17 17 14 14 14 17 14 14 14 0
0 0 16 0 0 0 0 0 0 0 14 17 14 17 16 16 14 14 14 14 0
0 0 16 0 0 0 0 0 0 0 14 17 14 16 16 16 14 14 14 14 0
16 16 17 16 16 0 0 0 0 0 13 13 14 16 16 16 14 14 14 13 0
0 0 13 0 0 0 0 0 0 13 13 13 13 14 14 14 13 13 13 13 13
0 0 13 0 0 0 0 0 0 13 13 13 13 15 13 13 13 13 13 13 13
0 0 0 0 0 0 0 0 0 13 13 13 15 13 13 13 13 13 13 13 13
0 0 0 0 0 13 0 0 0 13 13 13 13 13 13 13 13 13 13 13 13
5 0 0 0 13 17 13 0 0 13 13 13 13 13 13 13 13 13 13 13 13
0 0 0 0 0 13 0 0 0 13 13 13 13 13 13 5 5 0 0 0 0
0 0 0 0 0 0 0 0 0 0 0 5 5 5 5 5 0 0 0 0 0
0 0 0 0 0 0 0 0 0 0 0 0 5 5 5 0 0 0 0 0 0
