0 0 0 0 0 0 0 0 0 0 0 0 0 0 0 0 0 0
0 0 0 0 0 4 4 4 0 0 15 15 0 0 0 0 0 0
0 0 0 4 4 3 3 4 4 0 15 15 0 0 0 0 0 0
0 0 4 3 3 3 3 3 4 15 15 4 4 4 0 0 0 0
0 0 4 3 3 3 3 3 15 15 4 4 3 3 4 0 0 0
0 0 4 1 3 3 3 1 15 15 1 3 3 3 4 0 0 0
0 0 0 4 1 3 1 1 15 9 1 1 3 3 4 5 6 6
0 4 4 1 1 1 1 1 9 9 1 3 3 4 5 6 6 5
4 3 3 3 3 3 1 1 9 1 1 1 1 4 4 5 6 5
4 3 3 3 1 1 1 1 1 1 1 1 3 3 4 4 5 0
4 3 3 3 3 3 1 3 1 3 1 3 3 3 3 4 0 0
4 3 3 3 1 1 3 3 1 3 1 1 3 3 3 4 0 0
4 3 3 4 4 4 3 3 3 3 4 4 4 4 4 0 0 0
0 4 4 4 0 4 3 3 3 3 3 4 5 5 5 0 0 0
0 0 0 0 0 4 3 3 3 3 4 4 5 5 6 5 0 0
0 0 0 0 0 0 4 4 4 4 4 5 5 6 5 6 0 0
0 0 0 0 0 0 0 0 0 0 0 5 6 6 6 6 0 0
0 0 0 0 0 0 0 0 0 0 0 0 5 5 5 5 0 0
---
0 0 0 0 0 0 0 0 0 0 0 0 0 0 0 0 0 0
0 0 0 0 0 3 3 3 0 0 1 1 0 0 0 0 0 0
0 0 0 3 3 5 5 3 3 0 1 1 0 0 0 0 0 0
0 0 3 5 5 5 5 5 3 1 1 1 1 1 0 0 0 0
0 0 3 5 5 5 5 5 1 1 1 1 6 6 1 0 0 0
0 0 3 3 5 5 5 3 1 1 3 6 6 6 1 0 0 0
0 0 0 3 3 5 3 3 1 1 3 3 6 6 1 6 5 5
0 3 3 3 3 3 3 3 1 1 3 6 6 1 6 5 5 9
3 4 4 4 4 4 3 3 1 3 3 3 3 1 1 9 6 9
3 4 4 4 3 3 3 3 3 3 3 3 15 15 1 1 9 0
3 4 4 4 4 4 3 4 3 4 3 15 15 15 15 1 0 0
3 4 4 4 3 3 4 4 3 4 3 3 15 15 15 1 0 0
3 4 4 3 3 3 4 4 4 4 1 1 1 1 1 0 0 0
0 3 3 3 0 3 4 4 4 4 4 1 4 4 4 0 0 0
0 0 0 0 0 3 4 4 4 4 3 3 4 4 4 4 0 0
0 0 0 0 0 0 3 3 3 3 3 4 4 15 4 4 0 0
0 0 0 0 0 0 0 0 0 0 0 4 15 4 4 4 0 0
0 0 0 0 0 0 0 0 0 0 0 0 4 4 4 4 0 0
