0 0 0 0 0 0 0 0 0 0 0 0 18 18 0 0 0 0 0 0 0 0
0 0 0 0 0 0 0 0 0 0 0 0 18 1 18 0 0 0 0 0 0 0
0 0 0 0 0 0 0 0 0 0 0 0 0 18 1 18 0 0 0 0 0 0
0 0 0 0 0 0 0 0 0 0 0 0 0 0 18 1 18 0 0 0 0 0
0 0 0 0 0 0 0 0 0 0 0 0 0 0 18 1 1 18 0 0 0 0
0 0 0 0 0 0 0 0 0 0 0 0 0 0 0 18 1 1 18 0 0 0
0 0 0 0 0 18 18 0 0 0 18 18 0 0 18 18 18 18 18 18 0 0
0 0 0 0 18 3 3 18 0 18 3 3 18 0 18 7 7 10 10 18 0 0
0 0 18 18 18 18 18 18 18 18 18 18 18 18 18 18 18 18 18 18 0 0
0 18 7 14 14 14 14 14 14 7 14 14 7 7 7 7 7 7 7 10 18 0
18 7 14 14 7 7 7 7 7 7 7 4 4 4 4 4 4 4 7 7 10 18
18 7 7 7 4 4 4 4 7 7 4 14 14 14 14 13 14 14 4 7 10 18
18 7 7 4 15 15 15 15 4 7 7 4 4 4 4 4 4 4 7 7 10 18
18 7 4 15 15 9 9 15 15 4 7 7 7 7 7 7 7 7 7 7 10 18
18 7 4 15 9 9 9 9 15 4 7 7 4 4 7 7 7 4 4 7 10 18
18 7 4 15 9 9 9 9 15 4 7 4 15 15 4 7 4 15 15 4 10 18
18 7 4 15 15 9 9 15 15 4 7 7 4 4 7 7 7 4 4 7 10 18
18 7 7 4 15 15 15 15 4 7 7 7 7 7 7 7 7 7 7 7 10 18
18 7 7 7 4 4 4 4 7 7 7 7 7 7 7 7 7 7 7 7 10 18
18 7 7 7 7 7 7 7 7 7 7 7 7 7 7 7 7 7 10 10 10 18
0 18 10 10 10 10 10 10 10 10 10 10 10 10 10 10 10 10 10 10 18 0
0 0 18 18 18 18 18 18 18 18 18 18 18 18 18 18 18 18 18 18 0 0
0 0 0 18 10 10 10 18 0 0 0 0 0 0 18 10 10 10 18 0 0 0
0 0 0 0 18 18 18 0 0 0 0 0 0 0 0 18 18 18 0 0 0 0
---
0 0 0 0 0 0 0 0 0 0 0 0 10 10 0 0 0 0 0 0 0 0
0 0 0 0 0 0 0 0 0 0 0 0 10 10 10 0 0 0 0 0 0 0
0 0 0 0 0 0 0 0 0 0 0 0 0 10 10 10 0 0 0 0 0 0
0 0 0 0 0 0 0 0 0 0 0 0 0 0 10 10 10 0 0 0 0 0
0 0 0 0 0 0 0 0 0 0 0 0 0 0 10 10 10 10 0 0 0 0
0 0 0 0 0 0 0 0 0 0 0 0 0 0 0 10 10 10 10 0 0 0
0 0 0 0 0 15 15 0 0 0 10 10 0 0 10 10 10 10 10 10 0 0
0 0 0 0 15 15 15 15 0 10 15 15 10 0 10 3 3 3 3 10 0 0
0 0 7 7 7 7 7 7 15 15 15 15 10 10 10 10 10 10 10 10 0 0
0 7 9 18 18 18 18 18 18 18 18 18 15 15 15 15 15 15 15 18 7 0
7 9 18 18 18 18 18 18 18 18 18 7 7 7 7 7 7 7 15 15 18 7
7 9 9 9 7 7 7 7 1 1 7 18 18 18 18 18 18 18 7 15 18 7
7 9 9 7 18 18 18 18 7 1 1 7 7 7 7 7 7 7 15 15 18 7
7 9 7 18 18 18 18 18 18 7 1 4 4 4 4 4 4 4 4 4 18 7
7 9 7 18 18 18 18 18 18 7 1 4 7 7 4 4 4 7 7 4 18 7
7 9 7 18 18 18 18 18 18 7 1 7 18 18 7 4 7 18 18 7 18 7
7 9 7 18 18 18 18 18 18 7 13 4 7 7 4 4 4 7 7 4 18 7
7 9 14 7 18 18 18 18 7 14 4 4 4 4 4 4 4 4 4 4 18 7
7 14 14 14 7 7 7 7 14 14 4 4 4 4 4 4 4 4 4 4 18 7
7 14 14 14 14 14 14 14 14 14 4 4 4 4 4 4 4 4 18 18 18 7
0 7 18 18 18 18 18 18 18 18 18 18 18 18 18 18 18 18 18 18 7 0
0 0 7 7 7 7 7 7 7 7 7 7 7 7 7 7 7 7 7 7 0 0
0 0 0 7 18 18 18 7 0 0 0 0 0 0 7 18 18 18 7 0 0 0
0 0 0 0 7 7 7 0 0 0 0 0 0 0 0 7 7 7 0 0 0 0
