0 0 0 0 0 0 0 0 18 18 0 0 0 0 0 0 0 0
0 0 0 0 18 0 0 18 14 14 18 0 0 18 0 0 0 0
0 0 0 18 14 18 18 14 14 14 14 18 18 14 18 0 0 0
0 18 0 18 14 14 6 14 6 6 14 6 14 14 18 0 18 0
18 14 18 18 14 14 14 5 14 14 5 14 14 14 18 18 14 18
18 14 14 5 6 14 14 9 9 9 9 14 14 6 5 14 14 18
18 14 14 6 14 5 12 9 15 15 9 12 5 14 6 14 14 18
0 18 14 6 14 14 12 15 15 15 15 12 14 14 6 14 18 0
18 14 6 17 14 14 14 12 9 9 12 14 14 14 17 6 14 18
18 14 14 14 6 6 6 14 14 14 14 6 6 6 14 14 14 18
18 5 14 14 14 5 14 6 6 6 6 14 5 14 14 14 5 18
18 5 5 5 17 14 14 14 5 5 14 14 14 14 17 5 5 18
18 6 5 5 5 14 14 14 14 14 14 14 14 14 5 5 5 18
0 18 5 5 5 5 14 14 17 17 14 14 5 5 5 6 6 18
0 18 6 5 5 5 5 5 5 5 5 5 5 18 18 18 18 0
0 0 18 6 6 5 5 5 5 5 5 5 5 18 0 0 0 0
0 0 0 18 18 6 6 6 6 6 6 6 6 18 0 0 0 0
0 0 0 0 0 18 18 18 18 18 18 18 18 0 0 0 0 0
---
0 0 0 0 0 0 0 0 5 5 0 0 0 0 0 0 0 0
0 0 0 0 14 0 0 5 18 18 5 0 0 14 0 0 0 0
0 0 0 14 18 14 5 18 18 18 18 5 14 18 14 0 0 0
0 14 0 14 18 18 5 18 12 12 18 5 18 18 14 0 14 0
14 18 14 14 18 18 18 12 18 18 12 18 18 18 14 14 6 14
14 18 18 17 5 18 18 5 5 5 5 18 18 9 9 6 6 14
14 18 18 5 18 15 15 5 5 5 5 17 9 18 9 6 6 14
0 14 18 5 18 18 15 5 5 5 5 17 18 18 9 6 14 0
14 18 5 6 18 18 18 15 15 15 17 18 18 18 6 9 6 14
14 18 18 18 5 5 5 18 18 18 18 5 5 5 6 6 6 14
14 14 18 18 18 5 18 5 5 5 5 6 6 6 6 6 14 14
14 14 14 14 17 18 18 6 9 9 6 6 6 6 6 14 14 14
14 17 14 14 14 6 6 6 6 6 6 6 6 6 14 14 14 14
0 14 14 14 14 14 6 6 12 12 6 6 14 14 14 5 5 14
0 14 5 14 14 14 14 14 14 14 14 14 14 14 14 14 14 0
0 0 14 5 5 14 14 14 14 14 14 14 14 14 0 0 0 0
0 0 0 14 14 5 5 5 5 5 5 5 5 14 0 0 0 0
0 0 0 0 0 14 14 14 14 14 14 14 14 0 0 0 0 0
