0 0 0 14 1 0 0 0 0 0 0 0 0 0 1 14 0 0 0
0 0 0 3 4 0 9 9 19 15 19 9 9 0 4 3 0 0 0
0 0 0 0 2 9 0 0 0 0 0 0 0 9 2 0 0 0 0
0 0 0 9 0 0 0 0 0 0 0 0 0 0 0 9 0 0 0
0 9 0 9 0 0 0 0 0 0 0 0 0 0 0 9 0 9 0
19 4 19 0 0 0 0 0 0 0 0 0 0 0 0 0 19 4 19
0 15 2 0 0 0 0 0 0 0 0 0 0 0 0 0 2 15 0
0 0 2 0 0 0 0 0 0 0 0 0 0 0 0 0 2 0 0
0 9 0 9 0 0 0 0 0 0 0 0 0 0 0 9 0 9 0
19 4 19 2 0 0 0 0 0 0 0 0 0 0 0 2 19 4 19
0 15 0 0 9 0 0 0 0 0 0 0 0 0 9 0 0 15 0
0 0 0 15 0 19 9 0 0 0 0 0 9 19 0 15 0 0 0
0 14 4 0 0 0 0 19 9 0 9 19 0 0 0 0 4 14 0
0 3 1 0 19 9 9 0 0 9 0 0 9 9 19 0 1 3 0
0 0 0 0 15 4 9 0 19 4 19 0 9 4 15 0 0 0 0
0 0 0 0 15 15 19 0 0 15 0 0 19 15 15 0 0 0 0
0 0 0 19 0 0 0 0 19 4 19 0 0 0 0 19 0 0 0
0 14 4 0 0 0 0 15 4 4 4 15 0 0 0 0 4 14 0
0 3 1 0 0 0 19 4 1 14 1 4 19 0 0 0 1 3 0
0 0 0 0 0 0 9 4 1 14 1 4 9 0 0 0 0 0 0
0 0 0 0 0 0 9 1 3 3 3 1 9 0 0 0 0 0 0
0 0 0 0 0 0 0 9 1 1 1 9 0 0 0 0 0 0 0
0 0 0 0 0 0 0 0 9 9 9 0 0 0 0 0 0 0 0
---
0 0 0 19 19 0 0 0 0 0 0 0 0 0 19 19 0 0 0
0 0 0 19 9 0 1 1 9 9 9 1 1 0 9 19 0 0 0
0 0 0 0 9 1 0 0 0 0 0 0 0 1 9 0 0 0 0
0 0 0 1 0 0 0 0 0 0 0 0 0 0 0 1 0 0 0
0 1 0 1 0 0 0 0 0 0 0 0 0 0 0 1 0 1 0
2 15 2 0 0 0 0 0 0 0 0 0 0 0 0 0 2 15 2
0 2 15 0 0 0 0 0 0 0 0 0 0 0 0 0 15 2 0
0 0 15 0 0 0 0 0 0 0 0 0 0 0 0 0 15 0 0
0 1 0 1 0 0 0 0 0 0 0 0 0 0 0 1 0 15 0
2 15 19 15 0 0 0 0 0 0 0 0 0 0 0 15 15 15 15
0 2 0 0 3 0 0 0 0 0 0 0 0 0 4 0 0 15 0
0 0 0 3 0 3 4 0 0 0 0 0 4 14 0 14 0 0 0
0 19 19 0 0 0 0 15 4 0 4 15 0 0 0 0 19 19 0
0 19 19 0 3 4 4 0 0 4 0 0 4 4 14 0 19 19 0
0 0 0 0 3 19 4 0 9 19 9 0 4 19 14 0 0 0 0
0 0 0 0 3 3 3 0 0 9 0 0 14 14 14 0 0 0 0
0 0 0 3 0 0 0 0 9 9 9 0 0 0 0 14 0 0 0
0 19 19 0 0 0 0 9 9 9 9 9 0 0 0 0 19 19 0
0 19 19 0 0 0 9 9 9 9 9 9 9 0 0 0 19 19 0
0 0 0 0 0 0 4 9 9 9 9 9 4 0 0 0 0 0 0
0 0 0 0 0 0 4 9 9 9 9 9 4 0 0 0 0 0 0
0 0 0 0 0 0 0 4 9 9 9 4 0 0 0 0 0 0 0
0 0 0 0 0 0 0 0 4 4 4 0 0 0 0 0 0 0 0
