0 18 18 18 18 0 0 0 0 0 0 0 0 0 0 0 0 0 0 0
18 14 3 14 3 18 0 0 0 0 0 0 0 0 0 0 0 0 0 0
18 3 3 3 3 14 18 0 18 18 18 18 0 0 0 0 0 0 0 0
18 14 3 14 14 3 14 18 18 18 0 18 18 18 18 0 0 0 0 0
18 3 3 14 14 14 3 14 18 18 0 0 0 18 18 0 0 0 0 0
18 14 3 14 14 14 14 3 19 19 18 0 0 18 18 0 0 0 0 0
0 18 14 3 14 14 14 9 9 9 18 0 18 18 0 0 0 0 0 0
0 0 18 14 3 14 9 9 9 9 19 18 18 0 0 0 0 0 0 0
0 18 19 9 14 9 9 14 18 18 9 18 0 0 0 0 0 0 0 0
0 18 19 18 9 18 9 14 18 18 9 9 18 0 0 0 0 0 0 0
18 19 19 9 18 9 9 14 14 14 9 9 18 0 0 0 0 0 0 0
18 19 9 9 9 9 9 9 9 9 9 9 18 0 0 0 0 0 0 0
18 9 9 9 9 9 9 9 9 9 9 9 9 18 0 0 0 0 0 0
0 18 2 19 9 2 19 9 2 9 9 9 9 18 0 0 0 0 0 0
0 18 2 9 9 2 9 9 18 9 9 9 9 18 18 0 0 0 0 0
18 9 18 2 9 9 2 18 9 18 18 9 9 18 18 18 0 18 18 18
18 9 9 9 18 18 18 18 9 9 9 9 18 18 0 18 18 18 0 18
0 18 18 18 0 0 0 18 18 18 18 18 0 0 0 0 0 18 18 18
---
0 3 3 3 3 0 0 0 0 0 0 0 0 0 0 0 0 0 0 0
3 18 18 18 18 3 0 0 0 0 0 0 0 0 0 0 0 0 0 0
3 18 18 18 18 9 14 0 14 14 14 14 0 0 0 0 0 0 0 0
3 18 18 9 9 18 9 14 14 14 0 14 14 14 14 0 0 0 0 0
9 18 18 9 9 9 18 9 14 14 0 0 0 14 14 0 0 0 0 0
9 9 18 9 9 9 9 18 18 18 14 0 0 14 14 0 0 0 0 0
0 9 9 18 9 9 9 18 18 18 14 0 14 14 0 0 0 0 0 0
0 0 9 9 18 9 18 18 18 18 18 14 14 0 0 0 0 0 0 0
0 9 2 18 9 18 18 18 3 3 18 14 0 0 0 0 0 0 0 0
0 9 2 3 18 3 18 18 3 3 18 18 14 0 0 0 0 0 0 0
9 2 2 18 3 18 18 18 18 18 18 18 14 0 0 0 0 0 0 0
9 2 18 18 18 18 18 18 18 18 18 18 14 0 0 0 0 0 0 0
9 18 18 18 19 18 18 18 18 18 18 18 18 9 0 0 0 0 0 0
0 9 18 2 19 18 2 18 18 18 18 18 18 9 0 0 0 0 0 0
0 9 18 19 19 18 18 18 9 18 18 18 18 9 9 0 0 0 0 0
9 19 9 18 19 19 18 9 18 9 9 18 18 9 9 9 0 9 9 9
9 19 19 19 9 9 9 9 18 18 18 18 9 9 0 9 9 9 0 9
0 9 9 9 0 0 0 9 9 9 9 9 0 0 0 0 0 9 9 9
