0 0 0 0 0 0 0 0 0 0 0 0 0 0 0
0 0 0 0 0 0 0 0 0 0 0 0 0 0 0
0 0 0 0 0 0 0 0 0 0 0 0 0 0 0
0 0 0 0 0 18 18 18 18 0 0 0 0 0 0
0 18 18 18 18 6 5 5 5 18 0 0 0 0 0
0 0 18 2 2 5 5 18 5 5 18 0 0 0 0
0 18 8 8 8 8 5 5 5 5 18 0 0 0 0
18 8 8 8 8 5 5 5 5 18 18 0 0 0 0
18 8 8 8 8 5 5 5 5 5 18 18 18 0 0
18 8 8 8 8 5 5 5 5 5 5 5 18 0 0
18 8 8 8 8 8 18 5 5 5 5 18 18 18 18
0 18 8 8 8 5 5 18 18 18 18 4 18 18 0
0 0 18 5 5 5 4 5 4 4 4 18 18 0 0
0 0 0 18 18 18 18 18 18 18 18 0 0 0 0
0 0 0 0 0 0 18 0 0 0 0 0 0 0 0
---
0 0 0 0 0 0 0 0 0 0 0 0 0 0 0
0 0 0 0 0 0 0 0 0 0 0 0 0 0 0
0 0 0 0 0 0 0 0 0 0 0 0 0 0 0
0 0 0 0 0 5 5 5 5 0 0 0 0 0 0
0 5 5 5 5 8 18 18 18 5 0 0 0 0 0
0 0 5 8 8 18 18 6 18 18 5 0 0 0 0
0 5 4 4 2 2 18 18 18 18 5 0 0 0 0
5 18 4 4 4 18 18 18 18 5 5 0 0 0 0
5 18 18 18 18 18 18 18 18 18 5 5 5 0 0
5 18 18 18 18 18 18 18 18 18 18 18 5 0 0
5 18 18 18 18 18 5 18 18 18 18 5 5 5 5
0 5 18 18 18 8 8 5 5 5 5 8 5 5 0
0 0 5 8 8 8 8 8 8 8 8 8 8 0 0
0 0 0 5 8 8 8 8 8 8 8 0 0 0 0
0 0 0 0 0 0 8 0 0 0 0 0 0 0 0
