0 0 0 0 9 0 0 0
0 0 0 9 9 0 0 0
0 0 9 9 15 9 0 0
0 0 9 9 15 9 0 0
0 0 15 15 15 15 0 0
16 16 14 15 15 14 18 0
16 15 14 14 14 14 19 16
16 15 14 14 14 14 19 16
16 14 14 15 14 14 19 16
0 16 14 14 15 15 18 0
0 2 14 14 14 19 16 0
0 16 14 14 14 19 16 0
0 16 16 19 19 19 16 0
16 16 16 16 2 2 16 16
16 16 16 16 16 2 2 16
0 16 16 16 16 16 16 0
---
0 0 0 0 16 0 0 0
0 0 0 16 16 0 0 0
0 0 16 16 16 16 0 0
0 0 16 16 16 16 0 0
0 0 16 16 16 16 0 0
14 14 16 16 16 16 14 0
14 16 16 16 16 16 14 14
14 16 16 16 16 16 14 14
14 16 16 14 16 16 14 14
0 14 15 15 14 14 14 0
0 15 15 15 15 14 19 0
0 9 15 15 15 14 19 0
0 9 9 14 14 14 19 0
9 9 9 9 15 15 19 19
9 9 18 18 2 15 15 19
0 2 2 2 2 19 19 0
