11 15 11 11 11 10 14 10 11 11 11 11 11 11 11 15 11 11
11 11 15 11 11 11 10 11 11 11 10 11 11 11 15 11 11 11
11 11 11 15 19 11 11 11 19 11 11 11 19 15 11 11 11 11
11 11 11 11 11 19 9 19 8 19 9 19 11 11 11 7 11 11
11 11 10 11 11 11 11 9 8 9 11 11 11 11 7 14 10 11
11 10 7 10 11 11 11 11 9 11 11 11 11 11 11 10 11 11
10 7 14 7 10 11 11 19 14 19 11 11 11 11 11 10 11 11
11 10 7 10 11 11 19 1 14 3 19 11 11 10 11 11 11 10
11 11 10 11 11 11 9 1 14 3 9 11 11 11 11 11 10 7
11 11 11 11 11 9 1 1 14 3 3 9 11 11 10 10 7 14
11 10 11 11 11 9 1 14 3 14 3 9 11 11 11 11 10 7
11 11 11 11 9 1 14 3 3 1 14 3 9 11 11 11 11 10
11 11 11 11 4 1 14 3 1 1 14 1 4 11 11 11 11 10
11 11 11 11 1 3 3 14 1 14 3 1 4 11 11 7 11 11
11 11 10 11 11 1 3 3 14 3 1 4 11 11 7 14 10 11
11 10 14 10 11 11 1 3 14 1 4 11 11 11 11 10 11 11
11 11 10 11 11 11 11 1 1 4 11 11 10 11 11 11 11 11
11 11 11 11 11 11 11 11 4 11 11 11 11 11 11 11 11 11
---
11 11 11 11 11 11 11 11 11 11 11 11 11 11 11 11 11 11
11 11 11 11 11 11 11 11 11 11 11 11 11 11 11 11 11 11
11 11 11 11 11 11 11 11 11 11 11 11 11 11 11 11 11 11
11 11 11 11 11 11 11 11 11 11 11 11 14 11 11 11 11 11
11 11 11 3 3 3 3 11 11 11 14 14 14 11 11 11 11 11
11 11 11 11 3 3 3 19 11 8 14 14 14 11 11 11 11 11
11 11 11 11 11 19 19 10 11 3 8 14 14 11 11 11 11 11
11 11 11 11 1 19 10 10 11 1 3 15 14 11 11 11 11 11
11 11 11 1 19 19 3 10 11 1 3 15 15 14 14 11 11 11
11 11 1 1 19 3 10 10 11 1 1 3 15 14 11 11 11 11
11 11 4 1 19 3 10 11 1 11 1 3 15 15 14 14 11 11
11 4 4 19 3 10 11 1 1 10 11 1 3 9 14 14 11 11
11 4 4 19 10 10 11 1 10 10 11 10 10 9 14 14 11 11
11 4 4 19 10 1 1 11 10 11 10 10 10 9 14 11 11 11
11 11 11 7 7 10 1 1 11 10 10 10 9 9 11 11 11 11
11 11 11 11 7 7 10 1 11 10 10 9 9 11 11 11 11 11
11 11 11 11 7 7 7 10 10 10 9 9 11 11 11 11 11 11
11 11 11 11 7 7 7 7 10 9 9 9 9 11 11 11 11 11
