0 0 0 0 0 0 0 18 18 18 0 0 0 0 0 0
0 0 0 0 0 0 18 2 2 2 18 18 0 0 0 0
0 0 0 0 0 18 2 2 18 18 2 8 18 0 0 0
0 0 0 0 0 18 9 2 18 18 2 18 0 0 0 0
0 0 0 0 0 18 2 2 18 18 2 8 18 0 0 0
0 0 0 0 0 18 9 2 2 2 18 18 0 0 0 0
0 0 0 0 0 0 18 17 5 5 18 0 0 0 0 0
0 0 0 0 0 0 18 17 14 14 18 0 0 0 0 0
0 0 0 0 0 0 18 17 5 5 18 0 0 0 0 0
0 0 0 0 0 0 18 17 5 5 18 0 0 0 0 0
0 0 0 0 18 18 18 17 14 14 18 18 0 0 0 0
0 0 18 18 2 2 2 9 5 5 9 9 18 0 0 0
0 18 2 2 2 9 9 9 14 14 9 9 9 18 0 0
0 18 2 2 9 9 9 9 5 5 9 9 9 9 18 0
0 18 2 2 9 9 9 9 14 14 9 9 9 9 18 0
0 0 18 2 2 9 9 2 5 5 2 9 9 18 0 0
0 0 18 2 2 9 2 2 8 8 2 2 9 18 0 0
0 18 2 2 2 9 9 2 8 8 2 9 9 9 18 0
0 18 2 9 9 9 9 9 8 8 9 9 9 9 18 0
18 2 2 9 9 9 9 9 8 8 9 9 9 9 9 18
18 2 2 9 9 9 9 9 8 8 9 9 9 9 9 18
18 2 2 2 9 9 2 2 19 19 2 2 9 9 9 18
18 18 2 2 9 9 9 9 9 9 9 9 9 9 18 18
0 18 18 2 2 2 2 9 9 9 9 9 9 18 18 0
0 0 18 18 18 18 18 18 18 18 18 18 18 18 0 0
---
0 0 0 0 0 0 0 9 9 9 0 0 0 0 0 0
0 0 0 0 0 0 9 18 18 18 9 9 0 0 0 0
0 0 0 0 0 9 18 18 8 8 18 18 9 0 0 0
0 0 0 0 0 9 18 18 8 8 18 9 0 0 0 0
0 0 0 0 0 9 18 18 8 8 18 18 9 0 0 0
0 0 0 0 0 9 18 18 18 18 9 9 0 0 0 0
0 0 0 0 0 0 9 9 18 18 9 0 0 0 0 0
0 0 0 0 0 0 9 9 18 18 9 0 0 0 0 0
0 0 0 0 0 0 9 9 18 18 9 0 0 0 0 0
0 0 0 0 0 0 9 9 18 18 9 0 0 0 0 0
0 0 0 0 9 9 9 9 18 18 9 9 0 0 0 0
0 0 9 9 18 18 18 2 18 18 2 2 9 0 0 0
0 9 18 18 18 2 2 2 18 18 2 2 2 9 0 0
0 9 18 18 2 2 2 2 18 18 2 2 2 2 9 0
0 9 18 18 2 2 2 2 18 18 2 2 2 2 9 0
0 0 9 18 18 2 2 9 18 18 9 2 2 9 0 0
0 0 9 18 18 19 9 9 18 18 9 9 2 9 0 0
0 9 18 18 18 17 19 9 18 18 9 2 2 2 9 0
0 9 18 17 17 17 14 14 18 18 2 2 2 2 9 0
9 18 18 17 14 14 14 14 18 18 2 2 2 2 2 9
9 18 18 5 5 5 14 14 18 18 2 2 2 2 2 9
9 18 18 18 5 5 9 9 18 18 9 9 2 2 2 9
9 9 18 18 5 5 5 8 8 8 2 2 2 2 9 9
0 9 9 5 5 5 5 8 8 8 2 2 2 9 9 0
0 0 9 9 9 9 9 9 9 9 9 9 9 9 0 0
