0 0 0 0 16 16 16 16 0 16 16 16 16 16 16 16 16 16 0 0 0 0 0 0 0 0 0 0 0 0 0 0
0 0 0 16 2 9 9 9 16 16 9 9 8 8 8 8 8 8 16 16 0 16 16 16 0 0 0 0 0 0 0 0
0 0 16 2 2 2 16 16 9 9 9 8 8 8 8 8 9 9 9 9 16 9 9 9 16 0 0 0 0 0 0 0
0 0 16 2 2 16 9 9 9 9 8 8 8 8 8 9 9 9 9 16 9 9 9 9 9 16 0 0 0 0 0 0
0 0 16 2 16 9 9 9 9 9 8 8 8 8 8 9 9 9 9 9 9 9 9 9 9 9 16 0 0 0 0 0
0 0 16 2 16 9 9 9 9 8 8 8 8 8 9 9 9 9 9 9 9 9 9 16 16 9 16 0 0 0 0 0
0 0 0 16 9 9 9 9 9 8 8 8 8 8 9 9 9 9 9 9 9 9 16 2 2 16 2 16 0 0 0 0
0 0 0 16 9 9 9 9 8 8 8 8 8 8 9 9 9 9 9 9 9 9 16 2 2 2 2 16 0 0 0 0
0 0 0 16 9 16 16 9 8 8 8 8 8 8 9 9 9 9 9 9 9 9 16 2 2 2 2 16 0 0 0 0
0 0 16 9 16 14 16 9 8 8 8 8 8 8 9 9 16 16 16 9 9 9 9 2 2 2 2 16 0 0 0 0
0 0 16 9 16 16 16 9 8 8 8 8 8 8 9 16 14 16 16 16 9 9 9 2 16 16 16 0 0 0 0 0
0 0 16 9 16 16 16 8 8 8 8 8 8 8 9 16 16 16 16 16 9 9 9 9 2 2 16 0 0 0 0 0
0 16 9 15 16 16 9 8 8 8 8 8 8 8 9 16 16 16 16 16 9 9 9 9 9 2 2 16 0 0 0 0
0 16 9 15 15 9 8 8 8 10 8 8 8 8 8 16 16 16 16 16 15 9 9 9 9 2 2 16 0 0 0 0
16 8 9 9 9 9 8 8 10 10 10 8 8 8 8 9 16 16 16 15 15 9 9 9 9 9 2 2 16 0 0 0
16 8 8 9 9 8 8 2 10 10 10 2 8 8 8 8 9 9 9 9 9 9 9 9 9 9 9 2 2 16 0 0
16 8 8 8 8 8 8 8 12 12 12 8 8 8 8 8 8 9 9 9 9 9 9 9 9 8 9 9 2 2 16 0
16 8 8 8 8 8 8 8 8 2 8 8 8 8 8 8 8 8 8 8 9 9 9 8 8 8 9 9 2 2 16 0
0 16 8 8 8 8 8 8 8 2 8 8 8 8 8 8 8 8 8 8 8 8 8 8 8 9 9 9 2 2 2 16
0 16 8 8 8 8 16 8 8 16 8 8 16 16 8 8 8 8 8 8 8 8 8 8 9 9 9 9 2 2 2 16
0 0 16 8 17 17 5 16 16 5 16 16 16 8 8 8 8 8 8 8 8 8 8 9 9 9 9 9 9 2 2 16
0 0 17 17 6 6 5 17 5 5 5 5 5 17 8 8 8 8 8 8 8 8 9 9 9 9 9 9 9 2 2 16
0 17 6 6 6 6 17 5 5 6 6 5 5 17 2 2 2 2 2 9 9 9 9 9 9 9 9 9 9 2 2 16
0 17 6 6 6 6 17 6 6 6 6 5 17 2 2 2 9 9 9 9 9 9 9 9 9 9 9 9 2 2 2 16
0 0 17 6 6 17 6 6 6 6 5 17 2 2 2 9 9 9 9 9 9 9 9 9 9 9 9 9 2 2 2 16
0 17 5 6 6 17 6 6 6 6 5 5 17 2 9 9 9 9 9 9 9 9 9 9 9 2 2 2 2 2 16 0
0 17 5 5 5 5 6 6 6 5 5 5 17 2 2 16 16 9 9 9 9 9 2 2 2 2 2 2 2 2 16 0
0 0 17 5 5 5 5 5 5 5 5 17 2 2 16 12 12 9 9 9 9 2 16 16 16 2 2 2 2 16 0 0
0 0 0 17 17 17 5 5 17 17 17 2 2 16 12 12 12 12 9 2 2 16 12 12 12 2 2 2 16 0 0 0
0 0 0 0 0 0 17 17 0 16 16 16 16 16 12 12 12 12 9 16 16 16 12 12 12 12 16 16 0 0 0 0
0 0 0 0 0 0 0 0 0 0 0 0 0 0 16 16 16 16 16 0 0 0 16 16 16 16 0 0 0 0 0 0
---
0 0 0 0 2 2 2 2 0 2 2 2 2 2 2 2 2 2 0 0 0 0 0 0 0 0 0 0 0 0 0 0
0 0 0 2 17 17 8 8 2 2 8 8 9 9 9 9 9 9 2 2 0 2 2 2 0 0 0 0 0 0 0 0
0 0 2 17 17 17 2 2 8 8 8 9 9 9 9 9 16 16 16 16 2 16 16 16 2 0 0 0 0 0 0 0
0 0 2 17 17 2 8 8 8 8 9 9 9 9 9 16 16 16 16 2 16 16 16 16 16 2 0 0 0 0 0 0
0 0 2 17 2 8 8 8 8 8 9 9 9 9 9 16 16 16 16 16 16 16 16 16 16 16 2 0 0 0 0 0
0 0 2 17 2 8 8 8 8 9 9 9 9 9 16 16 16 16 16 16 16 16 16 2 2 16 2 0 0 0 0 0
0 0 0 2 8 8 8 8 9 9 9 9 9 9 16 16 16 16 16 16 16 16 2 8 8 2 8 2 0 0 0 0
0 0 0 2 8 8 8 8 9 9 9 9 9 9 16 16 16 16 16 16 16 16 2 8 8 8 8 2 0 0 0 0
0 0 0 2 8 2 2 8 9 9 9 9 9 9 16 16 16 16 16 16 16 16 2 8 8 8 8 2 0 0 0 0
0 0 2 8 2 15 2 8 9 9 9 9 9 9 16 16 6 6 6 16 16 16 16 8 8 8 8 2 0 0 0 0
0 0 2 8 2 2 2 8 9 9 9 9 9 9 16 6 6 6 6 6 16 16 16 8 2 2 2 0 0 0 0 0
0 0 2 8 2 2 2 9 9 9 9 9 9 9 16 6 6 6 6 6 16 16 16 16 8 8 2 0 0 0 0 0
0 2 8 5 2 2 8 9 9 9 9 9 9 9 16 6 6 6 6 6 16 16 16 16 16 8 8 2 0 0 0 0
0 2 8 5 5 8 9 9 9 12 9 9 9 9 9 6 6 6 6 6 6 16 16 16 16 8 8 2 0 0 0 0
2 9 8 8 8 8 9 9 12 12 12 9 9 9 9 16 6 6 6 6 6 16 16 16 16 16 8 8 2 0 0 0
2 9 9 8 8 9 9 14 12 12 12 14 9 9 9 9 16 16 16 16 16 16 16 16 16 16 16 8 8 2 0 0
2 9 9 9 9 9 9 9 17 17 17 9 9 9 9 9 9 16 16 16 16 16 16 16 16 9 16 16 8 8 2 0
2 9 9 9 9 9 9 9 9 6 9 9 9 9 9 9 9 9 9 9 16 16 16 9 9 9 16 16 8 8 2 0
0 2 9 9 9 9 9 9 9 6 9 9 9 9 9 9 9 9 9 9 9 9 9 9 9 16 16 16 8 8 8 2
0 2 9 9 9 9 12 9 9 12 9 9 12 12 9 9 9 9 9 9 9 9 9 9 16 16 16 16 8 8 8 2
0 0 2 9 9 9 9 12 12 9 12 12 12 9 9 9 9 9 9 9 9 9 9 16 16 16 16 16 16 8 8 2
0 0 9 9 5 5 9 15 9 9 9 9 9 12 9 9 9 9 9 9 9 9 16 16 16 16 16 16 16 8 8 2
0 9 5 5 5 5 15 9 9 5 5 9 9 12 17 17 17 17 17 8 8 8 16 16 16 16 16 16 16 8 8 2
0 9 5 5 5 5 15 5 5 5 5 9 12 17 17 17 8 8 8 8 8 8 8 16 16 16 16 16 8 8 8 2
0 0 9 5 5 15 5 5 5 5 9 12 17 17 17 8 8 8 8 8 8 8 8 16 16 16 16 16 8 8 8 2
0 9 9 5 5 15 5 5 5 5 9 9 9 17 8 8 8 8 8 8 8 8 8 8 8 8 8 8 8 8 2 0
0 9 9 9 9 9 5 5 5 9 9 9 9 17 17 8 8 8 8 8 8 8 8 8 8 8 8 8 8 8 2 0
0 0 9 9 9 9 9 9 9 9 9 9 17 17 8 8 8 8 8 8 8 8 8 8 8 8 8 8 8 2 0 0
0 0 0 9 9 9 9 9 9 9 9 17 17 8 8 8 8 8 8 8 8 8 10 10 10 8 8 8 2 0 0 0
0 0 0 0 0 0 9 9 0 8 8 8 8 8 8 8 8 8 8 8 8 2 10 10 10 10 2 2 0 0 0 0
0 0 0 0 0 0 0 0 0 0 0 0 0 0 8 8 8 8 8 0 0 0 2 2 2 2 0 0 0 0 0 0
