0 0 0 0 0 0 0 0 18 18 0 0 0 0 0 0 0 0
0 0 0 0 0 0 0 18 10 13 18 18 0 0 0 0 0 0
0 0 0 0 0 0 18 10 18 18 13 13 18 0 0 0 0 0
0 0 0 0 18 18 10 13 10 13 18 18 0 0 0 0 0 0
0 0 0 18 10 10 10 10 13 13 10 13 18 0 0 0 0 0
0 0 18 10 10 10 10 10 13 13 13 13 13 18 0 0 0 0
0 18 13 13 10 10 13 13 13 13 13 13 13 13 18 0 0 0
0 18 18 13 13 13 13 13 18 18 13 13 13 13 18 0 0 0
18 13 14 18 18 13 18 18 14 13 13 13 13 13 13 18 0 18
18 13 14 18 14 18 14 18 14 13 13 13 13 13 13 18 18 0
18 13 13 14 9 19 19 14 13 13 13 13 13 13 13 18 18 18
18 13 13 9 9 19 19 19 13 13 13 13 13 13 13 18 18 0
18 13 13 9 18 9 18 19 13 13 13 13 13 13 13 18 18 18
18 13 13 13 9 18 19 14 14 14 7 13 13 13 13 18 0 0
0 18 13 14 14 9 14 14 14 14 7 7 7 13 18 0 0 0
0 0 18 18 14 14 14 7 7 7 7 7 18 18 0 0 0 0
0 0 0 0 18 18 18 18 18 18 18 18 0 0 0 0 0 0
---
0 0 0 0 0 0 0 0 13 13 0 0 0 0 0 0 0 0
0 0 0 0 0 0 0 13 13 9 13 13 0 0 0 0 0 0
0 0 0 0 0 0 13 13 13 13 9 9 13 0 0 0 0 0
0 0 0 0 13 13 13 9 13 9 13 13 0 0 0 0 0 0
0 0 0 13 13 13 13 13 9 9 13 19 13 0 0 0 0 0
0 0 13 13 13 13 13 13 7 7 19 19 18 13 0 0 0 0
0 13 10 10 13 13 7 7 7 19 19 19 19 18 14 0 0 0
0 13 13 10 10 7 7 7 13 13 18 18 18 18 14 0 0 0
13 10 13 13 13 7 13 13 13 18 18 18 18 18 18 14 0 14
13 10 13 13 13 13 13 13 13 18 18 18 18 18 18 14 14 0
13 10 10 13 18 18 18 13 18 18 18 18 18 18 18 14 14 14
13 10 10 18 18 18 18 18 18 18 18 18 18 18 18 14 14 0
13 10 10 18 14 18 14 18 18 18 18 18 18 18 18 14 14 14
13 10 10 10 18 14 18 13 13 13 18 18 18 18 18 14 0 0
0 13 10 13 13 18 13 13 13 13 18 18 18 18 14 0 0 0
0 0 13 13 13 13 13 18 18 18 18 18 13 14 0 0 0 0
0 0 0 0 13 13 13 13 13 13 13 13 0 0 0 0 0 0
