0 0 0 0 0 0 0 0 0 0 0 0 0 0 0 0 0 0 0
0 0 0 0 0 0 0 0 0 0 0 0 0 0 0 0 0 0 0
0 0 0 0 0 0 0 0 0 0 0 0 0 0 0 0 0 0 0
0 0 0 0 0 0 0 0 0 0 0 0 0 0 0 0 0 0 0
0 0 0 0 0 0 0 0 0 0 0 0 0 0 0 0 0 0 0
0 0 0 0 0 0 0 0 0 0 0 0 0 16 16 16 16 0 0
0 0 0 0 0 0 0 0 0 0 0 16 16 10 10 10 10 16 0
0 0 0 0 0 0 16 16 0 0 16 10 10 10 10 10 10 16 0
0 0 0 0 0 16 15 15 16 16 10 10 10 10 10 10 10 10 16
0 0 0 0 16 15 15 15 15 16 10 10 10 10 10 10 10 10 16
0 16 16 16 16 15 15 15 15 16 16 16 16 10 10 3 3 16 0
16 15 15 15 15 15 15 15 15 15 15 15 15 16 3 3 3 3 16
16 15 15 15 16 14 15 15 16 14 15 15 15 16 3 3 3 3 16
0 16 15 15 16 16 15 15 16 16 15 15 16 3 3 16 16 16 0
0 0 16 9 9 15 15 15 15 9 9 16 3 16 16 0 0 0 0
0 0 16 15 15 15 15 15 15 15 15 16 16 0 0 0 0 0 0
0 0 16 15 15 15 16 16 15 15 15 16 0 0 0 0 0 0 0
0 0 16 15 15 16 0 0 16 15 15 16 0 0 0 0 0 0 0
0 0 0 16 16 0 0 0 0 16 16 0 0 0 0 0 0 0 0
---
0 0 0 0 0 0 0 0 0 0 0 0 0 0 0 0 0 0 0
0 0 0 0 0 0 0 0 0 0 0 0 0 0 0 0 0 0 0
0 0 0 0 0 0 0 0 0 0 0 0 0 0 0 0 0 0 0
0 0 0 0 0 0 0 0 0 0 0 0 0 0 0 0 0 0 0
0 0 0 0 0 0 0 0 0 0 0 0 0 0 0 0 0 0 0
0 0 0 0 0 0 0 0 0 0 0 0 0 15 15 15 15 0 0
0 0 0 0 0 0 0 0 0 0 0 15 15 16 16 16 16 15 0
0 0 0 0 0 0 15 15 0 0 15 16 16 16 16 16 16 15 0
0 0 0 0 0 15 10 10 15 15 16 16 16 16 16 16 16 16 15
0 0 0 0 15 10 10 10 10 15 16 16 16 16 16 16 16 16 15
0 15 15 15 15 10 10 10 10 15 15 15 15 16 16 16 16 15 0
15 10 10 10 10 10 10 16 16 16 16 16 16 15 16 16 16 16 15
15 10 10 10 9 9 10 16 3 15 16 16 16 15 16 16 16 16 15
0 15 10 10 9 9 10 16 3 3 16 16 15 16 16 15 15 15 0
0 0 15 14 14 10 10 16 16 3 3 15 16 15 15 0 0 0 0
0 0 15 10 10 10 16 16 3 3 3 15 15 0 0 0 0 0 0
0 0 15 16 16 16 15 15 3 3 3 15 0 0 0 0 0 0 0
0 0 15 16 16 15 0 0 15 3 3 15 0 0 0 0 0 0 0
0 0 0 15 15 0 0 0 0 15 15 0 0 0 0 0 0 0 0
