0 0 0 0 0 0 0 0 0 0 0 0 0 0 0 0 0 0 0 0 0 0 0 0 0 0 0 0 0 0 0 0
0 0 0 0 0 0 0 0 0 0 0 0 0 0 0 0 12 12 12 12 0 0 0 0 4 4 4 4 0 0 0 0
0 0 0 0 0 0 0 0 0 0 0 0 0 0 0 12 15 9 9 15 12 0 4 4 1 1 1 4 0 0 0 0
0 0 0 0 0 0 0 0 0 0 0 0 0 0 5 12 15 15 9 9 15 12 1 1 5 5 5 5 17 0 0 0
0 0 0 0 0 0 17 17 5 5 17 0 0 17 5 12 9 15 15 15 15 12 5 5 5 5 5 17 0 0 0 0
0 0 0 0 0 0 17 5 5 5 5 17 0 12 12 12 12 12 15 15 9 12 12 12 12 12 17 0 0 0 0 0
0 0 0 0 0 0 0 17 5 5 5 5 12 15 9 9 15 12 9 9 12 15 15 15 15 15 12 5 5 5 5 0
0 0 0 0 0 0 0 12 12 12 5 12 15 9 9 15 15 9 5 5 15 15 9 9 9 15 15 12 5 5 5 0
0 0 0 0 0 0 12 15 15 15 12 12 15 15 15 15 15 9 5 5 9 15 15 15 9 15 15 12 5 17 17 0
0 0 0 0 0 12 15 9 15 15 9 12 15 15 15 15 12 12 12 12 9 9 15 9 15 15 9 12 17 0 0 0
0 0 0 0 12 15 9 9 15 9 15 15 15 15 12 12 9 15 15 15 12 9 15 15 15 15 12 5 5 5 17 0
0 0 0 0 12 15 9 15 9 15 9 15 15 12 15 15 9 15 15 15 15 12 9 9 12 12 5 5 17 17 0 0
0 0 5 5 12 15 15 15 12 15 9 9 9 12 15 9 15 9 9 15 15 9 9 12 17 5 5 5 5 0 0 0
0 5 5 5 5 12 15 12 15 15 15 15 15 12 15 15 9 9 15 15 15 9 12 17 17 17 17 5 5 17 0 0
5 5 5 5 17 17 12 12 12 12 15 15 9 9 15 15 9 15 15 15 15 15 17 17 17 17 17 17 17 17 0 0
5 5 17 17 17 12 15 15 0 12 9 9 9 12 15 15 15 15 15 15 15 12 17 17 17 17 5 17 4 0 0 0
0 0 0 0 12 15 15 9 15 9 12 12 12 12 12 15 9 15 15 15 9 17 17 5 5 5 17 1 4 0 0 0
0 0 5 5 12 15 9 9 15 9 15 15 15 12 17 12 12 9 12 12 17 17 17 5 5 5 5 1 1 4 0 0
0 5 5 5 5 12 15 9 9 15 15 9 15 15 12 17 17 17 17 17 17 5 5 5 5 5 17 1 1 4 0 0
0 5 5 5 5 5 12 9 15 15 9 9 15 15 12 17 17 17 17 5 5 5 5 5 5 5 17 1 1 4 0 0
5 5 5 5 5 5 17 15 15 15 9 15 15 15 15 17 5 5 5 17 17 5 5 5 5 17 17 1 1 4 0 0
5 5 5 5 5 5 5 15 15 15 15 15 15 15 9 17 5 5 5 5 5 17 17 17 17 4 1 1 1 4 0 0
5 5 17 5 5 4 5 12 15 15 15 15 15 9 17 5 5 5 5 5 5 17 18 18 18 4 1 1 4 4 0 4
17 17 0 17 17 0 4 1 4 12 12 12 12 12 5 5 5 5 5 5 17 18 18 1 1 1 1 1 4 1 4 1
0 0 0 0 0 0 4 1 1 4 18 18 18 17 5 5 5 5 5 5 17 18 4 1 1 1 1 4 1 4 1 1
0 0 0 0 0 0 0 4 1 1 1 1 18 18 17 5 5 5 5 5 17 18 4 4 4 4 4 1 1 4 4 1
0 0 0 0 0 0 0 4 1 1 1 1 1 18 17 17 5 5 5 17 18 4 4 4 4 18 1 1 4 1 1 4
0 0 0 0 0 0 0 0 4 1 1 1 4 18 18 0 17 17 5 17 18 18 18 4 18 4 4 4 4 1 1 1
0 0 0 0 0 0 0 0 4 1 4 18 18 0 0 0 0 0 17 0 0 0 0 18 4 4 4 18 1 1 1 1
0 0 0 0 0 0 0 0 18 18 18 0 0 0 0 0 0 0 0 0 0 0 0 0 18 18 18 1 1 1 1 1
0 0 0 0 0 0 0 0 0 0 0 0 0 0 0 0 0 0 0 0 0 0 0 18 4 4 4 1 1 1 1 1
0 0 0 0 0 0 0 0 0 0 0 0 0 0 0 0 0 0 0 0 0 0 0 18 18 18 18 4 1 1 1 1
---
0 0 0 0 0 0 0 0 0 0 0 0 0 0 0 0 0 0 0 0 0 0 0 0 0 0 0 0 0 0 0 0
0 0 0 0 0 0 0 0 0 0 0 0 0 0 0 0 15 15 15 15 0 0 0 0 9 9 9 9 0 0 0 0
0 0 0 0 0 0 0 0 0 0 0 0 0 0 0 15 1 1 1 1 15 0 9 9 9 9 9 9 0 0 0 0
0 0 0 0 0 0 0 0 0 0 0 0 0 0 4 15 1 1 1 1 1 15 9 9 12 12 12 12 12 0 0 0
0 0 0 0 0 0 15 15 18 18 18 0 0 18 4 15 1 1 1 1 1 15 12 12 12 12 12 12 0 0 0 0
0 0 0 0 0 0 15 18 18 18 18 18 0 15 15 15 15 15 1 1 15 15 15 15 15 15 12 0 0 0 0 0
0 0 0 0 0 0 0 15 18 18 18 18 15 1 4 4 1 15 15 15 15 5 5 5 5 5 15 4 4 4 4 0
0 0 0 0 0 0 0 15 15 15 18 15 1 4 4 1 1 15 4 4 5 5 5 5 5 5 5 15 4 4 4 0
0 0 0 0 0 0 15 1 1 1 15 15 1 1 1 1 1 15 4 4 12 5 5 5 5 5 5 15 4 4 4 0
0 0 0 0 0 15 1 15 1 1 15 15 1 1 1 1 1 1 1 1 12 12 5 5 5 5 5 15 4 0 0 0
0 0 0 0 15 1 15 15 1 15 1 1 1 1 1 1 17 5 5 5 1 12 5 5 5 5 15 9 9 9 9 0
0 0 0 0 15 1 15 1 15 1 15 1 1 1 5 5 17 5 5 5 5 1 12 12 15 15 9 9 9 9 0 0
0 0 18 18 15 1 1 1 15 1 15 15 15 1 5 17 5 17 17 5 5 12 12 15 5 9 9 9 9 0 0 0
0 18 18 18 18 15 1 15 1 1 1 1 1 1 5 5 17 17 5 5 5 12 15 5 5 5 5 9 9 5 0 0
18 18 18 18 18 18 15 15 15 15 1 1 5 5 5 5 17 5 5 5 5 5 5 5 5 5 5 5 5 5 0 0
18 18 18 18 18 15 9 9 0 15 5 5 5 15 5 5 5 5 5 5 5 1 5 5 5 5 15 5 12 0 0 0
0 0 0 0 15 9 9 5 9 5 15 15 15 15 15 5 17 5 5 5 1 5 5 15 15 15 5 17 12 0 0 0
0 0 12 12 15 9 5 5 9 5 9 9 9 15 5 15 15 17 17 17 5 5 5 15 15 15 15 17 17 12 0 0
0 12 12 12 12 15 9 5 5 9 9 1 9 9 15 5 5 5 5 5 5 15 15 15 15 15 5 17 17 12 0 0
0 12 12 12 12 12 15 5 9 9 1 1 9 9 15 5 5 5 5 15 15 15 15 15 15 15 5 17 17 12 0 0
12 12 12 12 12 12 12 9 9 9 1 9 9 9 9 5 15 15 15 5 5 15 15 15 15 5 5 17 17 12 0 0
12 12 12 12 12 12 12 9 9 9 9 9 9 9 9 5 15 15 15 15 15 5 5 5 5 15 17 17 17 12 0 0
12 12 9 12 12 17 12 17 9 9 9 9 9 18 5 15 15 15 15 15 15 5 4 4 4 15 17 17 12 12 0 12
9 9 0 9 9 0 17 4 5 5 5 5 5 5 15 15 15 15 15 15 5 4 4 17 17 17 17 17 12 17 12 17
0 0 0 0 0 0 17 4 4 5 17 17 17 5 15 15 15 15 15 15 5 4 12 17 17 17 17 12 17 12 17 17
0 0 0 0 0 0 0 17 4 4 4 4 17 17 5 15 15 15 15 15 5 4 12 12 12 12 12 17 17 12 12 17
0 0 0 0 0 0 0 17 4 4 4 4 4 17 5 5 15 15 15 5 4 12 12 12 12 4 17 17 12 17 17 12
0 0 0 0 0 0 0 0 17 4 4 4 12 17 17 0 5 5 15 5 4 4 4 12 4 12 12 12 12 17 17 17
0 0 0 0 0 0 0 0 17 4 1 17 17 0 0 0 0 0 5 0 0 0 0 4 12 12 12 4 17 17 17 17
0 0 0 0 0 0 0 0 17 17 17 0 0 0 0 0 0 0 0 0 0 0 0 0 4 4 4 17 17 17 17 17
0 0 0 0 0 0 0 0 0 0 0 0 0 0 0 0 0 0 0 0 0 0 0 4 18 18 18 17 17 17 17 17
0 0 0 0 0 0 0 0 0 0 0 0 0 0 0 0 0 0 0 0 0 0 0 4 4 4 4 18 17 17 17 17
