0 0 0 0 0 0 0 0 8 13 8 0 0 0 0 0 0 0 0
0 0 8 8 8 8 8 8 13 13 13 8 8 8 8 8 8 0 0
0 8 13 8 13 8 5 8 8 13 8 8 17 8 13 8 13 8 0
0 8 8 13 13 8 5 5 8 8 8 17 17 8 13 13 8 8 0
0 8 13 13 13 8 5 5 5 8 17 17 17 8 13 13 13 8 0
0 8 8 8 8 8 5 5 5 8 17 17 17 8 8 8 8 8 0
0 8 17 17 17 17 8 5 5 8 17 17 8 5 5 5 5 8 0
0 8 8 17 17 17 17 8 5 8 17 8 5 5 5 5 8 8 0
8 13 8 8 17 17 17 17 8 9 8 5 5 5 5 8 8 13 8
13 13 13 8 8 8 8 8 9 9 9 8 8 8 8 8 13 13 13
8 13 8 8 5 5 5 5 8 9 8 17 17 17 17 8 8 13 8
0 8 8 5 5 5 5 8 17 8 5 8 17 17 17 17 8 8 0
0 8 5 5 5 5 8 17 17 8 5 5 8 17 17 17 17 8 0
0 8 8 8 8 8 17 17 17 8 5 5 5 8 8 8 8 8 0
0 8 13 13 13 8 17 17 17 8 5 5 5 8 13 13 13 8 0
0 8 8 13 13 8 17 17 8 8 8 5 5 8 13 13 8 8 0
0 8 13 8 13 8 17 8 8 13 8 8 5 8 13 8 13 8 0
0 0 8 8 8 8 8 8 13 13 13 8 8 8 8 8 8 0 0
0 0 0 0 0 0 0 0 8 13 8 0 0 0 0 0 0 0 0
---
0 0 0 0 0 0 0 0 17 8 17 0 0 0 0 0 0 0 0
0 0 13 13 13 13 13 17 8 8 8 17 17 5 5 5 5 0 0
0 13 8 13 8 13 8 17 17 8 17 17 8 5 8 5 8 5 0
0 13 13 8 8 13 8 8 17 17 17 8 8 5 8 8 5 5 0
0 13 8 8 8 13 8 8 8 17 8 8 8 5 8 8 8 5 0
0 13 13 13 13 13 8 8 8 17 8 8 8 5 5 5 5 5 0
0 13 8 8 8 8 17 8 8 17 8 8 17 8 8 8 8 5 0
0 13 13 8 8 8 8 17 8 17 8 17 8 8 8 8 5 5 0
13 8 13 8 8 8 8 8 17 8 17 8 8 8 8 5 5 8 5
8 8 8 13 13 13 13 13 8 8 8 17 17 5 5 5 8 8 8
13 8 13 13 8 8 8 8 17 8 17 8 8 8 8 5 5 8 5
0 13 13 8 8 8 8 17 8 17 8 17 8 8 8 8 5 5 0
0 13 8 8 8 8 17 8 8 17 8 8 17 8 8 8 8 5 0
0 13 13 13 13 13 8 8 8 17 8 8 8 5 5 5 5 5 0
0 13 8 8 8 17 8 8 8 17 8 8 8 5 8 8 8 5 0
0 13 13 8 8 17 8 8 17 17 17 8 8 5 8 8 9 5 0
0 13 8 13 8 17 8 17 17 8 17 17 8 5 8 9 8 9 0
0 0 13 13 13 13 17 17 8 5 5 5 5 5 5 9 9 0 0
0 0 0 0 0 0 0 0 17 8 17 0 0 0 0 0 0 0 0
