0 0 0 18 0 0 0 0 18 0 0 0
0 0 18 1 18 0 0 18 1 18 0 0
0 18 18 1 18 18 18 18 1 18 18 0
18 10 18 1 18 10 10 18 1 18 10 18
18 10 10 10 10 10 10 10 10 10 10 18
18 10 10 10 10 10 10 10 10 10 10 18
18 8 8 8 8 8 8 8 8 8 8 18
18 14 14 14 18 14 18 18 18 14 14 18
18 14 14 18 18 14 18 14 18 14 14 18
18 14 14 14 18 14 18 14 18 14 14 18
18 14 14 18 18 18 18 18 18 14 14 18
18 14 14 14 14 14 14 14 14 14 14 18
0 18 18 18 18 18 18 18 18 18 18 0
---
0 0 0 10 0 0 0 0 10 0 0 0
0 0 10 18 10 0 0 10 18 10 0 0
0 10 10 18 10 10 10 10 18 10 10 0
10 18 10 18 10 18 18 10 18 10 18 10
10 18 18 18 18 18 18 18 18 18 18 10
10 8 8 8 8 8 8 8 8 8 8 10
14 18 18 18 18 18 18 18 18 18 18 14
14 18 18 18 14 18 14 14 14 18 18 14
14 18 18 14 14 18 14 18 14 18 18 14
14 18 18 18 14 18 14 18 14 18 18 14
14 18 18 14 14 14 14 14 14 18 18 14
14 18 18 18 18 18 18 18 18 18 18 14
0 14 14 1 1 1 1 1 1 14 14 0
