0 0 0 18 18 18 18 0 0 0
0 18 18 14 14 14 14 18 18 0
18 14 14 14 10 10 2 14 14 18
18 14 13 13 9 15 2 2 14 18
18 14 14 13 9 15 14 14 14 18
18 18 18 14 14 14 14 18 18 18
18 5 5 18 18 18 18 5 17 18
18 5 5 5 5 5 5 5 17 18
18 5 18 5 5 18 5 5 17 18
18 7 5 5 5 5 7 17 17 18
0 18 17 17 17 17 17 17 18 0
0 0 18 18 18 18 18 18 0 0
---
0 0 0 14 14 14 14 0 0 0
0 17 17 18 18 18 18 14 14 0
17 18 18 18 9 9 17 18 18 14
17 18 17 17 7 2 17 17 18 14
17 18 18 17 7 2 18 18 18 14
5 5 5 18 18 18 18 14 14 14
5 18 18 14 14 14 14 18 15 14
5 18 18 18 18 18 18 18 15 14
5 18 10 18 18 10 18 18 13 14
5 5 18 18 18 18 2 13 13 14
0 5 18 18 18 5 5 5 5 0
0 0 5 5 5 5 5 5 0 0
