0 0 0 16 16 16 16 16 0 0 0
0 16 16 16 16 16 16 16 16 16 0
16 16 16 16 16 16 16 16 16 16 16
16 9 9 16 9 9 9 16 9 9 16
16 9 16 9 14 9 14 9 16 9 16
16 16 9 9 16 9 16 9 9 16 16
16 16 9 9 9 9 9 9 9 16 16
16 16 9 14 16 16 16 14 9 16 16
16 16 14 14 14 16 14 14 14 16 16
16 16 16 14 16 14 16 14 16 16 16
0 16 16 16 14 14 14 16 16 16 0
0 9 9 16 16 16 16 16 9 9 0
9 9 9 9 9 9 9 9 9 9 9
---
0 0 0 9 9 9 9 9 0 0 0
0 9 9 9 9 9 9 9 9 9 0
9 9 9 9 9 9 9 9 9 9 9
9 16 16 9 16 16 16 16 16 16 16
9 16 9 16 16 16 16 16 16 16 16
9 9 16 16 16 16 16 16 16 16 16
9 9 16 16 16 16 16 16 16 16 16
9 9 16 16 14 14 14 16 16 16 16
9 9 16 16 16 14 16 16 16 16 16
9 9 9 16 16 16 16 16 14 14 16
0 9 14 14 16 16 16 14 14 14 0
0 16 16 14 14 14 14 14 16 16 0
16 16 16 16 16 16 16 16 16 16 16
