0 0 0 0 0 0 0 0 0 0 0 0 0 0 0 0 0 0 16 16 16 0 0 0
0 0 0 16 16 16 16 16 16 16 16 16 16 16 0 0 16 16 8 8 8 16 16 0
0 0 16 9 8 8 8 8 8 8 8 8 8 9 16 16 8 13 13 13 13 8 8 16
0 16 9 8 8 13 13 13 13 2 2 2 2 2 2 2 2 7 7 7 13 13 8 16
0 16 9 8 13 7 7 7 2 2 14 14 14 14 14 14 14 2 2 7 7 7 13 16
0 16 9 13 7 7 2 2 14 14 14 14 14 5 14 5 14 14 14 2 7 7 13 16
0 16 9 13 7 2 14 14 14 14 14 14 14 14 14 14 14 14 14 14 2 7 13 16
0 16 9 13 2 14 14 5 14 14 2 2 2 2 2 14 14 14 14 14 2 7 13 16
0 16 17 17 2 14 14 14 14 2 15 15 15 15 15 2 14 14 14 2 7 7 13 16
17 17 17 6 2 14 5 14 2 15 15 14 15 15 15 15 2 14 14 2 13 13 8 16
17 6 6 6 6 2 14 14 2 15 14 15 15 15 15 15 2 14 5 14 2 8 9 16
17 6 6 6 6 6 2 14 2 15 14 15 15 15 9 15 2 14 14 14 2 2 9 16
17 17 6 6 6 2 14 14 2 15 15 15 9 9 9 15 2 14 14 14 14 2 9 16
0 17 6 6 6 2 14 14 2 15 15 9 9 9 9 15 2 14 14 5 14 2 16 0
0 17 17 6 2 14 14 14 14 2 15 15 15 15 15 2 14 14 14 14 14 2 17 0
0 0 17 17 2 14 14 14 5 14 2 2 2 2 2 14 14 14 14 14 2 6 17 17
0 0 17 6 2 14 5 14 14 14 14 14 14 14 14 14 5 14 14 14 2 6 6 17
0 17 17 6 6 2 2 14 14 14 14 14 14 14 14 5 14 14 14 2 6 6 17 17
0 17 6 6 6 6 2 14 14 14 14 5 14 14 14 14 14 14 2 17 17 17 17 0
0 17 6 6 6 6 6 2 2 2 2 2 2 2 2 2 2 2 13 8 8 8 9 16
0 16 17 17 6 6 6 6 6 6 13 13 7 7 7 7 7 13 13 8 8 9 9 16
0 16 9 17 17 17 17 17 17 6 17 13 13 13 13 13 13 13 9 9 9 9 9 16
0 0 16 9 9 9 9 9 17 17 17 9 9 9 9 9 9 9 9 9 9 9 16 0
0 0 0 16 16 16 16 16 16 16 16 16 16 16 16 16 16 16 16 16 16 16 0 0
---
0 0 0 0 0 0 0 0 0 0 0 0 0 0 0 0 0 0 9 9 9 0 0 0
0 0 0 9 9 9 9 9 9 9 9 9 9 9 0 0 9 9 17 17 17 9 9 0
0 0 9 16 16 16 16 16 16 16 16 16 16 5 9 9 5 7 7 7 7 17 17 9
0 9 16 16 16 5 5 5 5 14 14 14 14 14 14 14 14 14 14 14 7 7 17 9
0 9 16 16 5 15 15 15 14 14 16 16 16 16 16 16 16 14 14 14 14 14 7 9
0 9 16 5 15 15 14 14 16 16 16 16 16 16 16 16 16 16 16 14 14 14 7 9
0 9 16 5 15 14 16 16 16 16 16 16 16 16 16 16 16 16 16 16 14 14 7 9
0 9 16 5 14 16 16 13 16 16 15 15 15 15 15 16 16 16 16 16 14 14 7 9
0 9 14 14 14 16 16 16 16 15 17 17 17 17 17 15 2 2 2 14 14 14 7 9
14 14 14 13 14 2 7 2 15 17 17 15 17 17 17 17 15 2 2 14 7 7 16 9
14 13 13 13 13 14 2 2 15 17 15 17 17 17 17 17 15 2 8 2 14 16 7 9
14 13 13 13 13 13 14 2 15 17 15 17 17 17 6 17 15 2 2 2 14 14 7 9
14 14 13 13 13 14 2 2 15 17 17 17 6 6 6 17 15 2 2 2 2 14 7 9
0 14 13 13 13 14 2 2 15 17 17 6 6 6 6 17 15 2 2 8 2 14 14 0
0 14 14 13 14 2 2 2 2 15 17 17 17 17 17 15 2 2 2 2 2 14 13 0
0 0 14 14 14 2 2 2 15 2 15 15 15 15 15 2 2 2 2 2 14 13 13 13
0 0 14 8 14 2 8 2 2 2 2 2 2 2 2 2 6 2 2 2 14 13 13 13
0 14 14 8 8 14 14 2 2 2 2 2 2 2 2 6 2 2 2 14 13 13 13 13
0 14 8 8 8 8 14 2 2 2 2 5 2 2 2 2 2 2 14 13 13 13 13 0
0 14 8 8 8 8 8 14 14 14 14 14 14 14 14 14 14 14 6 9 9 9 6 14
0 14 14 14 8 8 8 8 8 8 6 6 8 8 8 8 8 6 6 9 9 6 6 14
0 14 7 14 14 14 14 14 14 17 14 6 6 6 6 6 6 6 6 6 6 6 6 14
0 0 14 7 7 7 7 7 14 14 14 6 6 6 6 6 6 6 6 6 6 6 14 0
0 0 0 14 14 14 14 14 14 14 14 14 14 14 14 14 14 14 14 14 14 14 0 0
