0 0 0 0 0 0 0 0 0 0 0 0 18 18 18 18 0 0 0
0 0 0 0 0 0 0 0 0 0 0 18 0 0 0 0 18 0 0
0 0 0 0 0 0 0 0 0 0 18 18 0 0 0 0 0 18 0
0 0 0 0 0 0 0 0 0 18 10 10 18 0 0 0 0 18 0
0 0 0 11 11 11 11 11 11 11 11 11 11 11 0 0 0 18 0
0 0 11 10 10 10 10 10 10 10 10 10 10 10 11 0 0 18 0
0 0 11 10 18 18 18 18 18 18 18 18 18 10 11 0 0 18 0
0 0 11 10 18 18 15 15 18 15 15 18 18 10 11 0 0 18 0
0 0 11 10 18 18 15 15 15 15 15 18 18 10 11 0 18 0 0
0 0 11 10 18 18 18 15 15 15 18 18 18 10 11 18 0 0 0
0 0 11 10 18 18 18 18 15 18 18 18 18 10 11 0 0 0 0
0 0 11 10 18 18 18 18 18 18 18 18 18 10 11 0 0 18 18
0 0 11 10 10 10 10 10 10 10 10 10 10 10 11 0 18 18 18
0 18 11 10 10 3 3 3 11 3 3 3 10 10 11 0 18 18 18
18 0 11 10 3 11 3 11 11 11 3 11 3 10 11 0 0 18 18
18 0 11 10 11 11 10 10 10 10 10 11 11 10 11 0 0 0 18
0 18 11 10 3 11 3 11 11 11 3 11 3 10 11 18 0 0 18
0 0 11 10 10 3 3 3 11 3 3 3 10 10 11 0 18 0 18
0 0 11 10 10 10 10 10 10 10 10 10 10 10 11 0 18 18 0
0 0 0 11 11 11 11 11 11 11 11 11 11 11 0 0 0 0 0
---
0 0 0 0 0 0 0 0 0 0 0 0 10 10 10 10 0 0 0
0 0 0 0 0 0 0 0 0 0 0 10 0 0 0 0 10 0 0
0 0 0 0 0 0 0 0 0 0 10 10 0 0 0 0 0 10 0
0 0 0 0 0 0 0 0 0 10 18 18 10 0 0 0 0 10 0
0 0 0 10 10 10 10 10 10 10 10 10 10 10 0 0 0 10 0
0 0 10 18 18 18 18 18 18 18 18 18 18 18 10 0 0 10 0
0 0 10 18 3 3 3 3 11 11 11 11 11 18 10 0 0 10 0
0 0 10 18 3 3 11 11 11 11 11 11 11 18 10 0 0 10 0
0 0 10 18 3 3 11 11 11 11 11 11 11 18 10 0 10 0 0
0 0 10 18 3 3 3 11 11 11 11 11 11 18 10 10 0 0 0
0 0 10 18 3 3 3 3 11 11 11 11 11 18 10 0 0 0 0
0 0 15 18 3 3 3 3 3 11 11 11 11 18 10 0 0 10 10
0 0 15 18 18 18 18 18 18 18 18 18 18 18 10 0 10 10 10
0 15 15 18 18 11 11 11 18 11 11 11 18 18 10 0 10 10 10
15 0 15 18 11 18 11 18 18 18 11 18 11 18 10 0 0 10 10
15 0 15 18 18 18 11 11 11 11 11 18 18 18 10 0 0 0 10
0 15 15 18 11 18 11 18 18 18 11 18 11 18 10 10 0 0 10
0 0 15 18 18 11 11 11 18 11 11 11 18 18 10 0 10 0 10
0 0 15 18 18 11 11 11 11 11 11 11 18 18 10 0 10 10 0
0 0 0 15 18 18 18 18 18 18 18 18 18 18 0 0 0 0 0
