0 16 16 16 16 16 16 16 16 0
0 16 14 14 14 14 14 14 16 0
16 16 16 16 16 16 16 16 16 16
16 14 14 14 14 14 14 14 14 16
16 16 16 16 16 16 16 16 16 16
0 16 2 2 2 2 2 2 16 0
0 16 2 2 17 17 2 2 16 0
0 16 2 17 14 14 17 2 16 0
0 16 2 17 14 14 17 2 16 0
0 16 2 2 17 17 2 2 16 0
0 16 2 2 2 2 2 2 16 0
0 16 14 14 14 14 14 14 16 0
0 16 16 14 14 14 14 16 16 0
0 0 16 16 16 16 16 16 0 0
---
0 16 16 16 16 16 16 16 16 0
0 16 2 2 2 2 2 2 16 0
16 16 16 16 16 16 16 16 16 16
16 17 17 17 17 17 17 17 17 16
16 16 16 16 16 16 16 16 16 16
0 16 2 2 2 2 2 2 16 0
0 16 2 14 14 14 14 2 16 0
0 16 14 14 14 14 14 14 16 0
0 16 14 14 14 14 14 14 16 0
0 16 14 14 14 14 14 14 16 0
0 16 14 14 14 14 14 14 16 0
0 16 2 2 2 2 2 2 16 0
0 16 16 2 2 2 2 16 16 0
0 0 16 16 16 16 16 16 0 0
