0 0 0 0 18 18 18 18 18 18 18 18 18 18 0 0 0 0
0 0 0 18 14 14 14 14 14 14 14 14 14 1 18 0 0 0
0 0 0 18 14 14 14 14 14 14 14 14 14 1 18 0 0 0
0 0 0 18 1 1 1 1 1 1 1 1 1 1 18 0 0 0
0 0 18 1 1 3 3 3 3 3 3 3 3 1 4 18 0 0
0 18 1 1 3 3 3 3 3 3 3 3 1 4 1 1 18 0
18 1 1 1 1 1 1 1 1 1 1 1 1 4 1 1 1 18
18 4 4 4 4 4 4 4 4 4 4 4 4 1 1 3 1 18
18 1 1 1 1 1 1 1 1 1 1 1 4 1 3 3 1 18
18 1 1 18 18 14 14 18 18 18 1 1 4 1 3 3 1 18
18 1 1 1 14 14 14 18 18 1 1 1 4 1 3 3 1 18
18 1 1 18 14 5 14 5 18 18 1 1 4 1 3 3 1 18
18 14 1 18 18 10 10 10 14 14 1 1 4 1 3 1 14 18
18 14 14 14 18 10 10 10 14 1 14 14 4 14 1 14 14 18
18 14 14 14 14 14 14 14 1 14 14 1 4 1 14 14 18 0
18 14 14 14 14 14 14 14 14 14 14 14 4 14 14 18 0 0
18 14 14 14 14 14 14 14 14 14 14 14 4 14 18 0 0 0
0 18 18 18 18 18 18 18 18 18 18 18 18 18 0 0 0 0
---
0 0 0 0 1 1 1 1 1 1 1 1 1 1 0 0 0 0
0 0 0 1 3 3 3 3 3 3 3 3 3 18 1 0 0 0
0 0 0 1 3 3 3 3 3 3 3 3 3 18 1 0 0 0
0 0 0 1 18 18 18 18 18 18 18 18 18 18 1 0 0 0
0 0 1 18 18 4 4 4 4 4 4 4 4 18 14 1 0 0
0 1 18 18 4 4 4 4 4 4 4 4 18 14 18 18 1 0
1 18 18 18 18 18 18 18 18 18 18 18 18 14 18 18 18 1
1 14 14 14 14 14 14 14 14 14 14 14 14 18 18 18 18 1
1 14 14 14 14 14 14 14 14 14 14 14 14 18 18 18 18 1
1 14 14 5 5 18 18 3 3 3 14 14 14 18 18 18 18 1
1 14 14 14 18 18 18 3 3 14 14 14 14 18 18 18 18 1
1 14 14 10 18 10 18 10 3 3 14 14 14 18 18 18 18 1
1 1 14 10 10 4 4 4 3 4 14 14 14 18 18 18 1 1
14 1 1 1 10 4 4 4 4 14 1 1 14 1 18 1 1 1
14 1 1 1 1 1 1 1 14 1 1 18 14 18 1 1 14 0
14 1 1 1 1 1 1 1 1 1 1 1 14 1 1 14 0 0
14 1 1 1 1 1 1 1 1 1 1 1 14 1 14 0 0 0
0 14 14 14 14 14 14 14 14 14 14 14 14 14 0 0 0 0
