0 16 16 16 16 16 16 16 16 0
16 15 15 15 15 15 15 15 15 16
16 15 15 15 15 15 15 15 15 16
16 15 14 14 15 15 14 14 15 16
16 15 14 16 15 15 16 14 15 16
16 15 14 16 15 15 16 14 15 16
16 15 15 15 15 15 15 15 15 16
16 15 15 15 15 15 15 15 15 16
16 14 14 14 13 13 14 14 14 16
16 2 2 2 13 13 2 2 2 16
16 16 2 16 16 16 16 2 16 16
0 16 16 16 0 0 16 16 16 0
---
0 15 15 15 15 15 15 15 15 0
15 16 16 16 16 16 16 16 16 15
15 16 16 16 16 16 16 16 16 15
15 16 15 15 16 16 15 15 16 15
15 16 15 14 16 16 14 15 16 15
15 16 15 14 16 16 14 15 16 15
15 16 16 16 16 16 16 16 16 15
15 16 16 16 16 16 16 16 16 15
15 13 13 13 2 15 15 15 15 15
15 14 14 14 2 2 15 15 15 15
15 2 14 2 13 14 14 15 14 15
0 2 2 2 0 0 14 14 14 0
