0 0 18 18 18 18 0 0 0 0 0 0 18 18 18 18 0 0
0 18 14 14 14 3 18 0 0 0 0 18 3 14 14 14 18 0
18 3 14 14 14 14 3 18 18 18 18 3 14 14 14 14 3 18
18 14 14 18 18 14 14 3 3 3 3 14 14 1 1 14 14 18
18 14 18 18 18 18 14 14 14 14 14 14 5 14 14 13 14 18
18 14 18 18 18 18 14 18 14 14 18 14 5 14 14 13 14 18
18 14 14 18 18 14 14 14 14 14 14 14 14 9 9 14 14 18
18 14 14 14 14 14 14 14 14 14 14 14 14 14 14 14 14 18
18 3 14 14 14 14 3 3 3 3 3 3 14 14 14 14 3 18
18 3 3 14 14 3 18 18 18 18 18 18 3 14 14 3 3 18
18 3 3 14 3 18 0 0 0 0 0 0 18 3 14 3 3 18
0 18 3 3 18 0 0 0 0 0 0 0 0 18 3 3 18 0
0 0 18 18 0 0 0 0 0 0 0 0 0 0 18 18 0 0
---
0 0 14 14 14 14 0 0 0 0 0 0 14 14 14 14 0 0
0 14 18 18 18 14 14 0 0 0 0 14 14 3 3 3 14 0
14 14 18 18 18 18 14 14 14 14 14 14 3 3 3 3 14 14
14 18 18 14 14 18 18 14 14 14 14 3 3 9 9 3 3 14
14 18 14 14 14 14 18 18 18 18 18 18 18 3 3 1 3 14
14 18 14 14 14 14 18 13 18 18 13 18 18 3 3 1 3 14
14 18 18 14 14 18 18 18 18 18 18 18 18 5 5 3 3 14
14 18 18 18 18 18 18 18 18 3 3 3 3 3 3 3 3 14
14 18 18 18 18 18 18 18 18 18 18 14 3 3 3 3 14 14
14 18 18 18 18 18 14 14 14 14 14 14 14 3 3 14 14 14
14 18 18 18 18 14 0 0 0 0 0 0 14 14 3 14 14 14
0 14 18 18 14 0 0 0 0 0 0 0 0 14 14 14 14 0
0 0 14 14 0 0 0 0 0 0 0 0 0 0 14 14 0 0
