0 0 0 0 0 0 18 18 18 18 18 0 0 0 0 0 0 0 0 18 18 18 18 18 0 0 0 0 0 0
0 0 0 0 18 18 13 13 11 7 7 11 18 0 0 0 0 18 18 13 13 13 13 13 18 18 0 0 0 0
0 0 0 18 13 13 15 11 7 7 7 11 13 18 0 0 18 13 13 15 15 15 15 15 13 13 18 0 0 0
0 0 18 13 15 15 11 7 11 7 7 7 11 7 18 18 13 16 15 16 16 15 16 16 15 16 13 18 0 0
0 18 13 11 11 11 7 7 7 7 7 11 11 13 13 13 16 2 16 2 2 16 2 2 16 2 16 13 18 0
0 18 7 7 7 7 11 7 11 11 11 7 7 11 13 13 16 2 19 2 2 16 2 19 2 2 16 13 18 0
0 18 7 7 7 11 7 11 11 7 7 7 11 15 18 18 9 16 2 2 16 9 16 2 2 16 18 13 18 0
18 13 11 7 7 11 7 11 7 11 7 7 11 15 15 15 15 9 16 16 9 15 15 16 16 9 9 18 13 18
11 7 7 11 11 7 7 7 16 16 16 16 15 16 16 16 16 16 15 15 16 16 16 9 9 15 15 18 13 18
11 7 7 7 11 7 16 16 19 19 19 16 16 2 19 2 2 2 16 16 19 19 19 16 16 15 15 18 13 18
11 7 11 15 15 11 16 2 2 19 2 2 16 19 19 2 2 2 16 2 2 19 2 2 16 15 15 18 13 18
18 11 10 18 15 9 16 2 2 2 2 2 16 2 2 2 2 2 16 2 2 2 2 2 16 15 18 10 13 18
18 13 13 10 18 15 9 16 16 16 16 16 9 16 16 16 16 16 9 16 16 16 16 16 15 18 10 13 13 18
0 18 13 13 10 18 15 9 9 16 16 9 16 16 9 9 16 16 15 16 16 15 15 15 18 10 13 13 18 0
0 18 13 13 13 10 18 15 16 2 19 16 2 2 16 16 2 19 16 2 2 16 15 18 10 13 13 13 18 0
0 0 18 13 13 13 10 18 18 2 2 2 2 2 16 16 2 2 2 2 2 18 18 10 13 13 13 18 0 0
0 0 0 18 13 13 13 10 10 18 2 2 2 16 9 9 16 2 2 2 18 10 10 13 13 13 18 0 0 0
0 0 0 0 18 13 13 13 13 10 18 18 18 9 15 15 9 18 18 18 10 13 13 13 13 18 0 0 0 0
0 0 0 0 0 18 13 13 13 13 13 10 18 15 15 15 15 18 10 13 13 13 13 13 18 0 0 0 0 0
0 0 0 0 0 0 18 18 13 13 13 13 10 18 18 18 18 10 13 13 13 13 18 18 0 0 0 0 0 0
0 0 0 0 0 0 0 0 18 13 13 13 13 10 10 10 10 13 13 13 13 18 0 0 0 0 0 0 0 0
0 0 0 0 0 0 0 0 0 18 18 13 13 13 13 13 13 13 13 18 18 0 0 0 0 0 0 0 0 0
0 0 0 0 0 0 0 0 0 0 0 18 18 13 13 13 13 18 18 0 0 0 0 0 0 0 0 0 0 0
0 0 0 0 0 0 0 0 0 0 0 0 0 18 18 18 18 0 0 0 0 0 0 0 0 0 0 0 0 0
---
0 0 0 0 0 0 2 2 2 2 2 0 0 0 0 0 0 0 0 13 13 13 13 13 0 0 0 0 0 0
0 0 0 0 2 2 18 18 2 16 16 2 13 0 0 0 0 13 13 18 18 18 18 18 13 13 0 0 0 0
0 0 0 2 18 18 16 2 16 16 16 2 16 13 0 0 13 18 18 10 10 10 10 10 18 18 13 0 0 0
0 0 2 18 16 16 2 16 2 16 16 16 2 16 13 13 18 7 10 7 7 10 7 7 10 7 18 13 0 0
0 2 18 2 2 2 16 16 16 16 16 2 2 18 18 18 7 10 7 10 10 7 10 10 7 10 7 18 13 0
0 2 16 16 16 16 2 16 2 2 2 16 16 2 18 18 7 10 16 10 10 7 10 16 10 10 7 18 13 0
0 2 16 16 16 2 16 2 2 16 16 16 2 16 16 16 16 7 10 10 7 16 7 10 10 7 13 18 13 0
2 18 2 16 16 2 16 2 16 2 16 16 2 16 16 16 16 16 7 7 16 16 16 7 7 15 15 13 18 13
2 16 16 2 2 16 16 16 15 15 15 15 16 7 7 7 7 7 9 9 7 7 7 15 15 2 2 13 18 13
2 16 16 16 2 16 15 15 16 16 16 15 15 9 16 11 11 11 7 7 16 16 16 7 7 2 2 13 18 13
2 16 2 16 16 2 15 9 9 16 9 9 15 16 16 11 11 11 7 9 9 16 9 9 7 2 2 13 18 13
13 2 2 13 16 15 15 9 9 9 9 9 15 11 11 11 11 11 15 9 9 9 9 9 7 2 13 13 18 13
13 18 18 2 13 16 15 15 15 15 15 15 19 15 15 15 15 15 19 7 7 7 7 7 2 13 13 18 18 13
0 13 18 18 2 13 16 15 15 15 15 19 15 15 19 19 15 15 11 7 7 2 2 2 13 13 18 18 13 0
0 13 18 18 18 2 13 16 15 11 16 15 11 11 15 15 11 11 15 11 11 7 2 13 13 18 18 18 13 0
0 0 13 18 18 18 2 13 13 11 11 11 11 11 15 15 11 11 11 11 11 13 13 13 18 18 18 13 0 0
0 0 0 13 18 18 18 2 2 13 11 11 11 15 19 19 15 11 11 11 13 13 13 18 18 18 13 0 0 0
0 0 0 0 13 18 18 18 18 2 13 13 13 19 19 19 19 13 13 13 13 18 18 18 18 13 0 0 0 0
0 0 0 0 0 13 18 18 18 18 18 13 13 19 19 19 19 13 13 18 18 18 18 18 13 0 0 0 0 0
0 0 0 0 0 0 13 13 18 18 18 18 13 13 13 13 13 13 18 18 18 18 13 13 0 0 0 0 0 0
0 0 0 0 0 0 0 0 13 18 18 18 18 13 13 13 13 18 18 18 18 13 0 0 0 0 0 0 0 0
0 0 0 0 0 0 0 0 0 13 13 18 18 18 18 18 18 18 18 13 13 0 0 0 0 0 0 0 0 0
0 0 0 0 0 0 0 0 0 0 0 13 13 18 18 18 18 13 13 0 0 0 0 0 0 0 0 0 0 0
0 0 0 0 0 0 0 0 0 0 0 0 0 13 13 13 13 0 0 0 0 0 0 0 0 0 0 0 0 0
