0 0 0 0 0 0 0 0 0 9 9 9 0 0 0 0 0 0 0 0 11 11 11 0 0 0 0 0 0 0 0 0
0 0 0 0 0 0 0 9 9 8 8 9 9 9 0 0 0 0 11 11 11 7 7 11 11 0 0 0 0 0 0 0
0 0 0 0 0 0 9 8 8 7 7 8 8 9 0 0 0 0 11 7 7 15 15 7 7 11 0 0 0 0 0 0
0 0 0 0 0 0 9 9 9 8 8 9 9 14 11 11 11 11 11 11 14 7 7 11 11 11 0 0 0 0 0 0
0 0 0 0 0 0 0 0 9 9 9 17 11 11 7 10 10 10 11 11 17 11 11 0 0 0 0 0 0 0 0 0
0 0 0 0 0 11 11 11 14 5 6 17 11 7 10 15 15 10 10 11 17 5 17 0 9 9 9 0 0 0 0 0
0 0 0 0 0 11 10 10 11 5 6 6 17 11 11 11 11 11 11 17 5 5 17 9 8 8 9 0 0 0 0 0
0 0 0 11 11 7 7 10 11 14 5 9 9 17 5 6 6 5 17 11 11 17 14 9 8 7 8 9 9 0 0 0
0 0 0 11 10 7 10 10 11 9 9 8 8 9 9 5 5 11 11 7 7 11 11 9 8 7 7 8 9 0 0 0
0 0 0 11 7 10 10 11 9 8 9 8 8 9 8 9 11 7 11 10 10 11 7 11 9 8 8 8 9 0 0 0
0 0 0 0 11 11 11 5 9 8 8 7 7 8 8 9 11 10 10 15 15 10 10 11 5 9 9 9 0 0 0 0
0 0 0 0 5 6 6 17 5 9 7 10 10 7 9 17 17 11 15 9 9 15 11 5 17 6 6 5 0 0 0 0
0 0 5 5 6 6 6 6 9 8 8 7 7 8 8 9 11 7 10 15 15 10 10 11 6 6 6 6 5 5 0 0
0 0 5 6 6 6 17 17 9 8 9 8 8 9 8 9 11 10 11 10 10 11 10 11 17 17 6 6 6 5 0 0
0 0 0 17 17 17 0 0 5 9 9 8 8 9 9 5 17 11 11 10 10 11 11 5 0 0 17 17 17 0 0 0
0 0 0 0 0 0 0 0 5 6 6 9 9 5 6 5 17 6 17 11 11 6 6 5 0 0 0 0 0 0 0 0
0 0 0 0 0 0 5 5 6 6 6 17 14 5 6 5 17 6 17 14 17 6 6 6 5 5 0 0 0 0 0 0
0 0 0 0 0 0 5 6 6 6 17 14 2 5 6 5 17 6 17 2 14 17 6 6 6 5 0 0 0 0 0 0
0 0 0 0 0 0 0 5 17 17 0 2 15 9 6 5 17 15 15 15 2 0 17 17 5 0 0 0 0 0 0 0
0 0 0 0 0 0 0 0 0 0 0 2 2 15 9 9 15 15 15 2 2 0 0 0 0 0 0 0 0 0 0 0
0 11 0 0 0 0 0 0 0 0 0 0 0 2 15 15 15 9 2 0 0 0 0 0 0 0 0 0 0 0 0 0
11 14 11 0 0 10 0 0 0 0 0 0 0 2 15 9 9 9 2 0 0 0 0 0 0 0 0 0 0 0 11 0
0 11 0 0 0 0 0 0 0 0 0 0 0 0 2 15 15 2 0 0 0 0 0 0 0 0 0 0 0 0 0 0
0 0 0 0 10 0 10 0 0 0 0 0 0 2 15 9 9 9 2 0 0 0 0 0 10 0 0 0 0 0 0 0
0 0 0 0 10 0 10 0 0 0 0 0 0 2 15 15 15 9 2 0 0 0 0 10 14 10 0 0 11 0 0 0
0 0 10 10 0 0 0 10 10 0 0 0 0 2 9 9 9 9 2 0 0 0 0 0 10 0 0 0 11 0 0 0
10 0 0 0 0 0 0 0 0 0 10 0 0 5 2 2 2 2 17 0 0 0 0 0 0 0 0 0 11 0 0 0
0 0 10 10 0 0 0 10 10 0 0 0 0 5 6 5 6 6 17 0 0 0 0 0 0 0 0 11 0 11 0 0
0 0 0 0 10 0 10 0 0 0 0 0 0 5 6 5 17 6 17 0 0 0 0 0 0 11 11 0 0 0 11 11
11 0 0 0 10 0 10 0 0 0 0 0 0 17 17 0 0 17 17 0 0 0 10 0 0 0 0 11 0 11 0 0
0 0 0 0 0 0 0 0 0 0 0 0 0 0 0 0 0 0 0 0 0 0 0 0 0 0 0 0 11 0 0 0
0 0 0 0 0 10 0 0 0 10 0 0 0 0 0 0 0 0 0 0 0 0 0 0 0 0 0 0 11 0 0 0
---
0 0 0 0 0 0 0 0 0 10 10 10 0 0 0 0 0 0 0 0 9 9 9 0 0 0 0 0 0 0 0 0
0 0 0 0 0 0 0 10 10 7 7 10 10 10 0 0 0 0 9 9 9 11 11 9 9 0 0 0 0 0 0 0
0 0 0 0 0 0 10 7 7 5 5 7 7 10 0 0 0 0 9 11 11 17 17 11 11 9 0 0 0 0 0 0
0 0 0 0 0 0 10 10 10 7 7 10 10 17 9 9 9 9 9 9 17 11 11 9 9 9 0 0 0 0 0 0
0 0 0 0 0 0 0 0 10 10 10 11 9 9 10 6 6 6 9 9 6 9 9 0 0 0 0 0 0 0 0 0
0 0 0 0 0 17 17 17 2 11 9 11 9 10 6 10 10 6 6 9 6 10 6 0 6 6 6 0 0 0 0 0
0 0 0 0 0 17 11 11 17 11 9 9 11 9 9 9 9 9 9 6 10 10 6 6 6 6 6 0 0 0 0 0
0 0 0 17 17 8 8 11 17 2 11 11 11 11 8 14 14 8 6 9 9 6 7 6 6 8 6 6 6 0 0 0
0 0 0 17 8 8 11 11 17 11 11 11 11 11 11 8 8 9 9 17 17 9 9 6 6 8 8 6 6 0 0 0
0 0 0 17 8 11 11 17 11 11 11 11 11 11 11 11 9 7 9 7 7 9 7 9 6 6 6 6 6 0 0 0
0 0 0 0 17 17 17 17 11 11 11 11 11 11 11 11 9 7 7 7 7 15 15 9 8 6 6 6 0 0 0 0
0 0 0 0 10 5 5 8 17 11 11 6 6 11 11 14 14 9 7 15 15 7 9 8 5 8 8 17 0 0 0 0
0 0 10 10 5 5 5 5 11 10 10 11 11 10 10 11 9 7 15 7 7 15 15 9 8 8 8 8 17 17 0 0
0 0 10 5 5 5 10 10 11 10 11 10 10 11 10 11 9 15 9 15 15 9 15 9 8 8 8 8 8 17 0 0
0 0 0 10 10 10 0 0 6 11 11 10 10 11 11 9 15 9 9 15 15 9 9 2 0 0 8 8 8 0 0 0
0 0 0 0 0 0 0 0 6 10 10 11 11 7 17 9 15 2 15 9 9 2 2 2 0 0 0 0 0 0 0 0
0 0 0 0 0 0 6 6 10 10 10 10 7 7 17 9 15 2 15 2 5 2 2 2 2 2 0 0 0 0 0 0
0 0 0 0 0 0 6 10 10 10 10 7 11 7 17 9 15 2 15 11 2 5 2 2 2 2 0 0 0 0 0 0
0 0 0 0 0 0 0 6 10 10 0 11 17 7 17 9 15 17 17 17 11 0 5 5 2 0 0 0 0 0 0 0
0 0 0 0 0 0 0 0 0 0 0 11 11 17 7 7 17 17 17 11 11 0 0 0 0 0 0 0 0 0 0 0
0 6 0 0 0 0 0 0 0 0 0 0 0 11 17 17 17 5 11 0 0 0 0 0 0 0 0 0 0 0 0 0
6 10 6 0 0 9 0 0 0 0 0 0 0 11 17 5 5 5 11 0 0 0 0 0 0 0 0 0 0 0 14 0
0 6 0 0 0 0 0 0 0 0 0 0 0 0 11 17 17 11 0 0 0 0 0 0 0 0 0 0 0 0 0 0
0 0 0 0 15 0 5 0 0 0 0 0 0 11 17 8 8 8 11 0 0 0 0 0 5 0 0 0 0 0 0 0
0 0 0 0 15 0 5 0 0 0 0 0 0 11 17 17 17 8 11 0 0 0 0 5 14 5 0 0 5 0 0 0
0 0 15 15 0 0 0 5 5 0 0 0 0 11 8 8 8 8 11 0 0 0 0 0 5 0 0 0 5 0 0 0
9 0 0 0 0 0 0 0 0 0 9 0 0 11 11 11 11 11 5 0 0 0 0 0 0 0 0 0 5 0 0 0
0 0 9 9 0 0 0 14 14 0 0 0 0 11 9 11 2 2 5 0 0 0 0 0 0 0 0 5 0 5 0 0
0 0 0 0 9 0 14 0 0 0 0 0 0 11 9 11 5 2 5 0 0 0 0 0 0 5 5 0 0 0 5 5
15 0 0 0 9 0 14 0 0 0 0 0 0 6 6 0 0 5 5 0 0 0 14 0 0 0 0 5 0 5 0 0
0 0 0 0 0 0 0 0 0 0 0 0 0 0 0 0 0 0 0 0 0 0 0 0 0 0 0 0 5 0 0 0
0 0 0 0 0 15 0 0 0 15 0 0 0 0 0 0 0 0 0 0 0 0 0 0 0 0 0 0 5 0 0 0
