0 0 0 0 16 16 16 0 0 0 0 0
0 0 0 16 6 6 6 16 0 0 0 0
0 0 16 6 6 16 16 0 0 0 0 0
0 0 16 16 16 16 0 0 0 0 0 0
0 16 16 9 9 9 16 16 0 0 0 0
16 9 9 13 13 9 9 9 16 0 0 0
16 13 14 14 14 9 9 14 16 0 0 0
16 13 14 18 14 9 9 14 16 0 0 0
16 13 14 14 14 16 16 16 0 0 0 0
16 13 13 13 16 0 14 16 0 0 0 0
0 16 13 13 16 14 16 16 16 0 0 0
0 16 13 13 9 16 9 9 16 0 0 0
0 0 16 13 13 13 13 9 16 0 0 16
0 0 0 16 13 13 13 13 9 16 16 16
0 0 0 0 16 13 13 13 13 9 9 16
0 0 0 0 0 16 16 16 16 16 16 0
---
0 0 0 0 13 13 13 0 0 0 0 0
0 0 0 13 13 13 13 13 0 0 0 0
0 0 18 13 13 13 13 0 0 0 0 0
0 0 14 13 13 13 0 0 0 0 0 0
0 14 14 16 16 16 13 13 0 0 0 0
14 16 16 16 16 16 16 16 13 0 0 0
14 16 16 16 16 16 16 16 13 0 0 0
14 16 16 14 16 16 16 16 13 0 0 0
14 16 16 16 16 13 13 13 0 0 0 0
14 16 16 16 6 0 16 13 0 0 0 0
0 14 16 16 6 16 6 6 9 0 0 0
0 14 16 16 16 6 16 16 9 0 0 0
0 0 14 16 16 16 16 16 9 0 0 9
0 0 0 9 16 16 16 16 16 9 9 9
0 0 0 0 9 16 9 9 9 16 16 9
0 0 0 0 0 9 9 9 9 9 9 0
