0 0 0 0 0 0 0 0 0 0 0 0 16 16 16 0
0 0 0 0 0 0 0 0 0 0 16 16 13 13 13 16
0 0 0 0 0 0 0 0 16 16 13 13 13 13 13 16
0 0 0 0 0 0 16 16 13 13 13 13 16 13 13 16
0 0 0 0 16 16 13 13 13 13 13 13 13 13 16 0
0 0 16 16 16 13 13 13 13 13 16 13 13 13 16 0
0 16 5 9 9 9 13 16 13 13 13 13 13 16 0 0
16 5 5 5 9 9 13 13 13 13 13 13 13 16 0 0
16 5 5 5 5 9 13 13 13 16 13 13 16 0 0 0
16 16 5 5 5 5 8 13 13 13 13 13 16 0 0 0
0 16 16 16 5 5 5 10 10 10 13 16 0 0 0 0
0 0 16 9 5 5 5 5 10 10 16 16 0 0 0 0
0 16 9 9 9 16 5 5 5 10 16 0 0 0 0 0
16 9 9 9 16 16 5 5 5 5 16 0 0 0 0 0
16 9 9 16 16 16 16 5 5 16 0 0 0 0 0 0
0 16 16 0 0 0 16 16 16 0 0 0 0 0 0 0
---
0 0 0 0 0 0 0 0 0 0 0 0 13 13 13 0
0 0 0 0 0 0 0 0 0 0 13 13 16 16 16 13
0 0 0 0 0 0 0 0 13 13 16 16 16 16 16 13
0 0 0 0 0 0 13 13 16 16 16 16 8 16 16 13
0 0 0 0 13 13 16 16 16 16 16 16 16 16 13 0
0 0 13 13 13 16 16 16 16 16 9 16 16 16 13 0
0 13 13 16 16 16 16 9 16 16 16 16 16 13 0 0
13 13 13 13 16 16 16 16 16 16 16 16 16 13 0 0
13 13 13 13 13 16 16 16 16 13 16 16 13 0 0 0
13 5 13 13 13 13 13 16 16 16 5 5 10 0 0 0
0 5 5 5 13 13 13 5 5 5 5 10 0 0 0 0
0 0 5 5 13 13 13 13 5 5 10 10 0 0 0 0
0 5 5 5 5 9 13 13 13 5 10 0 0 0 0 0
5 5 5 5 9 9 13 13 13 13 10 0 0 0 0 0
5 5 5 9 9 9 9 9 9 9 0 0 0 0 0 0
0 5 5 0 0 0 9 9 9 0 0 0 0 0 0 0
