7 7 7 7 7 7 7 7 7 7 7 7 7 7 7 7 7 7 7 7 7 7 7 7 7 7 7 7 7 7 7 7
7 7 7 7 7 7 7 7 7 10 14 14 14 10 7 7 7 7 7 7 7 7 7 7 7 7 7 7 10 10 14 14
7 7 7 7 7 7 7 10 10 14 14 14 14 14 14 14 14 7 7 7 7 7 7 7 7 7 10 10 10 10 10 14
14 7 7 7 7 7 7 7 10 10 10 10 14 14 10 10 10 7 7 7 7 7 7 10 10 10 10 10 10 10 10 10
14 14 14 7 7 7 7 7 7 7 7 7 10 7 7 7 7 7 7 7 7 10 10 10 10 10 10 10 10 10 10 10
14 14 10 10 10 10 10 7 7 7 7 7 7 7 7 7 7 7 7 7 10 10 10 10 10 10 10 10 14 14 14 10
10 10 10 14 14 10 10 10 10 7 7 7 7 7 7 7 7 7 10 10 10 10 10 10 10 14 14 14 14 14 14 14
10 14 14 14 14 14 10 10 10 10 10 10 10 10 10 10 10 10 10 10 10 10 10 10 14 14 14 14 14 14 14 14
14 14 14 14 14 14 14 14 14 10 10 10 10 10 10 10 10 10 10 10 14 14 14 14 14 14 7 7 7 7 7 14
14 14 14 14 14 14 14 7 14 10 10 10 10 10 10 10 10 10 14 14 14 14 14 7 14 14 7 7 7 7 7 14
14 7 7 7 7 7 14 7 7 14 14 14 10 10 10 10 10 14 7 14 14 7 7 7 7 7 7 7 7 7 7 7
14 7 7 7 7 7 7 7 7 7 7 7 14 10 10 10 14 14 7 14 14 7 7 7 7 7 7 7 7 7 7 7
7 7 7 7 7 7 7 7 7 7 7 7 7 14 10 10 14 7 7 7 7 7 7 7 7 7 7 7 7 7 7 7
4 4 4 4 4 4 4 4 7 4 4 4 4 14 10 10 4 4 1 1 4 4 1 1 4 4 4 4 4 4 4 4
4 4 4 4 4 4 4 4 4 4 4 4 4 4 4 1 1 1 1 1 1 1 1 1 14 9 9 9 14 14 14 14
4 4 4 4 4 4 4 4 14 14 14 14 4 14 14 1 1 1 1 1 1 1 1 14 14 14 14 14 14 9 14 14
4 4 4 4 4 4 14 14 14 1 14 14 14 14 1 1 1 1 14 14 14 14 14 14 14 9 9 14 9 9 9 9
4 4 4 4 4 4 4 4 4 4 4 1 1 1 1 14 14 1 14 14 9 9 9 14 14 14 9 9 9 9 9 9
4 4 4 4 4 4 1 4 4 4 1 1 1 1 1 1 14 14 14 14 14 14 14 9 9 9 9 9 9 9 9 14
4 4 4 4 1 1 1 4 1 1 1 14 14 14 14 1 1 14 14 9 9 14 14 14 14 14 9 9 9 14 14 15
4 14 14 1 1 1 4 1 14 1 1 14 14 9 9 14 14 14 14 14 14 14 14 14 14 9 9 9 14 15 15 9
14 1 1 1 1 1 14 14 14 1 1 14 14 14 14 14 9 9 14 14 14 9 9 9 9 9 9 15 15 15 15 15
1 1 1 4 4 4 1 14 14 14 14 14 14 9 9 9 9 15 14 9 9 9 9 9 9 14 15 13 15 15 13 15
4 4 4 4 14 14 14 1 1 1 1 14 14 9 9 15 15 14 14 9 9 9 14 14 14 15 13 13 15 15 13 13
4 4 14 1 1 1 1 1 1 1 14 14 9 9 15 15 14 14 9 9 9 14 14 15 15 15 15 16 13 13 16 15
14 14 1 1 1 1 1 14 14 14 14 14 14 14 14 14 14 14 9 9 14 15 15 15 15 15 13 13 13 13 13 13
14 1 1 1 1 1 14 14 9 9 9 9 9 9 14 14 14 9 9 9 15 15 15 15 15 9 9 13 13 13 13 9
1 1 1 1 14 14 14 9 9 9 9 9 14 14 14 14 9 9 9 15 15 15 15 15 15 15 9 9 9 9 9 9
14 14 14 14 14 14 14 9 9 9 14 14 14 14 9 9 9 9 15 15 15 15 15 15 15 15 15 15 15 15 15 15
9 9 14 14 14 14 9 9 15 15 14 14 14 9 9 9 9 15 15 15 15 15 15 15 9 15 15 15 15 15 15 15
14 14 14 9 14 14 14 14 14 14 14 9 9 9 9 9 15 15 15 15 15 15 9 9 15 15 15 9 15 15 15 15
14 15 14 14 14 9 15 15 15 14 9 9 9 9 9 15 15 15 15 15 15 9 15 15 15 15 15 15 15 15 15 15
---
14 14 14 14 14 14 14 14 14 14 14 14 14 14 14 14 14 14 14 14 14 14 14 14 14 14 14 14 14 14 14 14
14 14 14 14 14 14 14 14 14 14 4 4 4 14 14 14 14 14 14 14 14 14 14 14 14 14 14 14 7 7 15 15
14 14 14 14 14 14 14 14 14 4 4 4 4 4 4 4 4 14 14 14 14 14 14 14 14 14 7 7 7 7 7 15
4 14 14 14 14 14 14 14 14 14 14 14 4 4 14 14 14 14 14 14 14 14 14 7 7 7 7 7 7 7 7 7
4 4 4 14 14 14 14 14 14 14 14 14 14 14 14 14 14 14 14 14 14 7 7 7 7 7 7 7 7 7 7 7
4 4 7 7 7 7 7 14 14 14 14 14 14 14 14 14 14 14 14 14 7 7 7 7 7 7 7 7 4 4 4 7
7 7 7 1 1 7 7 7 7 14 14 14 14 14 14 14 14 14 7 7 7 7 7 7 7 4 4 4 4 4 4 4
7 1 1 1 1 1 7 7 7 7 7 7 7 7 7 7 7 7 7 7 7 7 7 7 4 4 4 4 4 4 4 4
1 1 1 1 1 1 1 1 1 7 7 7 7 7 7 7 7 7 7 7 4 4 4 4 4 4 1 1 1 1 1 4
1 1 1 1 1 1 1 14 1 7 7 7 7 7 7 7 7 7 4 4 4 4 4 1 4 4 1 1 1 1 1 4
1 14 14 14 14 14 1 14 14 1 1 1 7 7 7 7 7 4 1 4 4 1 1 1 1 1 1 1 1 1 1 1
1 14 14 14 14 14 14 14 14 14 14 14 1 7 7 7 4 4 1 4 4 1 1 1 1 1 1 1 1 1 1 1
14 14 14 14 14 14 14 14 14 14 14 14 14 1 7 7 4 7 1 1 1 1 1 1 1 1 1 1 1 1 1 1
7 7 7 7 7 7 7 7 14 7 7 7 7 1 7 7 15 15 10 10 7 7 10 10 10 10 10 10 10 10 10 10
7 7 7 7 7 7 7 7 7 7 7 7 7 7 7 10 10 10 10 10 10 10 10 10 9 4 4 4 9 9 9 9
7 7 7 7 7 7 7 7 15 15 15 15 7 15 15 10 10 10 10 10 10 10 10 9 9 9 9 9 9 15 9 9
7 7 7 7 7 7 15 15 15 7 15 15 15 15 10 10 10 10 9 9 9 9 9 9 9 15 15 9 15 15 15 15
7 7 7 7 7 7 7 7 7 7 7 10 10 10 10 9 9 10 9 9 15 15 15 9 9 9 15 15 15 15 15 15
7 7 7 7 7 7 10 7 7 7 10 10 10 10 10 10 9 9 9 9 9 9 9 15 15 15 15 15 15 15 15 10
7 7 7 7 10 10 10 7 10 10 10 9 9 9 9 10 10 9 9 13 13 9 9 9 9 9 15 15 15 10 10 14
10 4 4 10 10 10 10 10 9 10 10 9 9 10 10 9 9 9 9 9 9 9 9 9 9 15 15 15 14 14 14 4
4 10 10 10 10 10 9 9 9 10 10 9 9 9 9 9 15 15 9 9 9 15 15 15 15 15 15 14 14 14 14 14
10 10 10 7 7 10 10 9 9 9 9 9 9 15 15 15 15 15 9 15 15 15 15 15 15 14 14 7 14 14 7 14
7 7 7 7 7 7 7 10 10 10 10 9 9 15 15 15 13 9 9 15 15 15 14 14 14 14 7 7 14 14 7 7
7 10 1 10 10 10 10 10 10 10 9 9 15 15 13 13 9 9 15 15 15 14 14 14 14 14 14 7 7 7 10 14
1 1 10 10 10 10 10 9 9 9 9 9 9 9 9 9 9 9 15 15 14 14 14 14 14 14 7 7 7 7 7 7
1 10 10 10 10 10 9 9 4 4 4 4 4 4 9 9 9 15 15 15 14 14 14 14 14 13 13 7 7 7 7 13
10 10 10 10 10 10 9 4 4 4 4 4 9 9 9 9 15 15 15 14 14 14 14 14 14 14 13 13 13 13 13 13
10 10 10 10 9 9 9 4 4 4 9 9 9 9 15 15 15 15 14 14 14 14 14 14 14 14 14 14 14 14 14 14
1 15 10 10 9 9 4 4 4 4 9 9 9 15 15 15 15 14 14 14 14 14 14 14 4 14 14 14 14 14 14 14
10 10 10 14 9 9 9 9 9 9 9 15 15 15 15 15 14 14 14 14 14 14 4 4 14 14 14 4 14 14 14 14
10 1 10 16 16 13 13 13 13 9 15 15 15 15 15 14 14 14 14 14 14 4 14 14 14 14 14 14 14 14 14 14
