18 18 4 4 1 1 4 4 4 18 18 4 4 4 4 4 4 4 4 4 18 18 18 18 18 1 18 18 18 18
18 18 4 1 1 4 4 18 14 4 4 4 1 1 1 1 1 1 1 4 4 4 18 18 18 1 1 18 18 18
18 4 1 1 4 4 4 14 18 14 1 1 1 1 4 4 4 1 1 1 1 4 1 4 1 18 4 1 1 18
18 4 1 1 4 4 18 1 14 1 1 1 18 18 18 18 4 4 4 4 1 1 1 4 4 1 1 4 4 18
18 4 1 1 4 4 1 6 1 6 1 1 1 1 1 18 18 18 18 4 4 4 1 1 4 1 4 18 18 18
18 4 1 1 4 1 6 6 10 10 7 10 10 10 10 10 1 18 18 18 18 4 18 1 1 1 18 18 18 18
18 4 1 1 4 6 1 10 10 7 10 6 6 1 1 1 10 1 1 18 18 18 18 4 1 1 18 18 1 18
18 4 1 6 6 6 10 10 10 7 10 10 10 10 10 10 1 6 1 1 1 18 18 18 4 4 1 1 18 1
18 4 1 6 6 1 10 10 10 7 10 10 7 10 10 10 10 1 6 6 1 4 18 18 4 18 4 1 1 18
18 4 1 1 6 1 10 7 10 7 7 7 7 10 10 10 10 10 10 6 1 1 1 18 18 18 18 4 1 18
18 18 4 1 6 1 10 7 10 7 7 7 14 7 7 7 10 10 10 10 10 10 10 1 18 18 18 14 1 1
1 18 4 1 6 1 10 10 10 7 7 14 7 7 7 7 7 7 10 10 10 10 1 10 1 18 14 18 14 1
1 18 18 4 1 6 1 10 7 7 7 14 7 14 14 14 14 7 7 7 10 10 1 1 10 14 18 14 4 1
1 18 18 4 1 1 6 10 10 7 7 14 14 14 14 14 14 14 14 7 10 10 1 6 1 1 14 18 18 4
1 1 18 18 4 1 6 6 10 10 7 7 14 14 14 14 14 14 14 7 7 10 10 1 6 6 1 1 18 4
1 1 18 18 4 1 1 6 10 10 10 7 7 14 14 14 14 14 14 14 7 7 10 10 6 6 6 1 1 18
18 4 1 18 18 18 1 1 6 10 10 10 7 7 7 14 14 14 14 14 14 7 7 10 1 6 6 1 4 18
18 4 1 1 18 18 4 1 1 10 10 10 10 7 7 7 7 7 7 14 7 7 7 10 10 6 1 1 4 18
18 18 4 1 1 18 18 4 1 1 10 10 10 10 10 14 7 14 14 7 10 7 7 10 10 6 10 1 4 4
18 18 18 14 1 1 18 18 4 1 1 10 10 7 10 10 10 10 7 7 7 7 7 10 10 6 10 1 1 4
18 18 18 14 4 4 1 1 4 4 1 1 1 10 10 7 7 10 10 10 7 7 7 10 10 6 10 1 1 4
18 18 14 18 14 1 1 6 1 1 4 4 4 1 10 10 7 7 7 7 7 7 10 10 10 6 10 1 4 4
18 18 1 14 18 18 1 1 6 6 1 4 4 1 1 1 10 10 10 10 10 10 10 10 6 10 10 1 4 1
18 18 1 14 18 18 18 4 1 6 6 1 1 10 1 6 6 6 6 1 10 10 10 1 1 10 1 1 4 4
18 18 4 1 1 18 18 18 18 4 1 6 6 1 10 1 10 10 10 10 10 14 10 1 1 10 1 1 1 4
1 18 18 4 1 1 18 18 4 18 4 4 1 6 6 1 1 6 6 1 14 1 14 1 4 4 1 1 1 4
18 1 18 18 18 18 18 18 18 18 18 18 4 4 4 4 4 4 4 4 18 14 18 4 18 1 1 1 1 4
18 18 18 18 1 18 18 1 1 18 18 18 18 18 18 4 4 4 4 4 18 4 18 18 1 1 1 1 4 18
18 18 1 1 18 4 1 4 4 1 1 1 1 18 18 18 18 18 18 18 18 1 1 1 1 4 1 4 4 18
18 18 18 18 1 18 18 18 4 4 18 1 1 1 1 1 1 1 1 1 1 1 1 4 4 1 4 18 18 18
---
1 1 1 1 4 4 1 1 1 6 6 1 1 1 1 1 1 1 1 1 14 14 14 14 14 7 14 14 14 14
1 1 1 4 4 1 1 14 6 1 1 1 7 7 7 7 7 7 7 1 1 1 14 14 14 7 7 14 14 14
1 1 4 4 1 1 1 6 14 6 7 7 7 7 14 14 14 7 7 7 7 1 7 14 7 14 14 7 7 14
1 1 4 4 1 1 14 7 6 7 7 7 4 4 4 4 14 14 14 14 7 7 7 14 14 7 7 14 14 14
1 1 4 4 1 1 7 7 7 7 7 7 7 7 7 4 4 4 4 14 14 14 7 7 14 7 14 14 14 14
1 1 4 4 1 7 7 7 18 18 1 18 18 18 18 18 10 4 4 4 4 14 4 7 7 7 14 14 14 14
1 1 4 4 1 7 7 18 18 1 18 18 18 10 10 10 18 10 10 4 4 4 4 14 7 7 14 14 7 14
1 1 4 7 7 7 18 18 18 1 18 18 18 18 18 18 10 10 10 10 10 4 4 4 14 14 7 7 14 7
1 1 4 7 7 4 18 18 18 1 18 18 1 18 18 18 18 10 10 10 10 10 4 4 14 4 14 7 7 14
1 1 4 4 7 4 18 18 18 1 1 1 1 18 18 18 18 18 18 10 10 10 10 4 4 4 4 14 7 14
1 1 1 4 7 4 18 18 18 1 1 1 18 1 1 1 18 18 18 18 18 18 18 10 4 4 4 10 7 7
4 1 1 4 7 4 18 18 18 1 1 18 1 1 1 1 1 1 18 18 18 18 10 18 10 4 10 4 10 7
4 1 1 1 4 7 4 18 1 1 1 18 1 18 18 18 18 1 1 1 18 18 10 10 18 10 4 10 10 7
4 1 1 1 4 4 7 18 18 1 1 18 18 18 18 18 18 18 18 1 18 18 10 18 10 10 10 4 4 10
4 4 1 1 1 4 7 7 18 18 1 1 18 18 18 18 18 18 18 1 1 18 18 10 18 18 10 10 4 10
4 4 1 1 1 4 4 7 18 18 18 1 1 18 18 18 18 18 18 18 1 1 18 18 18 18 18 10 10 4
1 6 4 1 1 1 4 4 7 18 18 18 1 1 1 18 18 18 18 18 18 1 1 18 18 18 18 10 10 4
1 6 4 4 1 1 10 4 4 18 18 18 18 1 1 1 1 1 1 18 1 1 1 18 18 18 10 10 10 4
1 1 6 4 4 1 1 10 4 4 18 18 18 18 18 18 1 18 18 1 1 1 1 18 18 18 18 10 10 10
1 1 1 6 4 4 1 1 10 4 4 18 18 18 18 18 18 18 1 1 1 1 1 18 18 18 18 10 10 10
1 1 1 6 6 6 4 4 10 10 4 4 4 18 18 1 1 18 18 18 1 1 1 18 18 18 18 10 10 10
1 1 6 1 6 4 4 4 4 4 10 10 10 4 18 18 1 1 1 1 1 1 18 18 18 18 18 10 10 10
1 1 6 6 1 1 4 4 4 4 4 10 10 4 4 4 18 18 18 18 18 18 18 18 18 18 18 10 10 10
1 1 6 6 1 1 1 4 4 4 4 4 4 4 4 4 4 4 4 18 18 18 18 6 6 18 10 10 10 10
1 1 6 6 6 1 1 1 1 6 4 4 4 4 4 4 18 18 18 18 18 4 18 6 6 18 10 10 10 10
6 1 1 6 6 6 1 1 6 1 6 6 4 4 4 4 4 4 4 4 4 6 4 6 1 1 10 10 10 10
1 6 1 1 1 1 1 1 1 1 1 1 6 6 6 6 6 6 6 6 1 4 1 1 1 10 10 10 10 10
1 1 1 1 6 1 1 10 10 1 1 1 1 1 1 6 6 6 6 6 1 1 1 1 10 10 10 10 10 10
1 1 6 6 1 10 10 10 10 10 10 10 10 1 1 1 1 1 1 1 1 10 10 10 10 10 10 10 10 10
1 1 1 1 6 1 1 1 10 10 10 10 10 10 10 10 10 10 10 10 10 10 10 10 10 10 10 10 10 10
