5 5 5 5 5 5 5 5 5 14 14 14 5 5 5 5 5 5 14 14 5 5 14 5 5 5 5 5 5 5
14 14 5 5 5 5 14 14 14 14 14 14 14 14 14 14 14 14 14 14 14 14 14 14 5 5 5 5 5 5
14 14 5 5 5 14 14 18 18 18 18 18 18 18 18 18 18 18 18 18 18 18 18 14 14 5 5 5 5 14
14 14 5 5 14 14 18 7 7 7 7 7 7 7 7 7 7 7 7 7 7 7 7 18 14 14 5 5 14 14
14 14 5 5 14 18 7 7 7 18 18 18 18 18 18 18 18 18 18 18 18 7 7 7 18 14 5 14 14 14
14 14 5 5 14 18 7 7 18 1 1 1 1 1 1 1 1 1 1 1 1 18 7 7 18 14 5 14 14 14
14 14 5 5 14 18 7 7 18 1 1 1 15 15 15 15 1 1 1 1 1 18 7 7 18 14 5 14 14 5
14 14 5 5 14 18 7 7 18 1 1 15 15 18 15 15 15 1 1 1 1 18 7 7 18 14 5 14 14 5
14 14 5 5 14 18 7 7 18 1 15 15 15 15 15 1 1 1 1 1 1 18 7 7 18 14 5 14 14 5
14 14 14 5 14 18 7 7 18 1 15 15 15 15 1 1 1 15 1 15 1 18 7 7 18 14 5 14 5 5
5 14 14 5 14 18 7 7 18 1 15 15 15 15 15 1 1 1 1 1 1 18 7 7 18 14 14 14 5 5
5 5 14 14 14 18 7 7 18 1 1 15 15 15 15 15 15 1 1 1 1 18 7 7 18 14 14 14 5 5
5 5 5 14 14 18 7 7 18 1 1 1 15 15 15 15 1 1 1 1 1 18 7 7 18 14 14 14 5 5
5 5 5 5 14 18 7 7 18 1 1 1 1 1 1 1 1 1 1 1 1 18 7 7 18 14 5 5 5 5
5 5 5 5 14 18 7 7 7 18 18 18 18 18 18 18 18 18 18 18 18 7 7 7 18 14 5 5 5 5
14 14 5 5 14 14 18 7 7 7 7 7 7 7 7 7 7 7 7 7 7 7 7 18 14 14 5 5 14 14
5 14 5 5 14 14 18 18 18 18 18 18 18 18 18 18 18 18 18 18 18 18 18 18 14 14 5 5 14 5
5 14 5 14 14 18 8 8 8 18 10 10 10 10 10 10 10 10 10 10 18 8 8 8 18 14 14 5 14 5
5 14 14 14 18 8 8 8 8 18 18 18 18 18 18 18 18 18 18 18 18 8 8 8 8 18 14 14 14 5
5 5 14 18 8 8 8 8 8 8 8 8 8 8 8 8 8 8 8 8 8 8 8 8 8 8 18 14 5 5
5 14 14 18 18 18 18 18 18 18 18 18 18 18 18 18 18 18 18 18 18 18 18 18 18 18 18 14 14 5
5 14 18 7 7 7 7 7 7 7 7 7 7 7 7 7 7 7 7 7 7 7 7 7 7 7 7 18 14 5
5 14 18 7 7 18 18 18 18 18 18 18 18 18 7 7 7 18 7 7 7 18 18 18 18 7 7 18 14 5
5 14 18 7 7 10 10 10 10 10 10 10 10 10 7 7 18 6 18 7 18 6 6 6 6 18 7 18 14 14
14 14 18 7 7 18 7 7 7 18 7 7 7 18 7 7 18 5 18 7 18 5 5 5 5 18 7 18 14 5
5 14 18 10 18 6 18 10 18 6 18 10 18 6 18 7 10 18 10 7 10 18 18 18 18 10 10 18 14 5
5 14 18 10 18 5 18 10 18 5 18 10 18 5 18 10 10 10 10 10 10 10 10 10 10 10 10 18 14 5
5 14 14 18 18 18 18 18 18 18 18 18 18 18 18 18 18 18 18 18 18 18 18 18 18 18 18 14 14 5
5 5 14 14 14 14 14 14 14 14 14 14 14 14 14 14 14 14 14 14 14 14 14 14 14 14 14 14 5 5
5 5 5 14 5 5 14 14 14 5 5 5 5 5 5 5 14 14 14 14 5 5 5 5 5 5 14 5 5 5
---
7 7 7 7 7 7 7 7 7 18 18 18 14 14 14 14 14 14 18 18 7 7 18 7 7 7 7 7 7 7
18 18 7 7 7 7 18 18 18 18 18 18 18 18 18 18 18 18 18 18 18 18 18 18 7 7 7 7 7 7
18 18 7 7 7 18 18 5 5 5 5 5 5 5 5 5 5 5 5 5 5 5 5 18 18 7 7 7 7 18
18 18 7 7 18 18 5 5 5 5 5 5 5 5 5 5 5 5 5 5 5 5 5 5 18 18 7 7 18 18
18 18 7 7 18 5 5 5 5 5 5 5 5 5 5 5 5 5 5 5 5 5 5 5 5 18 7 18 18 18
18 18 7 7 18 10 5 5 5 14 14 14 14 14 14 14 14 14 14 14 14 5 5 5 5 18 7 18 18 18
18 18 7 7 18 10 5 5 5 14 14 14 14 14 14 14 14 14 14 14 14 5 5 5 6 18 7 18 18 7
18 18 7 7 18 10 5 5 5 14 14 14 14 14 14 14 14 14 14 14 14 5 5 5 6 18 7 18 18 7
18 18 7 7 18 10 5 5 5 14 14 14 14 14 14 14 14 14 14 14 14 5 5 5 6 18 7 18 18 7
18 18 18 7 18 10 5 5 5 14 14 14 14 14 14 14 14 14 14 14 14 5 5 5 6 18 7 18 7 7
7 18 18 7 18 10 5 5 5 14 14 14 14 14 14 14 14 14 14 14 14 5 5 5 6 18 18 18 7 7
7 7 18 18 18 10 5 5 5 14 14 14 14 14 14 14 14 14 14 14 14 5 5 5 6 18 18 18 7 7
7 7 7 18 18 10 5 5 5 14 14 14 14 14 14 14 14 14 14 14 14 5 5 5 6 18 18 18 7 7
7 7 7 7 18 10 5 5 5 14 14 14 14 14 14 14 14 14 14 14 14 5 5 5 6 18 7 7 7 7
7 7 7 7 18 10 5 5 5 5 5 5 5 5 5 5 5 5 5 5 5 5 5 5 8 18 7 7 7 7
18 18 7 7 18 18 15 5 5 5 5 5 5 5 5 5 5 5 5 5 5 5 5 8 18 18 7 7 18 18
7 18 7 7 18 18 15 15 15 15 5 5 5 5 5 5 5 5 5 5 8 8 8 8 18 18 7 7 18 7
7 18 7 18 18 15 18 18 18 15 5 5 5 5 5 5 5 5 5 5 8 18 18 18 8 18 18 7 18 7
7 18 18 18 15 18 18 18 18 15 15 15 15 15 15 8 8 8 8 8 8 18 18 18 18 8 18 18 18 7
7 7 18 15 18 18 18 18 18 18 18 18 18 18 18 18 18 18 18 18 18 18 18 18 18 18 8 18 7 7
7 18 18 15 15 15 15 15 15 15 15 15 15 15 15 8 8 8 8 8 8 8 8 8 8 8 8 18 18 7
7 18 15 1 1 1 1 1 1 1 1 1 1 1 1 1 1 1 1 1 1 1 1 1 1 1 1 8 18 7
7 18 15 1 1 10 10 10 10 10 10 10 10 10 1 1 1 10 1 1 1 10 10 10 10 1 1 8 18 7
7 18 15 1 1 1 1 1 1 1 1 1 1 1 1 1 10 1 10 1 10 18 18 18 18 10 1 8 18 18
18 18 15 1 1 14 1 1 1 14 1 1 1 14 1 1 10 10 10 1 10 10 10 10 10 10 1 8 18 7
7 18 15 1 14 14 14 1 14 14 14 1 14 1 14 1 14 10 14 1 14 10 10 10 10 14 14 8 18 7
7 18 15 1 14 14 14 1 14 14 14 1 14 1 14 14 14 14 14 14 14 14 14 14 14 14 14 8 18 7
7 18 18 15 15 14 14 14 14 14 14 14 14 14 14 14 14 14 14 14 14 14 14 14 14 8 8 18 18 7
7 7 18 18 18 18 18 18 18 18 18 18 18 18 18 18 18 18 18 18 18 18 18 18 18 18 18 18 7 7
7 7 7 18 14 14 18 18 18 14 14 14 14 14 14 14 18 18 18 18 14 14 14 14 14 14 18 7 7 7
