1 1 1 1 1 1 1 1 1 1 1 1 1 1 1 1 1 1 1 1 1 1 1 1 1 1 1 1 1 1
1 1 1 1 1 1 1 1 1 1 1 1 1 1 1 1 1 1 1 1 1 1 1 1 1 1 1 1 1 1
1 1 1 1 1 1 1 1 1 1 1 1 1 1 1 1 1 1 1 1 14 1 1 1 1 1 1 1 1 1
1 1 1 1 1 1 1 1 1 1 1 16 16 16 16 16 16 16 16 1 1 1 16 16 16 1 1 1 1 1
1 1 1 1 1 14 1 1 1 16 16 19 9 9 19 19 9 9 19 16 16 1 16 2 2 16 1 1 1 1
1 1 1 1 1 1 1 16 16 9 19 19 16 16 16 16 16 16 19 19 9 16 16 2 2 16 1 1 1 1
1 1 1 1 14 14 16 19 9 9 16 16 1 14 14 14 1 1 16 16 9 9 19 16 16 16 1 1 14 1
1 14 1 14 14 16 16 16 16 16 1 1 14 16 16 16 14 1 1 1 16 16 16 15 19 16 16 1 1 1
1 1 1 14 14 16 6 6 16 1 14 14 16 6 6 6 16 14 14 1 1 16 15 15 19 19 16 14 14 1
14 1 1 14 14 16 6 6 6 16 14 16 6 6 16 5 5 16 14 14 14 16 15 15 19 19 16 14 14 1
14 1 14 14 16 9 16 6 6 16 14 16 6 16 5 8 5 5 16 14 16 15 15 15 15 19 16 14 14 14
14 14 14 14 16 16 16 16 6 16 16 16 16 5 5 5 5 5 5 16 15 15 15 15 19 19 16 14 14 14
14 14 14 16 13 13 13 13 16 16 9 9 9 16 5 5 17 16 16 16 16 15 15 15 19 19 16 14 14 14
14 14 16 13 13 13 13 9 9 9 14 14 9 13 16 5 16 6 6 6 16 15 15 15 19 16 16 14 14 14
14 14 16 13 13 13 13 13 9 9 9 14 9 13 16 17 16 6 6 6 16 15 15 19 19 16 19 16 14 14
14 16 16 13 13 13 13 13 9 9 9 9 16 16 16 16 16 16 6 16 15 19 19 19 16 16 9 9 16 14
14 16 19 16 16 16 13 13 13 9 9 16 16 10 10 10 10 16 16 19 19 19 19 16 16 16 19 19 16 14
14 16 19 19 9 9 16 16 13 13 16 11 10 10 10 10 10 10 16 16 16 16 16 16 9 9 19 19 16 14
14 14 16 16 9 9 19 19 16 16 16 16 11 11 11 10 10 11 16 16 16 16 19 19 9 9 16 16 14 14
14 14 16 9 16 16 19 19 9 9 19 19 16 16 16 16 16 16 19 19 9 9 19 19 16 16 2 16 14 14
14 14 16 9 2 2 16 16 16 16 19 19 9 9 19 19 9 9 19 19 16 16 16 16 2 9 9 16 14 14
14 14 14 16 2 2 2 9 9 9 16 16 16 16 16 16 16 16 16 16 9 9 2 2 2 9 16 14 14 14
14 14 14 16 9 9 9 2 2 2 9 9 9 2 2 2 9 9 9 2 2 2 9 9 9 2 16 14 14 14
14 5 5 5 16 9 9 2 2 2 9 9 9 2 2 2 9 9 9 2 2 2 9 9 9 16 5 5 5 14
5 5 5 5 5 16 2 9 9 9 2 2 2 9 9 9 2 2 2 9 9 9 2 2 16 5 5 5 5 5
5 17 5 17 5 5 16 9 9 9 2 2 2 9 9 9 2 2 2 9 9 9 2 16 5 5 5 5 5 5
17 17 17 5 5 5 5 16 16 2 9 9 9 2 2 2 9 9 9 2 2 16 16 5 5 5 17 5 5 17
17 17 17 17 17 17 5 5 5 16 16 16 16 16 16 16 16 16 16 16 16 5 5 5 5 5 17 17 17 17
17 17 17 17 17 17 17 17 5 5 5 5 5 5 5 5 5 5 5 5 5 5 17 5 17 17 17 17 17 17
17 17 17 17 17 17 17 17 17 17 17 17 17 17 17 17 17 17 17 17 17 17 17 17 17 17 17 17 17 17
---
1 1 1 1 1 1 1 1 1 1 1 1 1 1 1 1 1 1 1 1 1 1 1 1 1 1 1 1 1 1
1 1 1 1 1 1 1 1 1 1 1 1 1 1 1 1 1 1 1 1 1 1 1 1 1 1 1 1 1 1
1 1 1 1 1 1 1 1 1 1 1 1 1 1 1 1 1 1 1 1 14 1 1 1 1 1 1 1 1 1
1 1 1 1 1 1 1 1 1 1 1 16 16 16 16 16 16 16 16 1 1 1 16 16 16 1 1 1 1 1
1 1 1 1 1 14 1 1 1 16 16 19 9 9 19 19 9 9 19 16 16 1 16 2 2 16 1 1 1 1
1 1 1 1 1 1 1 16 16 9 19 19 16 16 16 16 16 16 19 19 9 16 16 2 2 16 1 1 1 1
1 1 1 1 14 14 16 19 9 9 16 16 1 14 14 14 1 1 16 16 9 9 19 16 16 16 1 1 14 1
1 14 1 14 14 16 16 16 16 16 1 1 14 16 16 16 14 1 1 1 16 16 16 5 2 16 16 1 1 1
1 1 1 14 14 16 6 6 16 1 14 14 16 6 6 6 16 14 14 1 1 16 5 5 2 2 16 14 14 1
14 1 1 14 14 16 6 6 6 16 14 16 6 6 16 5 5 16 14 14 14 16 5 5 2 2 16 14 14 1
14 1 14 14 16 9 16 6 6 16 14 16 6 16 5 8 5 5 16 14 16 5 5 5 5 2 16 14 14 14
14 14 14 14 16 16 16 16 6 16 16 16 16 5 5 5 5 5 5 16 5 5 5 5 2 2 16 14 14 14
14 14 14 16 13 13 13 13 16 16 9 9 9 16 5 5 17 16 16 16 16 5 5 5 2 2 16 14 14 14
14 14 16 13 13 13 13 9 9 9 14 14 9 13 16 5 16 9 9 9 16 5 5 5 2 16 16 14 14 14
14 14 16 13 13 13 13 13 9 9 9 14 9 13 16 17 16 9 2 2 16 5 5 2 2 16 19 16 14 14
14 16 16 13 13 13 13 13 9 9 9 9 16 16 16 16 16 16 2 16 5 2 2 2 16 16 9 9 16 14
14 16 19 16 16 16 13 13 13 9 9 16 16 10 10 10 10 16 16 2 2 2 2 16 16 16 19 19 16 14
14 16 19 19 9 9 16 16 13 13 16 11 10 10 10 10 10 10 16 16 16 16 16 16 9 9 19 19 16 14
14 14 16 16 9 9 19 19 16 16 16 16 11 11 11 10 10 11 16 16 16 16 19 19 9 9 16 16 14 14
14 14 16 9 16 16 19 19 9 9 19 19 16 16 16 16 16 16 19 19 9 9 19 19 16 16 19 16 14 14
14 14 16 9 2 2 16 16 16 16 19 19 9 9 19 19 9 9 19 19 16 16 16 16 15 19 19 16 14 14
14 14 14 16 2 2 2 9 9 9 16 16 16 16 16 16 16 16 16 16 19 19 15 15 15 19 16 14 14 14
14 14 14 16 9 9 9 2 2 2 9 9 9 2 2 2 6 6 6 15 15 15 19 19 19 15 16 14 14 14
14 5 5 5 16 9 9 2 2 2 9 9 9 2 2 2 6 6 6 15 15 15 19 19 19 16 9 9 9 14
5 5 5 5 5 16 2 9 9 9 2 2 2 9 9 9 15 15 15 6 19 19 15 15 16 9 9 9 9 9
5 17 5 17 5 5 16 9 9 9 2 2 2 9 9 9 15 15 15 19 19 19 15 16 9 9 9 9 9 9
17 17 17 5 5 5 5 16 16 2 9 9 9 2 2 2 19 19 19 15 15 16 16 9 9 9 17 9 9 17
17 17 17 17 17 17 5 5 5 16 16 16 16 16 16 16 16 16 16 16 16 5 5 9 9 9 17 17 17 17
17 17 17 17 17 17 17 17 5 5 5 5 5 5 5 5 5 5 5 5 5 5 17 5 17 17 17 17 17 17
17 17 17 17 17 17 17 17 17 17 17 17 17 17 17 17 17 17 17 17 17 17 17 17 17 17 17 17 17 17
