12 10 10 12 12 10 10 12 10 10 10 12 12 12 10 10 10 10 10 12 10 10 12 12 10 10 10 12 10 12
12 10 12 12 12 10 10 12 10 12 10 12 12 12 10 10 12 10 10 12 10 10 12 12 10 10 10 12 10 10
10 10 12 14 14 14 10 14 14 14 14 14 14 14 10 12 14 14 14 14 14 14 14 12 14 14 14 14 14 10
12 10 14 16 16 16 14 16 16 16 16 16 16 16 14 14 16 16 16 16 16 16 16 14 14 16 16 16 14 10
12 10 14 16 9 9 16 9 9 9 9 9 9 9 16 16 9 9 9 9 9 9 14 14 16 15 15 16 14 10
12 10 14 16 9 16 9 16 9 9 9 9 9 9 9 9 9 9 9 9 9 14 14 16 15 15 15 16 14 10
12 10 12 14 16 9 16 9 9 2 2 2 2 2 2 2 2 2 2 2 14 14 16 15 15 15 16 14 14 10
12 10 14 16 9 9 9 2 16 14 14 14 14 14 14 14 14 14 14 14 14 16 15 15 15 16 14 14 12 10
12 10 14 16 9 9 2 14 14 14 14 14 14 14 14 14 14 1 14 14 16 15 15 15 16 14 14 14 12 10
12 10 14 16 9 9 2 14 14 14 14 14 14 14 6 14 14 14 14 16 16 15 15 16 14 14 16 14 12 10
12 10 12 14 16 9 2 14 14 14 14 6 6 6 14 14 16 16 16 7 7 16 16 14 14 16 14 10 12 10
12 10 12 14 16 9 2 14 14 14 6 6 14 14 14 16 8 8 16 7 7 16 14 14 9 16 14 10 12 10
12 10 14 16 9 9 2 14 14 6 6 14 1 14 16 8 8 8 8 16 16 14 14 2 9 9 16 14 12 10
12 10 14 16 9 9 2 14 14 6 1 1 1 14 16 1 8 8 8 8 16 14 6 2 9 9 16 14 12 10
12 10 14 16 9 9 2 14 14 1 6 1 1 14 16 1 8 8 8 8 16 14 14 2 9 9 16 14 12 10
12 10 14 16 9 9 2 14 14 6 1 1 14 14 16 1 1 1 1 16 14 14 14 2 9 9 16 14 12 10
12 10 14 16 9 9 2 14 6 1 1 1 14 16 1 1 1 16 16 14 14 1 1 2 9 9 16 14 12 10
12 10 14 16 9 9 2 6 1 1 14 1 14 16 16 16 16 14 14 14 1 1 14 2 9 9 16 14 12 10
12 10 12 14 16 9 2 14 14 1 1 1 14 14 14 14 14 14 1 1 1 14 6 2 9 16 14 12 12 10
12 10 12 14 16 9 2 14 1 1 1 6 14 6 14 14 1 1 1 1 6 14 14 2 9 16 14 12 12 10
12 10 14 16 9 9 2 14 14 1 14 6 6 14 14 1 1 1 6 6 14 14 14 2 9 9 16 14 12 10
12 10 14 16 9 9 2 14 14 14 14 14 14 14 14 14 14 14 14 14 14 14 14 2 9 9 16 14 12 10
12 10 14 16 9 9 9 2 16 2 2 2 9 2 2 2 2 9 2 2 2 16 2 9 9 9 16 14 12 10
10 12 12 14 16 9 16 9 9 9 9 9 9 9 9 9 9 9 9 9 9 9 9 16 9 16 14 10 12 10
10 12 14 16 9 16 9 16 9 9 9 2 9 2 9 9 2 9 2 9 9 9 16 9 16 9 16 14 12 10
10 12 14 16 2 2 16 2 2 2 2 2 2 2 16 16 2 2 2 2 2 2 2 16 2 2 16 14 12 10
12 12 14 16 16 16 14 16 16 16 16 16 16 16 14 14 16 16 16 16 16 16 16 14 16 16 16 14 12 12
12 12 12 14 14 14 12 14 14 14 14 14 14 14 10 10 14 14 14 14 14 14 14 10 14 14 14 10 12 12
12 12 12 12 10 10 12 12 12 12 10 10 10 12 10 10 12 12 12 10 12 12 12 10 10 10 10 12 12 12
12 12 12 12 12 12 12 12 12 12 12 12 12 12 12 12 12 12 12 10 12 12 12 12 12 12 12 12 12 12
---
16 16 16 16 16 16 16 16 16 16 16 16 16 16 16 16 16 16 16 6 6 6 6 6 6 6 6 6 9 6
16 16 16 16 16 16 16 16 16 16 16 16 16 16 16 16 6 16 16 6 6 6 6 6 6 6 6 6 9 9
16 16 16 2 2 2 16 2 2 2 2 2 2 2 16 6 2 2 2 2 2 2 2 6 10 10 10 10 10 9
16 16 2 14 14 14 2 14 14 14 14 14 14 14 2 2 14 14 14 14 14 14 14 2 2 9 9 9 10 9
16 16 2 14 14 14 14 14 14 14 14 14 14 14 14 14 14 14 14 14 14 14 15 15 9 12 12 9 10 9
16 16 2 14 14 14 14 14 14 14 14 14 14 14 14 14 14 14 14 14 14 15 15 9 12 12 12 9 10 9
16 16 7 2 14 14 14 14 14 1 1 1 1 1 1 1 1 1 1 1 15 15 9 12 12 12 9 10 10 9
16 16 2 14 14 14 14 1 1 12 12 12 12 12 12 12 15 15 15 15 15 9 12 12 12 9 10 10 9 9
16 16 2 14 14 14 1 12 12 12 12 12 12 12 12 12 15 12 15 15 9 12 12 12 9 10 10 10 9 9
16 16 2 14 14 14 1 12 12 12 12 12 12 12 10 12 12 15 15 9 9 12 12 9 10 10 14 10 9 9
16 16 7 2 14 14 1 12 12 12 12 10 10 10 12 12 9 9 9 12 12 9 9 10 10 14 10 9 9 9
16 16 7 2 14 14 1 12 12 12 10 10 12 12 12 9 12 12 9 12 12 9 10 10 14 14 10 9 9 9
16 16 2 14 14 14 1 12 12 10 10 12 10 12 9 12 12 12 12 9 9 10 10 1 14 14 14 10 9 9
16 16 2 14 14 14 1 12 12 10 10 10 10 12 9 12 12 12 12 12 9 10 7 1 14 14 14 10 9 9
16 16 2 14 14 14 1 12 12 10 10 10 10 12 9 12 12 12 12 12 9 10 10 1 14 14 14 10 9 9
16 16 2 14 14 14 1 12 12 10 10 10 12 12 9 12 12 12 12 9 12 12 10 1 14 14 14 10 9 9
16 16 2 14 14 14 1 12 10 10 10 10 12 9 12 12 12 9 9 12 12 10 10 1 14 14 14 10 9 9
16 16 2 14 14 14 1 10 10 10 10 10 12 9 9 9 9 12 12 12 10 10 12 1 14 14 14 10 9 9
16 16 2 2 14 14 1 8 8 10 10 10 12 12 12 12 12 12 10 10 10 12 10 1 14 14 10 9 9 9
16 16 2 2 14 14 1 8 10 10 10 10 12 10 12 12 10 10 10 10 10 12 12 1 14 14 10 9 9 9
16 16 2 14 14 14 1 8 8 10 8 10 10 12 12 10 10 10 10 10 12 12 12 1 14 14 14 10 9 9
16 16 2 14 14 14 1 8 8 8 8 8 8 8 8 12 12 12 12 12 12 12 12 1 14 14 14 10 9 9
16 16 2 14 14 14 14 1 1 1 1 1 14 12 12 12 12 14 1 1 1 12 1 14 14 14 14 10 9 9
16 16 16 2 14 14 14 14 14 14 14 14 14 14 14 14 14 14 14 14 14 14 14 14 14 14 10 9 9 9
16 16 2 14 14 14 14 14 14 14 14 14 14 14 14 14 14 14 14 14 14 14 14 14 14 14 14 10 9 9
16 16 2 14 14 14 14 14 14 14 14 14 14 14 14 14 14 14 14 14 14 14 14 14 14 14 14 10 9 9
16 16 2 14 14 14 2 14 14 14 14 14 14 14 2 2 14 14 14 14 14 14 14 2 14 14 14 10 9 9
16 16 16 2 2 2 16 2 2 2 2 2 2 2 16 16 2 2 2 2 2 2 2 9 2 10 10 9 9 9
16 16 16 16 16 16 16 16 16 16 16 16 16 16 16 16 16 16 16 9 9 9 9 9 9 9 9 9 9 9
16 16 16 16 16 16 16 16 16 16 16 16 16 16 16 16 16 16 16 9 9 9 9 9 9 9 9 9 9 9
