1 1 1 1 1 3 3 3 3 3 1 1 1 1 1 3 3 3 3 3 1 1 1 1 1 3 14 3 3 3
1 1 14 1 1 3 3 14 3 3 1 1 1 1 1 3 3 3 3 3 1 1 1 1 1 3 14 3 3 3
1 1 14 1 1 3 14 3 14 3 1 1 1 1 1 3 3 3 3 3 1 1 14 1 14 14 3 14 3 14
1 1 14 1 1 3 3 14 3 3 1 1 1 1 1 3 3 3 3 3 1 1 1 1 1 3 14 3 3 3
1 14 1 14 14 14 3 3 3 3 1 1 1 1 1 3 3 3 3 3 1 1 1 1 1 3 3 3 3 3
3 3 14 3 3 1 1 8 14 1 16 16 16 16 16 16 16 16 16 1 14 14 14 8 8 1 14 1 1 1
3 3 14 3 3 8 19 1 19 14 16 10 10 10 10 10 10 10 16 14 19 19 19 19 8 8 1 1 1 1
3 3 14 3 8 1 8 19 16 19 14 10 10 10 10 10 10 10 14 19 19 19 19 19 8 8 1 1 1 1
3 3 3 3 8 8 16 8 19 19 14 12 12 12 12 12 12 12 14 19 19 19 8 8 8 8 1 1 1 1
3 3 3 8 3 14 8 10 8 19 14 7 7 7 7 7 7 7 14 19 19 8 8 14 14 19 1 1 1 1
1 1 1 19 8 16 14 8 19 19 14 7 14 14 14 14 14 7 14 19 19 8 14 14 8 19 3 3 3 3
1 1 1 1 19 8 8 8 8 19 14 7 7 14 14 14 14 7 14 8 8 8 8 8 19 3 3 3 3 3
1 1 1 16 16 19 19 19 8 8 14 7 7 14 14 14 7 7 14 8 8 19 19 19 16 16 3 3 3 3
1 1 1 16 10 12 12 12 12 19 8 14 7 7 14 7 7 14 8 19 12 12 12 12 10 16 3 3 3 3
1 1 1 16 10 10 7 7 7 12 19 8 14 7 7 7 14 8 19 12 7 14 7 10 10 16 3 3 3 3
3 3 3 16 10 10 7 14 7 7 12 19 8 8 14 14 8 19 12 7 14 14 7 10 10 16 1 1 1 1
3 3 3 16 10 10 7 7 7 7 7 9 8 14 8 8 8 9 7 14 14 14 7 10 10 16 1 1 1 1
3 3 3 16 10 10 7 14 7 7 7 12 14 8 8 8 19 12 7 7 14 14 7 10 10 16 1 1 1 1
3 3 3 16 10 10 7 14 14 7 7 14 8 8 8 19 12 14 7 7 7 14 7 10 10 16 1 1 1 1
3 3 3 16 11 10 10 7 7 7 14 8 8 8 19 12 9 8 14 7 7 7 10 10 11 16 1 1 1 1
1 1 1 16 16 10 10 7 7 14 8 8 8 19 12 9 8 8 8 14 7 7 10 10 16 16 3 3 3 3
1 1 1 1 16 11 10 10 7 19 8 8 19 12 7 12 9 8 8 9 7 10 10 11 16 3 3 3 3 3
1 1 1 1 16 16 10 10 10 12 19 19 12 7 7 7 12 9 9 12 10 10 10 16 16 3 3 3 3 3
1 1 1 1 1 16 11 10 10 10 12 12 7 7 7 7 7 12 12 10 10 10 11 16 1 3 3 3 3 3
1 1 1 1 1 16 16 11 11 10 10 10 10 10 10 10 10 10 10 10 11 11 16 16 1 3 3 3 3 3
3 3 3 3 3 1 16 16 16 11 11 10 10 10 10 10 10 10 11 11 16 16 16 3 3 1 1 1 1 1
3 3 3 3 3 1 1 1 16 16 16 11 11 11 11 11 11 11 16 16 16 3 3 3 3 1 1 1 1 1
3 3 3 3 3 1 1 1 1 1 16 16 16 16 16 16 16 16 16 1 3 3 3 3 3 1 1 1 1 1
3 3 3 3 3 1 1 1 1 1 3 3 3 3 3 1 1 1 1 1 3 3 3 3 3 1 1 1 1 1
3 3 3 3 3 1 1 1 1 1 3 3 3 3 3 1 1 1 1 1 3 3 3 3 3 1 1 1 1 1
---
3 3 3 3 3 11 11 11 11 11 19 19 19 19 19 19 19 19 19 19 16 16 16 16 16 1 9 1 1 1
3 3 3 3 3 11 11 3 11 11 19 19 19 19 19 19 19 19 19 19 16 16 16 16 16 1 9 1 1 1
3 3 3 3 3 11 3 11 3 11 19 19 19 19 19 19 19 19 19 19 16 16 9 16 9 9 1 9 1 9
3 3 3 3 3 11 11 3 11 11 19 19 19 19 19 19 19 19 19 19 16 16 16 16 16 1 9 1 1 1
3 3 3 3 3 3 11 11 11 11 19 19 19 19 19 19 19 19 19 19 16 16 16 16 16 1 1 1 1 1
7 7 3 7 7 3 3 3 3 19 1 1 1 1 1 1 1 1 1 16 3 3 3 3 3 16 1 16 16 16
7 7 3 7 7 3 3 3 3 3 1 1 1 1 1 1 1 1 1 3 3 3 3 3 3 3 16 16 16 16
7 7 3 7 3 3 3 3 3 3 3 1 1 1 1 1 1 1 3 3 3 3 3 3 3 3 16 16 16 16
7 7 7 7 3 3 3 3 3 3 3 1 1 1 1 1 1 1 3 3 3 3 3 3 3 3 16 16 16 16
7 7 7 3 7 3 3 14 3 3 3 1 1 1 1 1 1 1 3 3 3 3 3 3 3 3 16 16 16 16
7 7 7 3 3 3 3 3 3 3 3 1 1 1 1 1 1 1 3 3 3 3 3 3 3 3 10 10 10 10
7 7 7 7 3 3 3 3 3 3 3 1 1 1 1 1 1 1 3 3 3 3 3 3 3 10 10 10 10 10
7 7 7 1 1 3 3 3 3 3 3 1 1 1 1 1 1 1 3 3 3 3 3 3 1 1 10 10 10 10
7 7 7 1 14 1 1 1 1 3 3 3 1 1 1 1 1 3 3 1 1 1 1 1 14 1 10 10 10 10
7 7 7 1 14 14 10 10 10 1 3 3 3 1 1 1 3 3 1 1 10 10 10 14 14 1 10 10 10 10
11 12 12 1 14 14 10 10 10 10 1 3 3 3 3 3 3 1 1 10 10 10 10 14 14 1 12 12 12 12
12 12 12 1 14 14 10 10 10 10 10 1 3 3 3 3 3 1 10 10 10 10 10 14 14 1 12 12 12 12
12 12 12 1 14 14 10 10 10 10 10 1 3 3 3 3 3 1 10 10 10 10 10 14 14 1 12 12 12 12
12 12 12 1 14 14 10 10 10 10 10 3 3 3 3 3 1 1 10 10 10 10 10 14 14 1 12 12 12 12
12 12 12 1 1 14 14 10 10 10 3 3 3 3 3 1 3 3 1 10 10 10 14 14 1 1 12 12 12 12
7 7 7 1 1 14 14 10 10 3 3 3 3 3 1 3 3 3 3 1 10 10 14 14 1 1 8 8 8 8
7 7 7 7 1 14 14 14 10 3 3 3 3 1 14 1 3 3 3 3 10 14 14 14 1 8 8 8 8 8
7 7 7 7 1 1 14 14 14 1 3 3 1 14 14 14 1 3 3 1 14 14 14 1 1 8 8 8 8 8
7 7 7 7 7 1 1 14 14 14 1 1 14 14 14 14 14 1 1 14 14 14 1 1 10 8 8 8 8 8
7 7 7 7 7 1 1 1 1 14 14 14 14 14 14 14 14 14 14 14 1 1 1 1 10 8 8 8 8 8
16 16 16 16 16 7 1 1 1 1 1 14 14 14 14 14 14 14 1 1 1 1 1 8 8 8 8 8 8 8
16 16 16 16 16 7 7 7 1 1 1 1 1 1 1 1 1 1 1 1 1 8 8 8 8 8 8 8 8 8
16 16 16 16 16 7 7 7 7 7 1 1 1 1 1 1 1 1 1 14 8 8 8 8 8 8 8 8 8 8
16 16 16 16 16 7 7 7 7 7 1 1 1 1 1 14 14 14 14 14 8 8 8 8 8 8 8 8 8 8
16 16 16 16 16 7 7 7 7 7 1 1 1 1 1 14 14 14 14 14 8 8 8 8 8 8 8 8 8 8
