0 0 0 18 18 0 18 18 0 0 0
0 0 18 8 8 18 8 8 18 0 0
0 0 18 8 8 18 8 8 18 0 0
0 0 18 8 8 18 8 8 18 0 0
0 18 8 8 8 8 8 8 8 18 0
18 8 8 8 8 8 8 8 8 8 18
18 8 8 18 8 8 8 18 8 8 18
18 8 10 18 8 18 8 18 10 8 18
18 8 10 10 8 8 8 10 10 8 18
0 18 8 8 8 8 8 8 8 18 0
0 0 18 18 18 18 18 18 18 0 0
---
0 0 0 8 8 0 8 8 0 0 0
0 0 8 10 10 8 10 10 8 0 0
0 0 8 8 10 8 10 8 8 0 0
0 0 8 18 8 8 8 18 8 0 0
0 8 18 18 18 18 18 18 18 8 0
8 18 18 18 18 18 18 18 18 18 8
8 18 18 18 18 18 18 18 18 18 8
8 18 8 18 18 18 18 18 8 18 8
8 8 8 8 18 18 18 8 8 8 8
0 8 8 8 8 8 8 8 8 8 0
0 0 8 8 8 8 8 8 8 0 0
