1 1 4 4 4 4 4 4 4 4 1 1 1 4 4 4 4 1 1 1 4 4 4 4 4 4 4 4 1 1
1 4 14 4 4 4 14 14 14 4 4 4 1 1 4 4 14 14 14 4 4 4 4 4 4 4 14 4 4 1
4 14 4 14 4 14 14 18 14 14 4 4 4 1 1 14 14 18 14 14 4 4 4 4 4 4 4 4 4 4
4 4 14 4 14 14 18 9 18 14 14 4 4 4 14 14 18 9 18 14 14 1 1 1 1 4 14 4 4 4
4 4 4 1 14 18 9 9 9 18 14 14 14 14 14 18 9 9 9 18 14 1 1 14 1 14 1 14 4 14
4 4 1 1 14 18 15 15 9 9 18 18 18 18 18 9 9 9 9 18 14 1 1 1 1 1 14 1 4 4
4 1 1 1 14 18 15 15 15 9 9 9 9 9 9 9 9 9 9 18 14 4 4 4 1 1 14 1 1 4
1 1 1 14 14 18 15 15 15 15 15 15 15 9 9 9 9 9 9 18 14 14 4 4 4 1 1 1 1 1
1 1 1 14 18 18 15 15 15 15 15 15 15 15 9 15 9 9 9 18 18 14 4 4 4 4 14 1 1 1
1 1 1 14 18 15 15 15 15 15 15 15 15 15 15 9 15 15 9 15 18 14 1 4 14 4 4 1 1 1
1 1 4 14 18 10 15 10 15 15 15 15 15 15 15 15 15 15 15 15 18 14 1 14 4 14 4 4 1 1
1 1 4 14 18 10 10 10 10 15 15 15 15 15 15 15 15 15 15 15 18 14 1 1 14 4 4 4 1 1
1 14 14 14 18 10 10 10 10 10 10 10 15 15 15 15 15 10 15 10 18 14 14 14 1 4 4 4 1 1
1 14 18 18 10 10 10 10 10 10 10 10 10 10 10 10 10 10 10 10 10 18 18 14 1 4 4 4 1 1
1 14 18 10 10 10 10 10 10 10 10 10 10 10 10 10 10 10 10 10 10 3 18 14 1 4 4 4 1 1
1 14 14 18 10 10 10 10 10 10 10 10 10 3 10 3 3 3 3 3 3 18 14 1 14 14 14 14 14 1
1 1 14 14 18 18 10 10 10 10 3 3 3 3 3 3 3 3 3 18 18 14 1 14 14 18 18 18 14 1
1 1 4 14 14 14 18 10 3 3 3 3 3 3 3 3 3 3 18 14 14 1 14 18 18 3 3 18 14 1
1 1 1 4 4 14 14 18 3 3 3 3 3 3 3 3 3 18 14 1 1 14 18 3 3 3 3 18 14 1
1 1 1 1 14 14 18 1 3 3 3 3 3 3 3 3 3 3 18 14 14 18 3 3 3 3 6 18 14 1
1 1 1 1 14 18 1 1 1 3 1 1 1 3 3 3 3 1 3 18 18 3 6 3 6 6 6 18 14 1
4 1 1 14 14 18 1 1 1 1 1 1 1 1 1 1 1 1 1 18 3 6 6 6 6 6 6 18 14 4
4 4 1 14 18 1 1 1 1 1 1 1 1 1 1 1 1 1 1 6 18 6 6 6 6 6 18 18 14 4
4 4 4 14 18 1 1 1 18 1 1 1 1 6 6 6 18 6 6 6 18 6 6 6 6 18 18 14 14 4
4 4 4 14 18 1 1 6 1 18 1 6 18 6 6 18 6 6 6 6 18 6 6 6 18 18 14 14 4 4
4 4 4 14 18 18 6 6 6 18 6 6 18 6 6 18 6 6 6 18 18 18 18 18 14 14 14 4 4 4
1 4 4 14 14 18 18 18 18 18 6 6 18 6 6 18 18 18 18 18 14 14 14 14 14 4 4 4 4 1
1 1 4 4 14 14 14 14 14 14 18 18 18 18 18 14 14 14 14 14 14 1 1 4 4 4 4 4 1 1
1 1 1 4 4 4 4 4 1 14 14 14 14 14 14 14 1 1 1 1 1 1 4 4 4 4 4 1 1 1
1 1 1 1 4 4 4 4 4 1 1 1 1 1 1 1 1 1 1 1 1 4 4 4 4 4 1 1 1 1
---
1 1 4 4 4 4 4 4 4 4 1 1 1 4 4 4 4 1 1 1 4 4 4 4 4 4 4 4 1 1
1 4 15 4 4 4 15 15 15 4 4 4 1 1 4 4 15 15 15 4 4 4 4 4 4 4 15 4 4 1
4 15 4 15 4 15 15 14 15 15 4 4 4 1 1 15 15 14 15 15 4 4 4 4 4 4 4 4 4 4
4 4 15 4 15 15 14 3 14 15 15 4 4 4 15 15 14 3 14 15 15 1 1 1 1 4 4 4 4 4
4 4 4 1 15 14 3 3 3 14 15 15 15 15 15 14 3 3 3 14 15 1 1 15 1 4 1 4 4 15
4 4 1 1 15 14 10 10 3 3 14 14 14 14 14 3 3 3 3 14 15 1 1 1 1 1 4 1 4 4
4 1 1 1 15 14 10 10 10 3 3 3 3 3 3 3 3 3 3 14 15 4 4 4 1 1 4 1 1 4
1 1 1 15 15 14 10 10 10 10 10 10 10 3 3 3 3 3 3 14 15 15 4 4 4 1 1 1 1 1
1 1 1 15 14 14 10 10 10 10 10 10 10 10 3 10 3 3 3 14 14 15 4 4 4 4 15 1 1 1
1 1 1 15 14 10 10 10 10 10 10 10 10 10 10 3 10 10 3 10 14 15 1 4 15 4 4 1 1 1
1 1 15 15 14 14 10 14 10 10 10 10 10 10 10 10 10 10 10 10 14 15 1 15 4 15 4 4 1 1
1 1 15 15 14 14 14 14 14 10 10 10 10 10 10 10 10 10 10 10 14 15 1 1 15 4 4 4 1 1
1 15 15 15 14 14 14 14 14 14 3 3 10 10 10 10 10 10 10 3 14 15 15 9 1 4 4 4 1 1
1 1 14 14 14 14 14 14 14 14 3 3 3 3 3 3 3 3 3 3 3 14 14 9 1 4 4 4 1 1
1 1 14 14 14 14 14 14 14 14 3 3 3 3 3 3 3 3 3 3 3 6 14 9 1 4 4 4 1 1
1 1 1 14 14 14 14 14 14 14 3 3 3 6 3 6 6 6 6 6 6 14 9 1 9 9 9 9 9 1
1 1 1 1 14 14 14 14 14 14 6 6 6 6 6 6 6 6 6 14 14 9 1 9 9 14 14 14 9 1
1 1 1 1 1 1 14 14 6 6 6 6 6 6 6 6 6 6 14 9 9 1 9 14 14 18 18 14 9 1
1 1 1 1 1 1 1 14 6 6 6 6 6 6 6 6 6 14 9 1 1 9 14 18 18 18 18 14 9 1
1 1 1 1 1 1 14 18 6 6 6 6 6 6 6 6 6 6 14 9 9 14 18 18 18 18 18 14 9 1
1 1 1 1 1 14 18 18 18 6 18 18 18 6 6 6 6 18 6 14 14 18 18 18 18 18 18 14 9 1
4 1 1 1 1 14 18 18 18 18 18 18 18 18 18 18 18 18 18 14 18 18 18 18 18 18 18 14 9 4
4 4 1 1 14 18 18 18 18 18 18 18 18 18 18 18 18 18 18 18 14 18 18 18 18 18 14 14 9 4
4 4 4 1 14 18 18 18 14 18 18 18 18 18 18 18 14 18 18 18 14 18 18 18 18 14 14 9 9 4
4 4 4 1 14 18 18 18 18 14 18 18 14 18 18 14 18 18 18 18 14 18 18 18 14 14 9 9 4 4
4 4 4 1 14 14 18 18 18 14 18 18 14 18 18 14 18 18 18 14 14 14 14 14 9 9 9 4 4 4
1 4 4 1 1 14 14 14 14 14 18 18 14 18 18 14 14 14 14 14 1 1 9 9 9 4 4 4 4 1
1 1 4 4 1 1 1 1 1 1 14 14 14 14 14 1 1 1 1 1 1 1 1 4 4 4 4 4 1 1
1 1 1 4 4 4 4 4 1 1 1 1 1 1 1 1 1 1 1 1 1 1 4 4 4 4 4 1 1 1
1 1 1 1 4 4 4 4 4 1 1 1 1 1 1 1 1 1 1 1 1 4 4 4 4 4 1 1 1 1
