11 11 11 11 11 9 11 11 11 11 11 9 11 11 11 11 11 11 11 11 11 11 11 11 11 11 11 11 11 11
11 11 11 11 11 11 11 11 11 11 9 14 10 11 11 11 11 11 9 11 11 11 11 11 10 11 11 11 11 11
11 11 11 11 11 10 11 11 11 11 11 9 11 11 11 11 11 11 11 11 10 11 11 10 14 9 9 11 9 11
11 11 11 11 9 14 10 11 11 11 11 11 11 11 11 11 11 11 11 11 11 11 11 11 9 11 11 11 11 11
11 9 11 9 14 14 14 10 11 9 11 11 11 14 14 14 14 14 14 14 11 11 11 11 9 11 11 11 11 11
11 11 11 11 9 14 9 11 11 11 11 11 14 14 16 16 16 16 16 14 14 14 11 11 11 11 11 11 10 11
11 11 11 11 11 9 11 11 11 11 11 14 14 16 16 15 15 15 16 16 16 14 11 11 11 11 11 10 14 10
11 11 10 11 11 11 14 14 14 14 14 14 16 16 15 15 15 15 15 15 16 14 14 14 14 14 14 11 10 11
11 10 14 10 11 14 14 16 16 16 16 16 16 15 15 15 15 9 15 15 16 16 16 16 16 16 14 11 11 11
11 11 10 11 11 14 16 16 15 15 15 2 2 15 15 15 9 9 9 15 2 2 15 15 15 16 14 11 11 11
11 11 11 14 14 14 16 15 15 9 9 2 2 15 15 15 9 9 9 15 2 15 15 15 15 16 14 11 11 11
11 11 11 14 16 16 16 15 9 9 9 9 2 15 15 15 15 9 9 15 2 15 9 9 9 16 14 14 14 11
11 11 14 14 16 15 15 15 15 9 9 9 2 15 15 15 15 9 15 2 9 9 9 9 9 16 16 16 14 11
11 11 14 16 16 15 15 15 15 15 9 9 15 2 12 12 12 12 12 15 9 15 15 15 15 15 9 16 14 11
11 11 14 16 15 15 15 15 15 15 9 15 12 12 12 10 10 10 12 12 15 15 9 15 15 15 9 16 14 11
11 11 14 16 16 2 15 15 15 15 15 12 12 10 14 14 14 14 10 12 9 9 15 15 15 9 16 16 14 11
11 14 14 14 16 2 2 15 15 15 15 12 10 10 14 10 10 10 14 12 9 9 15 9 9 9 16 14 14 11
11 14 16 16 15 15 9 9 2 2 15 12 12 10 10 15 15 15 10 12 9 9 15 9 9 16 16 14 11 11
11 14 16 15 15 15 15 9 9 9 9 9 2 15 15 15 15 15 15 15 2 9 9 9 16 16 14 14 11 11
11 14 16 15 15 15 15 9 9 9 2 2 15 15 15 15 15 15 15 15 9 9 2 2 16 14 14 11 11 11
11 14 16 16 16 15 15 15 9 9 9 9 15 15 15 15 15 9 9 9 5 5 6 6 16 14 11 11 11 11
11 14 14 14 16 16 2 6 6 5 5 9 9 9 9 9 9 9 9 15 15 5 5 16 16 14 11 11 9 11
11 11 11 14 16 2 6 6 5 9 9 9 9 9 9 9 15 15 15 15 16 16 16 16 14 14 11 11 11 11
11 10 11 14 16 6 5 16 16 9 9 9 15 15 15 5 5 15 15 5 5 16 16 14 14 11 11 11 10 11
10 14 9 14 16 16 16 16 16 16 9 15 15 15 5 5 5 16 5 5 6 6 16 14 11 11 11 9 14 10
11 9 11 14 14 14 14 14 14 16 16 16 16 16 6 5 5 16 16 6 6 6 16 14 9 11 9 14 14 14
11 9 11 11 11 11 11 11 14 14 14 14 14 16 16 16 16 16 16 16 16 16 16 14 11 11 11 9 14 9
11 11 11 11 11 10 11 11 11 11 11 11 14 14 14 14 14 14 14 14 14 14 14 14 11 11 11 11 9 11
11 11 11 11 10 14 10 11 11 11 9 11 11 11 11 11 11 11 11 11 11 11 11 11 11 10 11 11 11 11
11 11 11 11 11 10 11 11 11 11 11 11 11 11 11 11 11 11 11 11 11 11 11 11 10 14 10 11 11 11
---
11 11 11 11 11 15 11 11 11 11 11 15 11 11 11 11 11 11 11 11 11 11 11 11 11 11 11 11 11 11
11 11 11 11 11 11 11 11 11 11 15 15 15 11 11 11 11 11 15 11 11 11 11 11 15 11 11 11 11 11
11 11 11 11 11 15 11 11 11 11 11 15 11 11 11 11 11 11 11 11 15 11 11 15 15 15 15 11 15 11
11 11 11 11 15 15 15 11 11 11 11 11 11 11 11 11 11 11 11 11 11 11 11 11 15 11 11 11 11 11
11 15 11 15 15 15 15 15 11 15 11 11 11 12 12 12 12 12 12 12 11 11 11 11 15 11 11 11 11 11
11 11 11 11 15 15 15 11 11 11 11 11 12 12 9 9 9 9 9 12 12 12 11 11 11 11 11 11 15 11
11 11 11 11 11 15 11 11 11 11 11 12 12 9 9 14 14 14 9 9 9 12 11 11 11 11 11 15 15 15
11 11 15 11 11 11 5 5 5 5 5 12 9 9 14 14 14 14 14 14 9 12 12 6 6 6 6 11 15 11
11 15 15 15 11 5 5 9 9 9 9 9 9 14 14 14 14 14 14 14 9 9 9 9 9 9 6 11 11 11
11 11 15 11 11 5 9 9 14 14 14 14 14 14 14 14 14 14 14 14 14 14 14 14 14 9 6 11 11 11
11 11 11 16 5 5 9 14 14 14 14 14 14 14 14 14 14 14 14 14 14 14 14 14 14 9 6 11 11 11
11 11 11 16 9 9 9 14 14 14 14 14 14 14 14 14 14 14 14 14 14 14 5 5 5 9 6 6 6 11
11 11 16 16 9 14 14 14 14 14 14 14 14 14 14 14 14 14 14 14 5 5 5 5 5 9 9 9 6 11
11 11 16 9 9 14 14 14 14 14 14 14 14 14 16 16 16 16 16 14 5 14 14 14 14 14 15 9 6 11
11 11 16 9 14 14 14 14 14 14 14 14 16 16 16 16 16 16 16 16 14 14 15 14 14 14 15 9 6 11
11 11 16 9 9 2 14 14 14 14 14 16 16 16 16 16 16 16 16 16 15 15 14 14 14 15 9 9 9 11
11 16 16 16 9 2 2 14 14 14 14 16 16 16 16 16 16 16 16 16 15 15 14 15 15 15 9 9 9 11
11 16 9 9 2 2 15 15 15 15 14 16 16 16 16 16 16 16 16 16 15 15 14 15 15 9 9 9 11 11
11 16 9 2 2 2 2 15 15 15 15 15 16 16 16 16 16 16 16 16 16 15 15 15 9 9 9 9 11 11
11 16 9 2 2 2 2 15 15 15 16 16 16 16 16 16 16 16 16 16 15 15 10 10 9 9 9 11 11 11
11 16 9 9 9 2 2 2 15 15 15 15 16 16 16 16 16 15 15 15 10 10 10 10 9 9 11 11 11 11
11 16 16 16 9 9 9 2 2 2 2 15 15 15 15 15 15 15 15 10 10 10 10 9 9 9 11 11 15 11
11 11 11 16 9 9 2 2 2 15 15 15 15 15 15 15 10 10 10 10 9 9 9 9 15 9 11 11 11 11
11 15 11 16 9 2 2 9 9 15 15 15 10 10 10 10 10 10 10 10 10 9 9 15 15 11 11 11 15 11
15 15 15 16 9 9 9 9 9 9 15 10 10 10 10 10 10 9 10 10 10 10 9 15 11 11 11 15 15 15
11 15 11 16 16 16 16 16 16 9 9 9 9 9 10 10 10 9 9 10 10 10 9 15 15 11 15 15 15 15
11 15 11 11 11 11 11 11 16 16 16 16 16 9 9 9 9 9 9 9 9 9 9 15 11 11 11 15 15 15
11 11 11 11 11 15 11 11 11 11 11 11 16 16 16 16 16 16 16 15 15 15 15 15 11 11 11 11 15 11
11 11 11 11 15 15 15 11 11 11 15 11 11 11 11 11 11 11 11 11 11 11 11 11 11 15 11 11 11 11
11 11 11 11 11 15 11 11 11 11 11 11 11 11 11 11 11 11 11 11 11 11 11 11 15 15 15 11 11 11
