17 17 5 5 5 5 5 5 17 17 17 5 5 17 14 14 14 17 17 5 5 5 17 17 17 5 17 5 17 17
17 17 5 14 14 5 5 5 17 17 17 5 5 14 14 18 14 17 5 5 5 5 14 14 17 5 5 5 17 17
17 17 17 5 14 14 5 17 17 17 5 5 14 14 18 18 14 14 14 14 5 14 14 17 17 5 5 17 17 17
17 14 17 5 5 14 5 17 17 14 14 14 14 18 15 18 14 18 18 14 5 14 17 17 17 14 5 17 17 17
17 14 14 5 5 5 5 14 14 14 18 18 18 15 15 15 18 15 18 14 5 5 5 17 14 14 5 17 17 17
17 17 17 5 5 5 14 14 18 18 15 15 15 15 15 15 15 15 18 14 5 5 5 14 17 17 5 17 17 17
17 17 17 5 5 14 14 18 15 15 15 15 15 15 15 15 15 18 14 14 5 5 17 17 17 5 5 17 17 17
17 14 14 5 5 14 18 9 15 9 9 15 15 15 9 15 9 9 18 14 5 5 17 14 14 5 5 17 17 17
17 17 17 5 5 14 18 9 9 9 9 9 9 9 9 15 9 9 18 14 14 5 17 17 17 14 14 17 17 17
17 17 17 5 14 14 18 9 9 9 9 9 9 9 9 15 9 9 9 18 14 5 17 17 17 5 5 17 17 17
17 17 5 5 14 18 6 9 9 9 9 9 9 9 9 9 9 9 9 18 14 5 17 17 17 5 5 17 17 17
17 17 5 5 14 18 6 6 9 6 9 9 9 9 9 9 9 9 9 18 14 5 17 17 17 5 5 5 17 17
17 17 5 5 14 18 6 6 6 6 6 9 9 6 9 9 9 9 9 18 14 14 17 17 17 5 5 5 17 17
17 17 5 5 14 18 6 6 6 6 6 6 9 6 6 6 6 6 6 18 18 14 14 17 17 5 5 5 17 17
17 17 5 5 14 14 18 6 6 6 6 6 9 6 6 6 6 6 6 6 6 18 14 14 17 5 5 5 17 17
17 17 17 5 5 14 18 6 6 6 6 6 6 6 6 6 6 6 1 1 6 1 18 14 17 5 5 5 17 17
17 17 17 5 5 14 18 6 6 6 6 6 6 6 6 1 6 1 1 1 1 1 18 14 14 17 5 5 17 17
17 17 17 5 5 14 18 6 6 6 6 6 1 6 6 1 1 1 1 1 1 1 1 18 14 17 5 5 17 17
17 17 17 5 5 14 18 6 6 1 1 1 1 1 6 1 1 18 1 1 1 1 1 18 14 17 5 5 17 17
17 17 17 5 5 14 18 1 1 6 1 1 1 1 1 1 1 1 1 1 1 1 1 18 14 14 5 5 17 17
17 17 17 5 5 14 18 1 1 1 1 1 1 1 1 1 7 1 18 1 1 1 1 1 18 14 5 5 17 17
17 17 17 5 5 14 14 18 7 7 1 7 1 1 1 7 7 7 7 18 18 1 1 1 18 14 14 5 17 17
17 17 17 5 5 5 14 18 7 7 7 7 7 7 1 7 7 7 7 7 7 18 18 18 18 18 14 14 5 17
17 17 17 5 5 5 14 14 18 7 7 7 7 7 7 7 7 7 7 7 7 7 7 7 7 7 18 14 14 17
17 17 17 5 5 5 5 14 14 18 7 7 7 18 18 18 18 7 7 18 18 18 7 7 7 7 7 18 14 17
17 17 17 5 5 5 17 17 14 14 18 18 18 14 14 14 14 18 18 14 14 14 18 18 18 18 18 14 14 17
17 17 5 5 5 5 17 17 14 14 18 15 18 14 5 14 18 15 18 14 14 14 14 14 14 14 14 14 5 17
17 17 5 5 5 5 17 17 14 18 15 15 18 14 5 14 18 15 15 18 14 5 5 17 17 17 5 5 5 17
17 17 5 5 5 5 17 17 14 14 14 14 14 14 5 14 14 14 14 14 14 5 17 17 17 17 17 5 5 5
17 17 5 5 5 5 17 17 17 17 5 5 5 5 5 17 17 17 17 17 5 5 17 17 17 17 17 5 5 5
---
17 17 7 7 7 7 7 7 17 17 17 6 6 17 6 6 6 17 17 1 1 1 17 17 17 1 17 1 17 17
17 17 7 7 7 7 7 7 17 17 17 6 6 6 6 5 6 17 1 1 1 1 1 1 17 1 1 1 17 17
17 17 17 7 7 7 7 17 17 17 6 6 6 6 5 5 6 6 6 6 1 1 1 17 17 1 1 17 17 17
17 7 17 7 7 7 7 17 17 9 9 6 6 5 5 5 6 5 5 6 1 1 17 17 17 1 1 17 17 17
17 7 7 7 7 7 7 9 9 9 5 5 5 5 5 5 5 5 5 6 1 1 1 17 1 1 1 17 17 17
17 17 17 7 7 7 9 9 5 5 5 5 5 5 5 5 5 5 5 6 1 1 1 1 17 17 1 17 17 17
17 17 17 7 7 9 9 5 5 5 5 5 5 5 5 5 5 5 6 6 1 1 17 17 17 1 1 17 17 17
17 7 7 7 7 9 5 5 5 5 5 5 5 5 5 5 5 5 5 6 1 1 17 15 15 1 1 17 17 17
17 17 17 7 7 9 5 5 5 5 5 5 5 5 5 5 5 5 5 6 6 1 17 17 17 15 15 17 17 17
17 17 17 7 9 9 5 5 5 5 5 5 5 5 5 5 5 5 5 5 6 1 17 17 17 15 15 17 17 17
17 17 7 7 9 5 18 5 5 5 5 5 5 5 5 5 5 5 5 5 6 1 17 17 17 15 15 17 17 17
17 17 7 7 9 5 18 18 5 18 5 5 5 5 5 5 5 5 5 5 6 1 17 17 17 15 15 15 17 17
17 17 7 7 9 5 18 18 18 18 18 5 5 18 5 5 5 5 5 5 6 6 17 17 17 15 15 15 17 17
17 17 7 7 9 5 18 18 18 18 18 18 5 18 18 18 18 18 18 5 5 6 6 17 17 15 15 15 17 17
17 17 9 9 9 9 5 18 18 18 18 18 5 18 18 18 18 18 18 18 18 5 6 6 17 15 15 15 17 17
17 17 17 9 9 9 5 18 18 18 18 18 18 18 18 18 18 18 14 14 18 14 5 6 17 15 15 15 17 17
17 17 17 9 9 9 5 18 18 18 18 18 18 18 18 14 18 14 14 14 14 14 5 6 6 17 15 15 17 17
17 17 17 9 9 9 5 18 18 18 18 18 14 18 18 14 14 14 14 14 14 14 14 5 6 17 15 15 17 17
17 17 17 9 9 9 5 18 18 14 14 14 14 14 18 14 14 14 14 14 14 14 14 5 6 17 15 15 17 17
17 17 17 9 9 9 5 14 14 18 14 14 14 14 14 14 14 14 14 14 14 14 14 5 6 6 15 15 17 17
17 17 17 9 9 9 5 14 14 14 14 14 14 14 14 14 14 14 5 14 14 14 14 14 5 6 15 15 17 17
17 17 17 9 9 9 9 5 14 14 14 14 14 14 14 14 14 14 14 5 5 14 14 14 5 6 6 15 17 17
17 17 17 9 9 9 9 5 14 14 14 14 14 14 14 14 14 14 14 14 14 5 5 5 5 5 6 6 15 17
17 17 17 14 14 14 9 9 5 14 14 14 14 14 14 14 14 14 14 14 14 14 14 14 14 14 5 6 6 17
17 17 17 14 14 14 14 9 9 5 14 14 14 5 5 5 5 14 14 5 5 5 14 14 14 14 14 5 6 17
17 17 17 14 14 14 17 17 9 9 5 5 5 18 18 18 6 5 5 6 6 6 5 5 5 5 5 6 6 17
17 17 14 14 14 14 17 17 9 9 5 5 5 18 18 18 5 5 5 6 6 1 1 1 1 1 1 1 1 17
17 17 14 14 14 14 17 17 9 5 5 5 5 18 18 18 5 5 5 5 6 1 1 17 17 17 1 1 1 17
17 17 14 14 14 14 17 17 9 9 18 18 18 18 18 18 6 6 6 6 6 1 17 17 17 17 17 1 1 1
17 17 14 14 14 14 17 17 17 17 18 18 18 18 18 17 17 17 17 17 1 1 17 17 17 17 17 1 1 1
