4 4 4 4 4 4 14 14 4 4 4 4 4 4 4 4 14 4 14 4 4 4 4 14 4 4 4 4 14 4
4 4 4 4 4 14 1 14 14 4 4 4 4 4 4 4 4 14 4 4 4 4 14 4 4 4 14 14 4 14
14 4 4 4 4 14 1 1 14 4 4 4 4 4 4 4 4 4 4 4 4 4 14 4 4 4 14 14 1 14
4 14 4 4 4 4 14 14 4 4 14 14 14 14 14 14 14 14 14 14 4 4 14 4 14 4 1 4 1 14
14 4 4 4 4 4 4 4 14 14 14 18 18 18 18 18 18 18 18 14 14 14 14 4 4 14 4 1 1 14
4 4 4 4 4 4 4 14 14 18 18 14 14 14 14 14 14 14 14 18 18 14 14 14 4 1 1 1 14 4
4 4 4 14 4 4 14 14 18 14 14 14 7 7 7 7 7 7 14 14 14 18 14 14 14 14 14 14 4 4
4 4 4 4 4 14 14 18 14 14 7 7 14 14 7 7 7 7 7 14 14 14 18 14 14 4 4 4 14 4
14 14 4 4 4 14 18 14 14 7 7 14 14 14 7 7 7 7 7 14 7 14 14 18 14 4 4 14 4 14
4 4 14 4 4 14 18 14 7 7 7 14 14 7 7 7 7 7 7 7 14 7 14 18 14 4 4 4 14 4
14 14 4 14 4 14 18 14 7 7 14 7 7 7 7 7 7 7 7 7 14 7 14 18 14 14 14 4 4 4
14 14 4 14 4 14 18 14 3 7 3 7 7 7 3 3 3 7 3 14 14 3 14 18 14 1 14 14 4 4
1 4 1 14 4 14 18 14 3 3 3 3 3 3 3 3 3 7 3 3 14 3 14 18 14 1 1 14 4 4
4 1 1 14 4 14 18 14 3 3 3 3 3 3 3 3 3 3 3 3 14 3 14 18 14 14 14 4 4 4
1 1 14 4 4 14 18 14 14 3 3 3 3 3 3 3 3 3 3 14 3 14 14 18 14 4 4 4 4 4
14 14 4 14 14 14 14 18 14 14 14 14 14 14 14 14 14 14 14 3 14 14 18 14 14 14 14 4 4 4
4 4 14 14 18 18 14 14 18 18 14 18 18 18 18 18 18 18 18 14 18 18 14 14 18 18 14 14 4 4
4 4 14 18 14 14 18 14 14 18 18 14 3 14 14 14 14 3 14 18 18 14 14 18 14 14 18 14 4 4
4 4 14 18 3 3 14 18 18 14 14 3 3 3 3 3 3 3 3 14 14 18 18 14 3 3 18 14 4 4
4 4 14 18 3 3 14 14 14 18 3 18 3 14 3 3 14 3 18 3 18 14 14 14 3 3 18 14 4 4
4 4 14 14 18 1 1 1 18 1 18 1 1 18 14 14 18 1 1 18 1 18 1 1 1 18 14 14 4 4
4 4 4 14 14 18 18 18 14 1 18 14 1 18 18 18 18 1 14 18 1 14 18 18 18 14 14 4 4 14
4 14 4 14 18 14 14 1 1 1 18 14 1 18 14 14 18 1 14 18 1 1 1 14 14 18 14 4 14 4
4 4 4 14 18 14 1 1 1 18 14 1 1 18 14 14 18 1 1 14 18 1 1 1 14 18 14 14 4 4
4 4 4 14 14 18 18 18 18 14 1 1 18 18 14 14 18 18 1 1 14 18 18 18 18 14 14 14 4 1
4 4 14 4 14 14 14 14 18 14 14 14 18 14 14 14 14 18 14 14 14 18 14 14 14 14 4 14 4 14
4 14 4 4 14 14 4 14 14 18 18 18 14 14 4 4 14 14 18 18 18 14 14 4 4 4 4 4 14 4
4 14 4 1 14 14 1 14 14 14 14 14 14 4 4 4 4 14 14 14 14 14 4 4 14 4 4 4 4 14
4 14 4 14 4 1 1 14 4 4 4 4 4 4 4 4 4 4 4 4 4 4 4 14 4 14 4 4 4 4
4 4 14 4 1 1 14 4 4 4 4 4 4 4 4 4 4 4 4 4 4 4 4 4 14 4 4 4 4 4
---
14 14 14 14 14 14 7 7 14 14 14 14 14 14 14 14 14 14 14 14 14 14 14 4 14 14 14 14 4 14
14 14 14 14 14 7 14 7 7 14 14 14 14 14 14 14 14 14 14 14 14 14 4 14 14 14 4 4 14 4
14 14 14 14 14 7 14 14 7 14 14 14 14 14 14 14 14 14 14 14 14 14 4 14 14 14 4 4 14 4
14 14 14 14 14 14 7 7 14 14 4 4 4 4 4 4 4 4 4 4 14 14 4 14 14 14 14 14 14 4
14 14 14 14 14 14 14 14 7 7 7 14 14 14 14 14 14 14 14 4 4 4 4 14 14 14 14 14 14 4
14 14 14 14 14 14 14 7 7 14 14 7 7 7 7 7 7 7 7 14 14 4 4 4 14 14 14 14 4 14
14 14 14 14 14 14 4 7 14 7 7 7 18 18 18 18 18 18 7 7 4 14 4 4 4 4 4 4 14 14
14 14 14 14 14 4 4 1 7 7 18 18 7 7 18 18 18 18 18 18 4 4 1 4 4 14 14 14 4 14
4 4 14 14 14 4 1 7 7 18 18 7 7 7 18 18 18 18 18 18 18 4 4 1 4 14 14 4 14 4
14 14 4 14 14 4 1 7 18 18 18 7 7 18 18 18 18 18 18 18 18 18 18 1 4 14 14 14 4 14
4 4 14 4 14 4 1 7 18 18 7 18 18 18 18 18 18 18 18 18 18 18 18 1 4 4 4 14 14 14
4 4 14 4 14 4 1 7 18 18 18 18 18 18 18 18 18 18 18 18 18 18 18 1 4 14 4 4 14 14
14 14 14 4 14 4 1 7 18 18 18 18 18 18 18 18 18 18 18 18 18 18 18 1 4 14 14 4 14 14
14 14 14 4 14 4 1 7 18 18 18 18 18 18 18 18 18 18 18 18 18 18 18 1 4 4 4 14 14 14
14 14 4 14 14 4 1 7 7 18 18 18 18 18 18 18 18 18 18 18 18 18 18 1 4 14 14 14 14 14
4 4 14 4 4 4 4 1 7 7 7 18 18 18 18 18 18 18 18 18 18 18 1 4 4 4 4 14 14 14
14 14 4 4 1 1 4 4 1 1 18 1 1 1 1 1 1 1 1 18 1 1 4 4 1 1 4 4 14 14
14 14 4 1 4 4 1 4 4 1 1 4 4 4 4 4 4 4 4 1 1 4 4 1 4 4 1 4 14 14
14 14 4 1 4 4 4 1 1 4 4 4 4 4 4 4 4 4 4 4 4 1 1 4 4 4 1 4 14 14
14 14 4 1 4 4 4 4 4 1 4 4 4 4 4 4 4 4 1 4 1 4 4 4 4 4 1 4 14 14
14 14 4 4 1 4 4 4 1 4 4 4 4 4 4 4 4 4 4 1 4 1 4 4 4 1 4 4 14 14
14 14 14 4 4 1 1 1 4 4 4 4 4 4 4 4 4 4 4 1 4 4 1 1 1 3 3 14 14 3
14 14 14 4 4 4 4 4 4 4 4 4 4 4 3 3 4 4 4 4 4 4 4 3 3 4 3 14 3 14
14 14 14 4 4 4 4 4 4 4 4 4 4 4 3 3 4 4 4 4 4 4 4 4 3 4 3 3 14 14
14 14 14 3 3 4 4 4 4 4 4 4 4 4 3 3 4 4 4 4 4 4 4 4 4 3 3 3 14 14
14 14 3 14 3 3 3 3 4 4 4 4 4 3 3 3 3 4 4 4 4 4 3 3 3 3 14 3 14 3
14 3 14 14 3 3 14 3 3 4 4 4 3 3 14 14 3 3 4 4 4 3 3 14 14 14 14 14 3 14
14 3 14 14 3 3 14 3 3 3 3 3 3 14 14 14 14 3 3 3 3 3 14 14 14 14 14 14 14 3
14 3 14 3 14 14 14 3 14 14 14 14 14 14 14 14 14 14 14 14 14 14 14 14 14 14 14 14 14 14
14 14 3 14 14 14 3 14 14 14 14 14 14 14 14 14 14 14 14 14 14 14 14 14 14 14 14 14 14 14
