0 0 0 0 0 0 13 0 0 0 0 0 0
0 0 0 0 0 0 13 13 0 0 0 0 0
0 0 0 0 0 0 13 13 13 0 0 0 0
0 0 0 17 17 17 13 13 13 13 0 0 0
0 0 17 17 17 17 13 13 13 13 0 0 0
0 17 17 17 17 17 13 13 13 13 0 0 0
17 17 17 17 17 17 14 19 19 19 19 19 19
0 0 0 1 1 1 1 19 19 19 19 19 0
0 0 0 1 1 1 1 19 19 19 19 0 0
0 0 0 1 1 1 1 19 19 19 0 0 0
0 0 0 0 1 1 1 0 0 0 0 0 0
0 0 0 0 0 1 1 0 0 0 0 0 0
0 0 0 0 0 0 1 0 0 0 0 0 0
---
0 0 0 0 0 0 19 0 0 0 0 0 0
0 0 0 0 0 0 19 19 0 0 0 0 0
0 0 0 0 0 0 19 19 19 0 0 0 0
0 0 0 13 13 13 19 19 19 19 0 0 0
0 0 13 13 13 13 19 19 19 19 0 0 0
0 13 13 13 13 13 19 19 19 19 0 0 0
13 13 13 13 13 13 14 1 1 1 1 1 1
0 0 0 17 17 17 17 1 1 1 1 1 0
0 0 0 17 17 17 17 1 1 1 1 0 0
0 0 0 17 17 17 17 1 1 1 0 0 0
0 0 0 0 17 17 17 0 0 0 0 0 0
0 0 0 0 0 17 17 0 0 0 0 0 0
0 0 0 0 0 0 17 0 0 0 0 0 0
