0 0 0 0 0 0 0 0 18 18 18 0 0 0 0 0 0 0 0 0
0 0 0 0 0 0 0 18 13 13 13 18 18 0 0 0 0 0 0 0
0 0 0 0 0 0 0 0 18 13 13 13 13 18 18 0 0 0 0 0
0 0 0 0 0 0 0 0 0 18 13 13 13 13 13 18 0 0 0 0
0 0 0 0 0 0 0 0 0 0 18 13 14 14 14 15 18 0 0 0
0 0 0 0 0 0 0 0 0 18 13 14 14 18 14 15 15 18 0 0
0 0 0 0 0 0 0 0 18 13 13 14 14 18 14 15 15 18 0 0
0 0 0 0 0 0 0 0 18 13 13 13 14 14 14 15 15 18 0 0
0 0 0 0 0 0 0 0 18 13 13 13 13 14 14 13 18 18 0 0
0 0 0 0 0 0 18 18 13 13 13 13 13 13 13 13 18 0 0 0
0 0 0 0 0 18 13 13 13 13 13 13 13 13 13 13 18 0 0 0
0 0 0 0 0 18 13 13 13 13 13 13 13 13 15 15 18 0 0 0
0 0 0 0 18 13 13 13 13 13 13 15 13 15 15 1 18 0 0 0
0 0 0 0 18 13 13 13 13 15 15 15 15 1 1 18 0 0 0 0
0 0 0 0 18 13 15 15 15 1 1 1 1 1 1 18 0 0 0 0
18 18 18 18 18 18 13 13 13 1 1 1 1 1 18 18 18 18 18 18
2 2 2 2 2 2 18 18 1 1 1 1 1 18 2 2 2 2 2 2
2 2 2 2 2 2 2 2 18 18 18 18 18 2 2 2 2 2 2 2
18 18 18 18 18 18 18 18 18 18 18 18 18 18 18 18 18 18 18 18
