1 1 1 1 1 1 1 1
1 1 18 18 18 18 1 1
1 18 14 18 18 14 18 1
1 18 4 14 14 4 18 1
1 18 14 9 9 14 18 1
1 18 14 14 14 14 18 1
18 18 14 14 14 14 18 18
1 18 14 14 14 14 18 1
1 18 14 14 14 14 18 1
1 1 18 18 18 18 1 1
1 9 9 1 1 9 9 1
---
1 1 1 1 1 1 1 1
1 1 14 14 14 14 1 1
1 14 18 14 14 18 14 1
1 14 4 18 18 4 14 1
1 14 18 9 9 18 14 1
1 14 18 18 18 18 14 1
14 14 18 18 18 18 14 14
1 14 18 18 18 18 14 1
1 14 18 18 18 18 14 1
1 1 9 9 9 9 1 1
1 18 18 1 1 18 18 1
