0 0 0 0 0 0 17 17 17 17 0 0 0 0 0 0
0 0 0 0 0 17 6 6 6 17 17 0 0 0 0 0
0 0 0 0 17 6 6 6 6 6 17 17 0 0 0 0
0 0 0 17 6 6 8 8 8 8 6 17 17 0 0 0
0 0 0 17 6 8 8 8 8 8 6 17 17 0 0 0
0 0 0 17 6 8 8 8 8 8 6 17 17 0 0 0
0 0 17 6 6 8 8 8 8 8 8 6 17 17 0 0
0 0 17 6 8 8 8 8 8 8 8 6 17 17 0 0
0 17 6 6 8 8 8 8 8 8 8 8 6 17 17 0
0 17 6 8 8 9 9 8 9 16 8 8 6 17 17 0
17 6 6 8 9 14 9 9 9 16 16 8 8 6 17 17
17 6 8 8 9 9 9 9 9 16 16 8 8 6 17 17
17 6 8 8 9 9 9 9 9 16 16 8 8 6 17 17
17 6 8 8 8 9 9 9 16 16 8 8 8 6 17 17
17 6 6 8 8 8 16 16 16 8 8 8 6 6 17 17
17 6 6 6 8 8 8 16 8 8 8 6 6 6 17 17
0 17 6 6 6 8 8 8 8 8 6 6 6 17 17 0
0 0 17 17 6 6 6 6 6 6 6 17 17 17 0 0
0 0 0 0 17 17 17 17 17 17 17 17 0 0 0 0
