17 17 17 17 17 17 17 17 17 17 17 17 17 17 17 17 17 17 17 17 17 17 17 17 17 17 17 17 17 17
17 17 5 5 17 17 17 17 17 17 17 17 17 17 17 17 17 17 17 17 17 17 17 5 5 5 5 5 17 17
17 17 5 5 5 5 5 5 5 5 5 5 17 17 17 17 17 17 17 17 17 5 5 5 5 5 5 5 17 17
17 17 5 5 5 14 14 14 14 5 5 5 17 17 5 5 5 5 5 5 5 5 14 14 14 14 5 5 17 17
17 17 5 5 14 14 16 16 14 14 5 5 5 5 5 5 5 5 5 5 5 14 14 16 16 14 14 5 5 17
17 5 5 14 14 16 15 15 16 14 14 14 14 14 14 14 14 14 14 14 14 14 16 15 15 16 14 14 5 17
17 5 5 14 16 15 15 15 15 16 14 14 16 16 16 16 16 16 16 14 14 16 15 15 15 15 16 14 5 17
17 5 5 14 16 15 15 15 15 15 16 16 15 15 16 16 16 15 15 16 16 15 15 15 15 15 16 14 5 17
17 17 5 14 16 15 9 15 15 15 15 15 15 16 16 16 16 16 15 15 15 15 15 9 9 15 16 14 5 17
17 5 5 14 14 16 9 9 9 15 15 16 16 15 15 16 15 15 16 16 9 15 15 9 9 16 14 14 5 17
17 17 5 5 14 14 16 9 9 9 15 9 9 15 16 16 16 15 15 9 9 15 15 9 16 14 14 5 5 17
17 17 5 5 14 14 16 9 16 9 16 16 9 16 15 16 15 16 15 16 16 9 16 9 16 14 14 5 5 17
17 17 5 14 14 16 9 16 9 9 15 9 9 9 9 16 15 15 9 9 9 9 9 16 9 16 14 14 5 17
17 17 14 14 16 9 9 16 9 9 9 9 9 9 16 9 16 9 9 9 9 9 9 16 9 9 16 14 14 17
17 17 14 16 9 16 9 9 9 9 9 9 9 9 9 9 9 9 9 9 9 9 9 9 9 16 9 16 14 17
17 17 14 16 9 16 9 16 9 9 9 9 9 9 9 9 9 9 9 9 9 9 2 16 9 16 9 16 14 17
17 17 14 16 9 16 9 16 9 9 9 9 9 9 9 9 9 9 9 9 9 9 2 16 9 16 9 16 14 17
17 17 14 16 9 16 9 9 16 9 9 9 9 9 9 9 9 9 9 9 9 9 16 2 9 16 9 16 14 17
17 17 14 16 2 9 9 2 2 16 16 9 9 9 9 2 9 9 9 9 16 16 2 2 9 9 9 16 14 17
17 17 14 14 16 2 16 2 2 9 9 2 2 9 9 2 2 9 9 9 9 9 2 2 16 9 16 14 14 17
17 17 5 14 16 2 2 16 2 9 9 2 2 9 9 2 2 9 9 9 9 9 2 16 2 2 16 14 5 17
17 17 5 14 14 16 2 2 16 16 2 2 2 9 9 2 2 9 2 9 9 16 16 2 2 16 14 14 5 17
17 17 5 5 14 14 16 16 2 2 2 2 2 2 2 2 2 2 2 9 2 2 2 16 16 14 14 5 17 17
17 5 5 5 5 14 14 14 16 16 16 2 2 2 2 2 2 2 2 2 16 16 16 14 14 14 5 5 17 17
17 17 5 5 5 5 5 14 14 14 14 16 2 2 2 2 2 2 2 16 14 14 14 14 5 5 5 5 17 17
17 17 5 5 5 5 5 5 5 5 14 14 16 2 2 2 2 2 16 14 14 5 5 5 5 5 5 5 17 17
17 17 5 17 17 5 5 5 17 5 5 14 14 16 16 16 16 16 14 14 5 5 5 17 17 17 17 5 17 17
17 17 17 17 17 5 5 5 17 17 5 5 14 14 14 14 14 14 14 5 5 5 5 17 17 17 17 17 17 17
17 17 17 17 17 17 17 5 17 17 5 5 5 5 17 17 5 5 17 17 17 17 17 17 17 17 17 17 17 17
17 17 17 17 17 17 17 17 17 17 17 17 17 17 17 17 17 17 17 17 17 17 17 17 17 17 17 17 17 17
---
17 17 17 17 17 17 17 17 17 17 17 17 17 17 17 17 17 17 17 17 17 17 17 17 17 17 17 17 17 17
17 17 16 16 17 17 17 17 17 17 17 17 17 17 17 17 17 17 17 17 17 17 17 16 16 16 16 16 17 17
17 17 16 16 16 16 16 16 16 16 16 16 17 17 17 17 17 17 17 17 17 16 16 16 16 16 16 16 17 17
17 17 16 16 16 9 9 9 9 16 16 16 17 17 16 16 16 16 16 16 16 16 9 9 9 9 16 16 17 17
17 17 16 16 9 9 14 14 9 9 16 16 16 16 16 16 16 16 16 16 16 9 9 14 14 9 9 16 16 17
17 16 16 9 9 14 14 14 14 9 9 9 9 9 9 9 9 9 9 9 9 9 14 14 14 14 9 9 16 17
17 16 16 9 14 14 14 14 14 14 9 9 14 14 14 14 14 14 14 9 9 14 14 14 14 14 14 9 16 17
17 16 16 9 14 14 14 14 14 14 14 14 14 14 14 14 14 14 14 14 14 14 14 14 14 14 14 9 16 17
17 17 16 9 5 14 16 14 14 14 14 14 14 14 14 14 14 14 14 14 14 14 14 16 16 14 5 9 16 17
17 16 16 9 9 5 16 16 16 14 14 14 14 14 14 14 14 14 14 14 16 14 14 16 16 5 9 9 16 17
17 17 16 16 9 9 5 16 16 16 14 16 16 14 14 14 14 14 14 16 16 14 14 16 5 9 9 16 16 17
17 17 16 16 9 9 5 16 5 16 15 15 16 14 14 14 14 14 14 15 15 16 5 16 5 9 9 16 16 17
17 17 16 9 9 5 16 5 16 16 16 16 16 16 16 14 14 14 16 16 16 16 16 5 16 5 9 9 16 17
17 17 9 9 5 15 16 5 16 16 16 16 16 16 14 16 14 16 16 16 16 16 16 5 16 15 5 9 9 17
17 17 9 5 15 5 15 15 15 15 15 15 15 15 15 15 15 15 15 15 15 15 15 15 15 5 15 5 9 17
17 17 9 5 15 5 15 14 2 2 2 2 2 2 2 2 2 2 2 2 2 2 5 14 15 5 15 5 9 17
17 17 9 5 15 5 15 14 2 2 2 2 2 2 2 2 2 2 2 2 2 2 5 14 15 5 15 5 9 17
17 17 9 5 15 5 15 15 14 2 2 2 2 2 2 2 2 2 2 2 2 2 14 5 15 5 15 5 9 17
17 17 9 5 5 15 15 5 5 14 14 2 2 2 2 5 2 2 2 2 14 14 5 5 15 15 15 5 9 17
17 17 9 9 5 5 5 5 5 2 2 5 5 2 2 5 5 2 2 2 2 2 5 5 5 15 5 9 9 17
17 17 15 9 5 5 5 5 5 2 2 5 5 2 2 5 5 2 2 2 2 2 5 5 5 5 5 9 9 17
17 17 15 9 9 5 5 5 5 5 5 5 5 2 2 5 5 2 5 2 2 5 5 5 5 5 9 9 9 17
17 17 15 15 9 9 5 5 5 5 5 5 5 5 5 5 5 5 5 2 5 5 5 5 5 9 9 9 17 17
17 15 15 15 15 9 9 9 5 5 5 5 5 5 5 5 5 5 5 5 5 5 5 9 9 9 9 9 17 17
17 17 15 15 9 9 9 9 9 9 9 5 5 5 5 5 5 5 5 5 9 9 9 9 9 9 9 9 17 17
17 17 15 15 9 9 9 9 9 9 9 9 5 5 5 5 5 5 5 9 9 9 9 9 9 9 9 9 17 17
17 17 15 17 17 9 9 9 17 9 9 9 9 5 5 5 5 5 9 9 9 9 9 17 17 17 17 9 17 17
17 17 17 17 17 9 9 9 17 17 9 9 9 9 9 14 9 9 9 9 9 9 9 17 17 17 17 17 17 17
17 17 17 17 17 17 17 9 17 17 9 9 9 9 17 17 9 9 17 17 17 17 17 17 17 17 17 17 17 17
17 17 17 17 17 17 17 17 17 17 17 17 17 17 17 17 17 17 17 17 17 17 17 17 17 17 17 17 17 17
