0 0 0 18 18 18 0 0 0 0 18 18 18 0 0 0
0 0 18 13 13 13 18 0 0 18 19 19 19 18 0 0
0 18 13 13 13 9 9 18 18 19 19 19 19 17 18 0
18 13 13 13 8 9 9 19 19 19 19 19 17 17 17 18
18 13 13 8 8 8 19 19 19 19 19 17 17 17 17 18
18 13 9 9 8 19 19 19 19 19 17 17 17 17 1 18
18 9 9 9 19 19 19 19 19 17 17 17 17 1 1 18
0 18 9 9 19 19 19 19 17 17 17 17 1 1 18 0
0 18 19 19 19 19 19 17 17 17 17 1 1 1 18 0
0 0 18 19 19 19 17 17 17 17 1 1 1 18 0 0
0 0 0 18 19 17 17 17 17 1 1 1 18 0 0 0
0 0 0 0 18 17 17 17 1 1 1 18 0 0 0 0
0 0 0 0 0 18 17 1 1 1 18 0 0 0 0 0
0 0 0 0 0 0 18 1 1 18 0 0 0 0 0 0
0 0 0 0 0 0 0 18 18 0 0 0 0 0 0 0
