6 6 6 6 6 6 6 6 6 6 6 6 6 6 6 6 6 6 6 6 6 6 6 6 6 4 6 6 6 6
6 6 6 6 6 6 6 6 6 6 6 6 6 6 6 6 4 6 6 4 7 7 7 7 7 7 7 7 7 15
6 6 6 4 6 6 6 6 6 6 6 6 6 6 6 6 7 7 4 14 4 7 7 7 7 4 7 7 7 15
6 6 4 14 4 6 6 6 6 6 7 7 7 7 7 7 7 7 7 4 7 7 4 7 4 14 4 7 4 15
6 6 6 4 6 6 7 7 7 7 7 7 7 7 7 7 7 7 7 7 7 7 7 7 7 4 7 1 1 15
6 6 6 4 6 7 7 4 4 4 4 4 7 7 7 7 7 7 4 4 4 4 4 7 7 4 7 1 1 15
6 6 6 6 7 4 4 14 14 14 14 14 4 7 7 7 7 4 14 14 14 14 14 4 4 7 1 1 1 15
6 6 6 7 4 14 14 14 14 14 14 14 14 4 7 7 4 14 14 14 14 14 14 14 14 4 1 1 1 15
6 6 6 7 4 14 14 6 6 6 6 6 14 14 4 4 14 14 7 7 7 7 7 14 14 4 1 1 1 15
6 6 6 4 14 14 6 6 6 6 6 7 7 14 14 14 14 7 14 14 14 14 7 7 14 14 4 1 1 15
6 6 6 4 14 6 6 6 7 7 7 7 7 7 14 14 7 7 14 14 14 14 14 1 1 14 4 1 1 15
6 6 4 14 14 6 14 14 14 7 7 7 7 7 7 7 7 7 7 14 14 14 14 1 1 14 14 4 1 15
6 6 4 14 14 6 14 14 14 7 7 7 7 7 7 7 7 7 7 7 14 14 14 1 1 14 14 4 1 15
6 6 4 14 14 6 14 14 14 7 7 7 7 7 7 7 7 1 1 1 1 14 14 1 15 14 14 4 1 15
6 6 4 14 14 6 7 7 7 7 7 7 7 7 7 7 7 1 1 1 1 1 1 15 15 14 14 4 1 15
6 6 4 14 14 7 7 7 7 7 7 7 7 7 1 1 1 1 1 1 1 1 1 15 15 14 14 4 15 15
6 6 7 4 14 14 7 7 14 14 14 7 7 7 1 1 1 1 1 1 1 1 1 15 14 14 4 1 15 15
6 6 7 4 14 14 7 7 14 14 14 14 14 1 1 1 1 1 1 1 1 1 15 15 14 14 4 1 15 15
6 6 7 7 4 14 14 7 14 14 14 14 14 1 1 1 1 1 1 1 1 15 15 14 14 4 1 15 15 15
6 6 7 7 4 14 14 7 7 14 14 14 14 14 14 1 1 1 1 1 15 15 15 14 14 4 1 15 15 15
6 6 7 7 7 4 14 14 1 14 14 14 14 14 14 1 1 1 1 15 15 15 14 14 4 1 1 15 15 15
6 6 7 7 7 7 4 14 14 1 1 1 14 14 14 1 1 15 15 15 15 14 14 4 1 1 1 15 15 15
6 6 7 7 4 7 7 4 14 14 14 1 1 15 15 15 15 15 15 14 14 14 4 1 1 1 1 15 15 15
6 6 7 7 7 7 7 7 4 4 14 14 14 1 15 15 15 14 14 14 4 4 1 1 1 1 15 15 15 15
6 7 7 7 4 7 7 7 1 1 4 4 14 14 14 14 14 14 4 4 1 1 1 1 4 15 15 15 15 15
6 4 7 4 14 4 7 4 1 1 1 1 4 4 14 14 4 4 1 1 1 4 1 4 14 4 15 15 15 15
6 7 7 7 4 7 1 1 1 4 1 1 1 1 4 4 1 1 1 1 1 1 1 15 4 15 15 15 15 15
6 7 7 7 4 1 1 1 4 14 4 1 1 1 1 1 1 1 1 1 15 15 15 15 4 15 15 4 15 15
6 7 7 1 1 1 1 1 1 4 15 15 15 15 15 15 15 15 15 15 15 15 15 15 15 15 15 15 15 15
6 15 15 15 4 15 15 15 15 15 15 15 15 15 15 15 15 15 15 15 15 15 15 15 15 15 15 15 15 15
---
7 7 7 7 7 7 7 7 7 7 7 7 7 7 7 7 7 7 7 7 7 7 7 7 7 14 14 14 14 14
7 7 7 7 7 7 7 7 7 7 7 7 7 7 7 7 1 7 7 1 1 1 1 1 1 1 1 1 1 14
7 7 7 1 7 7 7 7 7 7 7 7 7 7 7 7 1 1 1 1 1 1 1 1 1 15 1 1 1 14
7 7 1 1 1 7 7 7 7 7 1 1 1 1 1 1 1 1 1 1 1 1 1 1 15 14 15 1 14 14
7 7 7 1 7 7 1 1 1 1 1 1 1 1 1 1 1 1 1 1 1 1 1 1 1 15 1 14 14 14
7 7 7 1 7 1 1 15 15 15 15 15 1 1 1 1 1 1 15 15 15 15 15 1 1 15 1 14 14 14
7 7 7 7 1 15 15 1 1 1 1 1 15 1 1 1 1 15 15 15 15 15 15 15 15 1 14 14 14 14
7 7 7 1 15 1 1 1 1 1 1 1 1 15 1 1 15 15 15 15 15 15 15 15 15 15 14 14 14 14
7 7 7 1 15 1 1 4 4 4 4 4 1 1 15 15 15 15 4 4 4 4 4 15 15 15 14 14 14 14
7 7 7 15 6 6 4 4 4 4 4 4 4 1 1 15 15 4 6 6 6 6 4 4 15 15 15 14 14 14
7 7 7 15 6 4 4 4 4 4 4 4 4 4 1 15 4 4 6 6 6 6 6 6 6 15 15 14 14 14
7 7 15 6 6 4 4 4 4 4 4 4 4 4 4 4 4 4 4 6 6 6 6 6 6 15 15 15 14 14
7 7 15 6 6 4 4 4 4 4 4 4 4 4 4 4 4 4 4 4 6 6 6 6 6 15 15 15 14 14
7 7 15 6 6 4 4 4 4 4 4 4 4 4 4 4 4 6 6 6 6 6 6 6 14 15 15 15 14 14
7 7 15 6 6 4 4 4 4 4 4 4 4 4 4 4 4 6 6 6 6 6 6 14 14 15 15 15 14 14
7 7 15 6 6 4 4 4 4 4 4 4 4 4 6 6 6 6 6 6 6 6 6 14 14 15 6 15 14 14
7 7 1 15 6 6 4 4 6 6 6 4 4 4 6 6 6 6 6 6 6 6 6 14 15 15 15 7 14 14
7 7 1 15 6 6 4 4 6 6 6 6 6 6 6 6 6 6 6 6 6 6 14 14 15 15 15 7 14 14
7 7 1 1 15 6 6 4 6 6 6 6 6 6 6 6 6 6 6 6 6 14 14 15 15 15 7 14 14 14
7 7 1 1 15 6 6 4 4 6 6 6 6 6 6 6 6 6 6 6 14 14 14 15 15 15 7 14 14 14
7 7 1 1 1 15 6 6 6 6 6 6 6 6 6 6 6 6 6 14 14 14 15 15 15 7 7 14 14 14
7 7 1 1 1 1 15 6 6 6 6 6 6 6 6 6 6 14 14 14 14 15 15 15 7 7 7 14 14 14
7 7 1 1 1 1 1 15 6 15 15 6 6 14 14 14 14 14 14 15 15 15 15 7 7 7 7 14 14 14
7 7 1 1 1 1 1 1 15 15 15 15 15 6 14 14 14 15 15 15 15 15 7 7 7 7 14 14 14 14
7 1 1 1 1 1 1 1 7 7 15 15 15 15 15 15 15 15 15 15 7 7 7 7 15 14 14 14 14 14
7 1 1 1 1 1 1 1 7 7 7 7 15 15 15 15 15 15 7 7 7 4 7 15 14 15 14 14 14 14
7 1 1 1 1 1 7 7 7 7 7 7 7 7 15 15 7 7 7 7 7 7 7 14 15 14 14 14 14 14
7 1 1 1 1 7 7 7 7 14 7 7 7 7 7 7 7 7 7 7 14 14 14 14 15 14 14 14 14 14
7 1 1 7 7 7 7 7 7 7 14 14 14 14 14 14 14 14 14 14 14 14 14 14 14 14 14 14 14 14
7 14 14 14 14 14 14 14 14 14 14 14 14 14 14 14 14 14 14 14 14 14 14 14 14 14 14 14 14 14
