6 6 6 6 6 5 5 5 5 5 6 6 14 14 14 14 14 5 5 5 6 6 6 6 6 5 5 5 5 5
6 6 6 6 6 5 5 5 5 5 6 14 14 18 18 18 14 14 5 5 6 6 6 6 6 5 5 5 5 5
6 6 6 6 6 5 5 5 5 5 14 14 18 9 9 9 18 14 14 5 6 6 6 6 6 5 5 5 5 5
6 6 6 6 6 5 5 5 5 5 14 18 9 14 9 9 13 18 14 5 6 6 6 6 14 14 14 14 5 5
6 6 6 6 6 5 5 5 5 5 14 18 13 9 9 13 13 18 14 5 6 6 6 14 14 18 18 14 14 5
5 5 5 5 5 6 6 6 6 14 14 18 18 13 13 13 18 18 14 14 5 5 5 14 18 9 2 18 14 6
5 5 5 5 5 6 6 6 14 14 18 14 14 18 18 18 7 7 18 14 14 5 14 14 18 2 9 18 14 6
5 5 5 5 5 6 6 14 14 18 14 14 14 14 14 14 14 14 7 18 14 14 14 18 9 2 18 14 14 6
5 5 5 5 5 6 6 14 18 14 14 14 14 7 7 14 14 14 7 7 18 14 14 18 2 9 18 14 6 6
5 5 5 5 5 6 6 14 18 7 14 14 7 18 18 14 14 14 7 7 18 14 18 9 2 18 14 14 6 6
6 6 6 6 6 5 14 14 18 18 14 7 18 12 12 18 14 7 7 18 18 14 18 2 9 18 14 5 5 5
6 6 6 6 6 14 14 18 10 12 18 18 12 12 12 18 7 7 18 12 12 18 9 2 18 14 14 5 5 5
6 6 6 6 6 14 18 10 10 10 12 12 12 10 10 12 18 7 18 12 12 12 18 9 18 14 5 5 5 5
6 6 6 14 14 14 18 10 14 10 10 10 10 10 10 12 18 18 12 10 10 12 18 18 14 14 5 5 5 5
6 6 14 14 18 18 10 14 10 10 10 10 10 10 10 12 12 12 10 10 10 10 12 18 18 14 14 5 5 5
5 5 14 18 14 18 10 14 10 10 10 10 10 10 10 10 12 10 10 10 10 12 12 18 14 18 14 6 6 6
5 5 14 18 18 18 12 12 12 10 10 10 10 10 10 10 10 10 10 10 12 12 12 18 18 18 14 6 6 6
5 5 14 18 14 14 18 18 18 12 12 12 12 12 12 12 12 12 12 12 18 18 18 14 14 18 14 6 6 6
5 5 14 14 18 1 1 14 14 18 18 18 18 18 18 18 18 18 18 18 14 14 14 14 18 14 14 6 6 6
5 5 5 14 14 18 1 1 1 14 14 14 14 14 14 14 14 14 1 1 1 1 14 18 14 14 6 6 6 6
6 6 6 6 14 14 18 18 1 1 1 1 1 1 1 1 1 1 1 1 14 18 18 14 14 5 5 5 5 5
6 6 6 6 6 14 14 14 18 18 18 18 14 1 1 14 14 18 18 18 18 14 14 14 6 5 5 5 5 5
6 6 6 6 6 5 5 14 14 14 14 14 18 18 1 18 18 14 14 14 14 14 6 6 6 5 5 5 5 5
6 6 6 6 6 5 5 14 14 14 18 18 18 14 14 14 18 18 18 14 14 14 6 6 6 5 5 5 5 5
6 6 6 6 6 5 14 14 18 18 1 1 18 1 1 14 18 1 14 18 18 14 14 6 6 5 5 5 5 5
5 5 5 5 5 6 14 18 1 1 1 18 14 1 1 14 14 18 1 14 14 18 14 5 5 6 6 6 6 6
5 5 5 5 5 6 14 18 1 1 1 1 1 1 1 1 1 14 1 14 14 18 14 5 5 6 6 6 6 6
5 5 5 5 5 6 14 14 18 18 14 14 14 14 14 14 14 14 14 18 18 14 14 5 5 6 6 6 6 6
5 5 5 5 5 6 6 14 14 14 18 18 18 18 18 18 18 18 18 14 14 14 5 5 5 6 6 6 6 6
5 5 5 5 5 6 6 6 6 14 14 14 14 14 14 14 14 14 14 14 5 5 5 5 5 6 6 6 6 6
---
6 6 6 6 6 5 5 5 5 5 6 6 14 14 14 14 14 5 5 5 6 6 6 6 6 5 5 5 5 5
6 6 6 6 6 5 5 5 5 5 6 14 14 18 18 18 14 14 5 5 6 6 6 6 6 5 5 5 5 5
6 6 6 6 6 5 5 5 5 5 14 14 18 10 10 10 18 14 14 5 6 6 6 6 6 5 5 5 5 5
6 6 6 6 6 5 5 5 5 5 14 18 10 10 10 10 1 18 14 5 6 6 6 6 14 14 14 14 5 5
6 6 6 6 6 5 5 5 5 5 14 18 1 10 10 1 1 18 14 5 6 6 6 14 14 18 18 14 14 5
5 5 5 5 5 6 6 6 6 14 14 18 18 1 1 1 18 18 14 14 5 5 5 14 18 1 1 18 14 6
5 5 5 5 5 6 6 6 14 14 18 9 9 18 18 18 14 14 18 14 14 5 14 14 18 1 1 18 14 6
5 5 5 5 5 6 6 14 14 18 9 9 9 9 9 9 9 12 14 18 14 14 14 18 1 1 18 14 14 6
5 5 5 5 5 6 6 14 18 9 9 9 9 12 12 12 12 12 14 14 18 14 14 18 1 1 18 14 6 6
5 5 5 5 5 6 6 14 18 7 9 9 12 18 18 12 12 12 14 14 18 14 18 1 1 18 14 14 6 6
6 6 6 6 6 5 14 14 18 18 9 12 18 10 10 18 12 14 14 18 18 14 18 1 1 18 14 5 5 5
6 6 6 6 6 14 14 18 14 10 18 18 10 10 10 18 14 14 18 10 10 18 1 1 18 14 14 5 5 5
6 6 6 6 6 14 18 14 14 14 10 10 10 12 12 10 18 14 18 10 10 10 18 1 18 14 5 5 5 5
6 6 6 14 14 14 18 14 14 14 14 14 14 7 12 10 18 18 10 13 13 10 18 18 14 14 5 5 5 5
6 6 14 14 18 18 14 14 14 14 14 14 14 7 12 10 10 10 2 13 13 13 10 18 18 14 14 5 5 5
5 5 14 18 14 18 14 14 14 14 14 14 14 7 12 12 10 2 2 13 13 10 10 18 14 18 14 6 6 6
5 5 14 18 18 18 10 10 10 14 14 14 7 7 12 12 2 2 2 2 10 10 10 18 18 18 14 6 6 6
5 5 14 18 14 14 18 18 18 10 10 10 10 10 10 10 10 10 10 10 18 18 18 14 14 18 14 6 6 6
5 5 14 14 18 1 1 7 7 18 18 18 18 18 18 18 18 18 18 18 14 14 14 14 18 14 14 6 6 6
5 5 5 14 14 18 12 12 12 7 7 7 7 7 7 7 7 7 12 12 12 12 14 18 14 14 6 6 6 6
6 6 6 6 14 14 18 18 12 12 12 12 12 12 12 12 12 12 12 12 14 18 18 14 14 5 5 5 5 5
6 6 6 6 6 14 14 14 18 18 18 18 14 12 12 14 14 18 18 18 18 14 14 14 6 5 5 5 5 5
6 6 6 6 6 5 5 14 14 14 14 14 18 18 12 18 18 14 14 14 14 14 6 6 6 5 5 5 5 5
6 6 6 6 6 5 5 14 14 14 18 18 18 14 14 14 18 18 18 14 14 14 6 6 6 5 5 5 5 5
6 6 6 6 6 5 14 14 18 18 1 1 18 1 1 14 18 1 14 18 18 14 14 6 6 5 5 5 5 5
5 5 5 5 5 6 14 18 1 1 1 18 14 1 1 14 14 18 1 14 14 18 14 5 5 6 6 6 6 6
5 5 5 5 5 6 14 18 1 1 1 1 1 1 1 1 1 14 1 14 14 18 14 5 5 6 6 6 6 6
5 5 5 5 5 6 14 14 18 18 14 14 14 14 14 14 14 14 14 18 18 14 14 5 5 6 6 6 6 6
5 5 5 5 5 6 6 14 14 14 18 18 18 18 18 18 18 18 18 14 14 14 5 5 5 6 6 6 6 6
5 5 5 5 5 6 6 6 6 14 14 14 14 14 14 14 14 14 14 14 5 5 5 5 5 6 6 6 6 6
