0 0 0 0 0 0 18 18 18 18 0 0 0 0 0 0
0 0 0 0 18 18 4 4 4 4 18 18 0 0 0 0
0 0 0 18 4 4 4 4 4 4 4 4 18 0 0 0
0 0 18 4 4 1 1 1 1 1 1 1 4 18 0 0
0 0 18 4 1 1 1 1 1 1 1 1 4 18 0 0
0 18 4 1 1 1 1 1 1 1 1 1 4 4 18 0
0 18 4 1 1 14 18 1 1 18 14 1 1 4 18 0
0 18 4 1 1 18 18 1 1 18 18 1 1 4 18 0
0 18 4 1 1 1 19 19 19 19 1 1 1 4 18 0
18 4 4 1 1 1 1 19 19 1 1 1 1 4 4 18
18 4 4 1 1 14 14 14 14 14 14 1 1 4 4 18
18 4 18 1 14 14 14 14 14 14 14 14 1 18 4 18
0 18 18 14 14 14 14 14 14 14 14 14 14 18 18 0
0 0 18 14 14 14 14 14 14 14 14 14 14 18 0 0
0 0 18 19 19 19 18 18 18 18 19 19 19 18 0 0
0 0 0 18 18 18 0 0 0 0 18 18 18 0 0 0
