12 12 12 12 12 14 14 14 14 14 12 12 12 12 12 12 12 12 12 12 14 14 14 14 14 12 12 12 12 12
12 12 12 12 14 14 18 18 18 14 14 14 14 14 14 14 14 14 14 14 14 18 18 18 14 14 12 12 12 12
12 12 12 14 14 18 7 7 7 18 14 14 18 18 18 18 18 18 14 14 18 7 7 7 18 14 14 12 12 12
12 12 12 14 18 7 7 7 7 18 18 18 3 3 3 3 3 3 18 18 18 7 7 7 7 18 14 12 12 12
12 12 12 14 18 8 8 18 18 3 3 3 3 3 3 3 3 3 3 3 3 18 18 8 8 18 14 12 12 12
12 12 12 14 18 8 18 3 3 3 3 3 3 3 3 3 3 3 3 3 3 3 3 18 8 18 14 12 12 12
12 12 12 14 14 18 1 1 1 1 1 18 18 18 18 18 18 18 18 1 1 1 1 1 18 14 14 12 12 12
12 12 12 14 14 18 1 1 1 18 18 8 8 8 8 8 8 8 8 18 18 1 1 1 18 14 14 12 12 12
12 12 12 14 18 1 1 1 18 7 7 7 7 18 7 7 7 7 7 7 7 18 1 1 1 18 14 12 12 12
12 12 14 14 18 1 1 18 9 9 9 9 18 9 9 9 9 9 9 9 9 9 18 1 1 18 14 14 12 12
12 12 14 18 1 1 1 18 9 18 9 18 18 9 3 9 9 18 18 3 18 9 18 1 1 1 18 14 12 12
12 14 14 18 1 1 18 3 3 18 18 14 18 3 3 3 3 18 14 18 18 3 3 18 1 1 18 14 14 12
12 14 18 18 6 6 18 3 3 18 14 14 14 18 3 3 18 14 14 14 18 3 3 18 6 6 18 18 14 12
14 14 18 18 6 6 18 7 18 14 14 14 14 14 18 18 14 14 14 14 14 18 7 18 6 6 18 18 14 14
14 18 7 18 6 18 7 7 18 14 14 14 14 14 14 14 14 14 14 14 14 18 7 18 6 6 18 7 18 14
14 18 8 18 6 6 18 7 18 14 14 14 14 14 14 14 14 14 14 14 14 18 7 7 18 6 18 8 18 14
18 8 8 18 6 6 18 8 18 14 14 14 14 14 14 14 14 14 14 14 14 18 8 18 6 6 18 8 8 18
18 8 9 8 18 15 18 8 18 14 14 14 14 14 14 14 14 14 14 14 14 18 8 18 15 18 8 9 8 18
18 9 9 9 18 15 15 18 9 18 14 14 14 14 14 14 14 14 14 14 18 9 18 15 15 18 9 9 9 18
18 9 9 9 9 18 15 15 18 18 18 14 14 14 14 14 14 14 14 18 18 18 15 15 18 9 9 9 9 18
18 7 7 7 7 7 18 18 15 15 15 18 18 18 18 18 18 18 18 14 14 18 18 18 7 7 7 7 7 18
18 7 7 3 3 7 18 14 18 18 18 18 15 15 15 15 15 15 18 14 14 18 14 18 7 3 7 7 7 18
18 3 3 3 3 3 18 14 14 18 14 18 15 15 15 15 15 15 15 18 18 14 14 18 3 3 3 3 3 18
18 8 8 8 3 8 18 14 18 18 14 18 7 7 7 7 7 7 7 18 18 18 14 18 8 8 3 8 8 18
14 18 8 8 8 18 14 18 7 18 14 14 18 7 7 7 7 7 18 7 7 7 18 14 18 8 8 8 18 14
14 14 18 18 18 14 18 10 10 10 18 14 14 18 10 10 10 18 10 10 10 10 10 18 14 18 18 18 14 14
12 14 14 14 14 14 18 10 10 10 18 14 14 18 10 10 10 18 10 10 10 10 10 18 14 14 14 14 14 12
12 12 12 12 12 14 14 18 10 10 10 18 18 18 18 18 18 18 18 10 10 10 18 14 14 12 12 12 12 12
12 12 12 12 12 12 14 14 18 18 18 14 14 14 14 14 14 14 14 18 18 18 14 14 12 12 12 12 12 12
12 12 12 12 12 12 12 14 14 14 14 14 12 12 12 12 12 12 14 14 14 14 14 12 12 12 12 12 12 12
---
12 12 12 12 12 14 14 14 14 14 12 12 12 12 12 12 12 12 12 12 14 14 14 14 14 1 1 1 1 1
12 12 12 12 14 14 18 18 18 14 14 14 14 14 14 14 14 14 14 14 14 18 18 18 14 14 1 1 1 1
12 12 12 14 14 18 7 7 7 18 14 14 18 18 18 18 18 18 14 14 18 7 7 7 18 14 14 1 1 1
12 12 12 14 18 7 7 7 7 18 18 18 3 3 3 3 3 3 18 18 18 7 7 7 7 18 14 1 1 1
12 12 12 14 18 8 8 18 18 3 3 3 3 3 3 3 3 3 3 3 3 18 18 8 8 18 14 1 1 1
12 12 12 14 18 8 18 3 3 3 3 3 3 3 3 3 3 3 3 3 3 3 3 18 8 18 14 1 1 1
12 12 12 14 14 18 12 12 12 12 12 18 18 18 18 18 18 18 18 12 12 12 12 12 18 14 14 1 1 1
12 12 12 14 14 18 12 12 12 18 18 8 8 8 8 8 8 8 8 18 18 12 12 12 18 14 14 1 1 1
12 12 12 14 18 12 12 12 18 7 7 7 7 18 7 7 7 7 7 7 7 18 12 12 12 18 14 1 1 1
12 12 14 14 18 12 12 18 9 9 9 9 18 9 9 9 9 9 9 9 9 9 18 12 12 18 14 14 1 1
12 12 14 18 12 12 12 18 9 18 9 18 18 9 14 9 9 18 18 14 18 9 18 12 12 12 18 14 1 1
12 14 14 18 12 12 18 3 3 18 18 9 18 14 14 14 14 18 3 18 18 14 14 18 12 12 18 14 14 1
12 14 18 18 6 6 18 3 3 18 9 9 9 18 14 14 18 3 3 3 18 14 14 18 6 6 18 18 14 1
14 14 18 18 6 6 18 7 18 9 9 9 9 9 18 18 3 3 3 3 3 18 7 18 6 6 18 18 14 14
14 18 7 18 6 18 7 7 18 7 7 7 7 7 7 7 7 7 3 3 3 18 7 18 6 6 18 7 18 14
14 18 8 18 6 6 18 7 18 7 7 7 7 7 7 7 7 7 7 7 7 18 7 7 18 6 18 8 18 14
18 8 8 18 6 6 18 14 18 7 7 7 7 7 7 7 7 7 7 7 7 18 8 18 6 6 18 8 8 18
18 8 14 8 18 14 18 14 18 8 8 8 8 8 8 8 8 8 8 8 8 18 8 18 14 18 8 14 8 18
18 14 14 14 18 14 14 18 14 18 8 8 8 3 3 3 3 3 3 3 18 14 18 14 14 18 14 14 14 18
18 14 14 14 14 18 14 14 18 18 18 3 3 3 3 3 3 3 3 18 18 18 14 14 18 14 14 14 14 18
18 15 15 15 15 15 18 18 15 15 15 18 18 18 18 18 18 18 18 14 14 18 18 18 9 9 9 9 9 18
18 15 15 10 10 15 18 14 18 18 18 18 14 14 14 14 14 14 18 14 14 18 14 18 9 10 9 9 9 18
18 10 10 10 10 10 18 14 14 18 14 18 14 14 14 14 14 14 14 18 18 14 14 18 10 10 10 10 10 18
18 10 10 10 10 8 18 14 18 18 14 18 15 15 15 15 15 15 15 18 18 18 14 18 10 10 10 10 10 18
14 18 10 10 10 18 14 18 14 18 14 14 18 15 15 15 15 15 18 15 15 15 18 14 18 10 10 10 18 14
14 14 18 18 18 14 18 14 14 14 18 14 14 18 14 14 14 18 14 14 14 14 14 18 14 18 18 18 14 14
12 14 14 14 14 14 18 14 14 14 18 14 14 18 14 14 14 18 14 14 14 14 14 18 14 14 14 14 14 12
12 12 12 12 12 14 14 18 14 14 14 18 18 18 18 18 18 18 18 14 14 14 18 14 14 12 12 12 12 12
12 12 12 12 12 12 14 14 18 18 18 14 14 14 14 14 14 14 14 18 18 18 14 14 12 12 12 12 12 12
12 12 12 12 12 12 12 14 14 14 14 14 12 12 12 12 12 12 14 14 14 14 14 12 12 12 12 12 12 12
