11 11 11 11 11 11 11 11 11 11 11 11 11 11 11 11 11 11 11 11 11 11 11 11 11 11 11 11 11 11
11 11 11 11 11 11 11 11 11 11 11 11 11 10 11 11 9 11 11 11 11 11 11 11 11 11 11 11 11 11
11 11 11 11 14 14 14 14 14 14 11 11 10 14 10 11 11 11 11 11 14 14 14 14 14 14 11 11 11 11
11 11 11 14 14 18 18 18 18 14 14 14 14 10 14 14 14 14 14 14 14 18 18 18 18 14 14 11 11 11
11 11 14 14 18 3 3 3 3 18 14 14 18 10 18 18 18 18 14 14 18 3 3 3 3 18 14 14 11 11
11 11 14 18 3 3 3 3 3 3 18 18 3 3 3 3 3 3 18 18 3 3 3 3 3 3 18 14 11 11
11 11 14 18 3 3 3 3 3 3 3 3 3 3 3 3 3 3 3 3 3 3 3 3 3 3 18 14 11 11
11 11 14 18 3 3 3 3 3 3 3 3 1 1 1 1 1 1 3 3 3 3 3 3 3 3 18 14 11 11
11 11 14 18 3 3 3 3 3 3 1 1 1 1 1 1 1 1 1 1 3 3 3 3 3 3 18 14 11 11
11 11 14 14 18 18 3 3 1 1 1 1 1 1 1 1 1 1 1 1 1 1 3 3 18 18 14 14 11 11
11 11 9 14 14 14 18 1 1 1 1 1 1 1 1 1 1 1 1 1 1 1 1 18 14 14 14 11 11 11
11 11 11 11 14 18 1 1 1 1 1 1 1 1 1 1 1 1 1 1 1 1 1 1 18 14 11 9 11 11
11 11 9 14 14 18 1 1 1 1 1 1 6 6 6 6 6 6 1 1 1 1 1 1 18 14 9 14 9 9
11 9 8 10 18 1 1 1 1 1 6 6 6 6 6 6 6 6 6 6 1 1 1 1 1 18 14 9 11 11
9 8 9 14 10 1 1 1 6 6 6 6 6 6 6 6 6 6 6 6 6 6 1 1 1 18 14 9 11 11
11 9 8 10 18 1 1 6 6 6 6 6 6 6 15 15 6 6 6 6 6 6 6 1 1 18 14 11 11 11
11 11 9 14 14 18 1 6 6 6 6 15 15 15 15 15 15 15 15 6 6 6 6 1 18 14 14 11 11 11
11 11 11 11 14 14 18 18 6 15 15 15 15 15 15 15 15 15 15 15 15 6 18 18 14 14 11 11 11 11
11 11 9 11 11 14 14 14 18 15 15 15 15 7 7 7 7 15 15 15 15 18 14 14 14 11 11 11 11 11
11 11 11 11 11 14 14 18 15 15 7 7 7 7 7 7 7 7 7 7 15 15 18 14 14 11 11 10 11 11
11 11 11 11 11 14 18 15 7 7 7 7 7 7 10 10 7 7 7 7 7 7 15 18 14 11 11 11 11 11
11 11 11 11 11 14 18 7 7 7 18 7 10 10 10 10 10 10 7 18 7 7 7 18 14 11 11 10 11 11
11 11 11 11 11 14 14 18 18 18 7 10 10 10 10 10 10 10 10 7 18 18 18 14 14 11 10 14 10 11
11 11 11 10 11 11 14 14 14 18 10 10 10 10 10 10 10 10 10 10 18 14 14 10 11 10 14 10 14 10
11 10 10 14 10 11 11 11 14 18 10 10 10 18 18 18 18 10 10 10 18 14 11 11 11 11 10 14 10 11
11 11 11 10 11 11 11 11 14 18 10 10 10 18 14 14 18 10 10 10 18 14 11 11 11 11 11 10 11 11
11 11 11 10 11 11 9 11 14 14 18 18 18 14 14 14 14 18 18 18 14 14 11 11 11 11 11 11 11 11
11 11 11 10 11 11 11 11 11 14 14 14 14 14 11 11 14 14 14 14 14 11 11 9 11 11 11 10 11 11
11 11 11 11 11 11 11 11 11 11 11 11 11 11 11 11 11 11 11 11 11 11 11 11 11 11 11 11 11 11
11 11 11 11 11 11 11 11 11 11 11 11 11 11 11 11 11 11 11 11 11 11 11 11 11 11 11 11 11 11
---
11 11 11 11 11 11 11 11 11 11 11 11 11 11 11 11 11 11 11 11 11 11 11 11 11 11 11 11 11 11
11 11 11 11 11 11 11 11 11 11 11 11 11 6 11 11 9 11 11 11 11 11 11 11 11 11 11 11 11 11
11 11 11 11 1 1 15 15 15 15 11 11 6 15 6 11 11 11 11 11 15 15 15 15 15 15 11 11 11 11
11 11 11 1 1 3 3 3 3 15 15 15 15 6 15 15 15 15 15 15 15 10 10 10 10 15 15 11 11 11
11 11 1 1 3 1 1 1 1 3 15 15 3 6 10 10 10 10 15 15 10 1 1 1 1 10 15 15 11 11
11 11 1 3 1 1 1 1 1 1 3 3 1 1 1 1 1 1 10 10 1 1 1 1 1 1 10 15 11 11
11 11 1 3 1 1 1 1 1 1 1 1 1 1 1 1 1 1 1 1 1 1 1 1 1 1 10 15 11 11
11 11 1 3 1 1 1 1 1 1 1 1 18 18 18 18 18 18 1 1 1 1 1 1 1 1 10 15 11 11
11 11 1 3 1 1 1 1 1 1 18 18 18 18 18 18 18 18 18 18 1 1 1 1 1 1 10 15 11 11
11 11 1 1 3 3 1 1 18 18 18 18 18 18 18 18 18 18 18 18 18 18 1 1 10 10 15 15 11 11
11 11 9 1 1 1 3 18 18 18 18 18 18 18 18 18 18 18 18 18 18 18 10 10 10 10 10 11 11 11
11 11 11 11 1 3 18 18 18 18 18 18 18 18 18 18 18 18 18 18 18 18 10 10 10 10 11 9 11 11
11 11 9 1 1 3 18 18 18 18 18 18 3 3 3 3 3 3 18 18 18 18 10 10 10 10 9 10 9 9
11 9 8 10 3 18 18 18 18 18 3 3 3 3 3 3 3 3 3 3 18 18 10 10 10 14 10 9 11 11
9 8 9 14 10 18 18 18 3 3 3 3 3 3 3 3 3 3 3 3 3 3 10 10 10 14 10 9 11 11
11 9 8 10 14 18 18 3 3 3 3 3 3 3 7 7 3 3 3 3 3 3 3 10 10 14 10 11 11 11
11 11 9 6 6 14 18 3 3 3 3 7 7 7 7 7 7 7 7 3 3 3 3 10 14 3 3 11 11 11
11 11 11 11 6 6 14 14 3 7 7 7 7 7 7 7 7 7 7 7 7 3 14 14 3 3 11 11 11 11
11 11 9 11 11 6 6 6 14 7 7 7 7 14 14 14 14 7 7 7 7 14 3 3 3 11 11 11 11 11
11 11 11 11 11 6 6 14 7 7 14 14 14 14 14 14 14 14 14 14 7 7 14 6 6 11 11 10 11 11
11 11 11 11 11 6 14 7 14 14 14 14 14 14 14 14 14 14 14 14 14 14 7 14 6 11 11 11 11 11
11 11 11 11 11 6 14 14 14 14 14 14 14 14 14 14 14 14 14 14 14 14 14 14 6 11 11 10 11 11
11 11 11 11 11 6 6 14 14 14 14 14 14 14 14 14 14 14 14 14 14 14 14 6 6 11 10 14 10 11
11 11 11 10 11 11 6 6 6 14 14 14 14 14 14 14 14 14 14 14 14 6 6 6 11 10 14 10 14 10
11 10 10 14 10 11 11 11 6 14 14 14 14 14 14 14 14 14 14 14 14 6 11 11 11 11 10 14 10 11
11 11 11 10 11 11 11 11 6 14 14 14 14 14 6 6 14 14 14 14 14 6 11 11 11 11 11 10 11 11
11 11 11 10 11 11 9 11 6 6 14 14 14 6 6 6 6 14 14 14 6 6 11 11 11 11 11 11 11 11
11 11 11 10 11 11 11 11 11 6 6 6 6 6 11 11 6 6 6 6 6 11 11 9 11 11 11 10 11 11
11 11 11 11 11 11 11 11 11 11 11 11 11 11 11 11 11 11 11 11 11 11 11 11 11 11 11 11 11 11
11 11 11 11 11 11 11 11 11 11 11 11 11 11 11 11 11 11 11 11 11 11 11 11 11 11 11 11 11 11
