4 4 4 4 4 4 4 4 4 4 4 4 4 4 4 4 4 4 4 4 4 4 4 4 4 4 4 4 4 4
4 4 4 4 14 4 4 4 4 4 1 1 1 1 1 1 1 1 1 14 4 4 4 4 4 4 4 14 4 4
4 4 4 14 14 14 4 4 1 14 1 1 1 14 14 14 1 1 14 14 14 4 4 4 4 4 4 4 4 4
4 4 14 14 4 14 14 1 1 1 1 1 1 14 17 14 1 1 1 14 1 1 4 4 4 4 4 4 4 4
4 4 4 14 14 14 1 1 1 1 1 1 14 14 5 14 1 1 1 1 1 1 1 4 14 4 4 4 4 4
4 4 4 4 14 1 1 1 1 1 1 1 14 17 5 14 14 1 1 1 1 1 1 14 14 14 4 4 4 4
4 4 4 4 4 1 1 1 1 1 1 14 14 17 5 5 14 1 1 1 1 1 14 14 4 14 14 4 4 4
4 14 4 4 1 1 1 1 1 1 1 14 17 5 5 5 14 14 1 1 1 1 1 14 14 14 4 4 14 4
4 4 4 4 1 1 1 1 1 1 14 14 5 5 5 5 17 14 14 1 1 1 1 1 14 4 4 1 4 4
4 1 4 4 1 1 1 1 1 14 14 5 5 6 9 5 5 17 14 14 1 1 1 1 1 4 4 1 4 4
4 1 4 4 14 1 1 1 1 14 5 5 6 9 14 15 5 5 6 14 1 1 14 1 1 4 4 1 4 4
4 1 4 14 14 14 1 1 1 14 14 6 17 9 15 9 6 14 14 14 1 1 1 1 1 4 1 4 4 4
4 4 1 4 14 1 1 1 1 14 14 17 17 17 9 5 17 17 14 14 1 1 1 1 1 4 1 4 1 4
4 4 1 4 1 1 1 1 14 14 17 5 5 5 17 17 5 17 17 14 14 1 1 1 1 4 14 4 1 4
4 4 1 4 1 1 14 14 14 17 5 5 5 5 5 5 5 5 17 17 14 14 14 1 1 14 4 14 4 4
4 4 4 4 1 1 14 5 17 5 5 5 6 6 5 5 6 5 5 17 17 17 14 1 1 4 14 4 4 4
4 14 4 4 4 1 14 14 5 5 17 6 6 17 17 5 5 6 6 5 14 14 14 1 4 4 4 4 4 4
4 4 4 4 4 1 1 14 14 14 14 15 17 2 17 2 17 17 17 14 14 1 1 1 4 4 4 4 4 4
4 4 4 4 4 4 14 14 14 17 17 17 17 17 17 17 17 9 9 17 14 14 14 4 4 4 4 4 4 4
4 4 4 4 14 14 14 5 9 9 17 5 5 5 5 5 9 14 15 9 17 17 14 14 4 4 4 4 4 4
4 4 4 14 14 17 5 9 15 14 9 5 5 5 6 5 9 15 15 9 17 15 17 14 14 14 4 4 14 4
4 4 4 14 5 5 5 9 15 15 15 5 5 6 5 5 5 9 9 5 5 5 5 5 5 14 4 4 4 4
4 4 4 14 14 14 17 17 9 9 17 5 6 6 5 6 5 17 17 5 6 6 14 14 14 14 4 4 4 4
4 4 4 4 4 14 14 17 17 17 5 6 6 16 17 16 6 6 17 17 17 14 14 4 4 4 4 4 4 4
4 4 4 14 4 4 14 14 14 14 14 14 16 2 2 2 16 14 14 14 14 14 4 4 4 4 4 4 4 4
4 4 14 14 14 4 4 4 4 4 4 14 16 16 2 2 16 14 4 4 4 4 4 4 4 4 14 4 4 4
4 14 14 4 14 14 4 4 4 4 14 14 16 2 2 16 16 14 14 4 4 4 4 4 4 14 14 14 4 4
4 4 14 14 14 4 4 4 4 4 14 16 2 2 2 16 16 16 14 4 4 4 4 4 4 4 14 4 4 4
4 4 4 14 4 4 4 4 4 4 14 14 14 14 14 14 14 14 14 4 4 4 4 4 4 4 4 4 4 4
4 4 4 4 4 4 4 4 4 4 4 4 4 4 4 4 4 4 4 4 4 4 4 4 4 4 4 4 4 4
---
4 4 4 4 4 4 4 4 4 4 4 4 4 4 4 4 4 4 4 4 4 4 4 4 4 4 4 4 4 4
4 4 4 4 9 4 4 4 4 4 14 14 14 14 14 14 14 14 14 1 4 4 4 4 4 4 4 5 4 4
4 4 4 9 9 9 4 4 14 1 14 14 14 17 17 17 14 14 1 1 1 4 4 4 4 4 4 4 4 4
4 4 9 9 9 9 9 14 14 14 14 14 14 17 17 17 14 14 14 1 14 14 4 4 4 4 4 4 4 4
4 4 4 9 9 9 14 14 14 14 14 14 17 17 1 17 14 14 14 14 14 14 14 4 6 4 4 4 4 4
4 4 4 4 9 14 14 14 14 14 14 14 17 1 1 17 17 14 14 14 14 14 14 6 6 6 4 4 4 4
4 4 4 4 4 14 14 14 14 14 14 17 17 1 1 1 17 14 14 14 14 14 6 6 6 6 6 4 4 4
4 5 4 4 14 14 14 14 14 14 14 17 1 1 1 1 17 17 14 14 14 14 14 6 6 6 4 4 2 4
4 4 4 4 14 14 14 14 14 14 17 17 1 1 1 1 1 17 17 14 14 14 14 14 6 4 4 2 4 4
4 15 4 4 14 14 14 14 14 17 17 1 1 1 1 1 1 1 17 17 14 14 14 14 14 4 4 2 4 4
4 15 4 4 15 14 14 14 14 17 1 1 1 1 1 1 1 1 1 17 14 14 9 14 14 4 4 2 4 4
4 15 4 15 15 15 14 14 14 17 17 1 1 1 1 1 1 17 17 17 14 14 14 14 14 4 2 4 4 4
4 4 15 4 15 14 14 14 14 17 17 1 1 1 1 14 1 1 17 17 14 14 14 14 14 4 2 4 2 4
4 4 15 4 14 14 14 14 17 17 1 14 14 14 1 1 14 1 1 17 17 14 14 14 14 4 2 4 2 4
4 4 15 4 14 14 17 17 17 1 14 14 14 14 14 14 14 14 1 1 17 17 17 14 14 2 4 2 4 4
4 4 4 4 14 14 17 14 1 14 14 14 14 14 14 14 14 14 14 1 1 1 6 14 14 4 2 4 4 4
4 16 4 4 4 14 17 17 14 14 14 14 14 1 1 14 14 14 14 14 6 6 6 14 4 4 4 4 4 4
4 4 4 4 4 14 14 17 17 17 17 14 1 14 1 14 1 1 1 6 6 14 14 14 4 4 4 4 4 4
4 4 4 4 4 4 17 17 17 1 1 1 1 1 1 1 1 1 1 1 6 6 6 4 4 4 4 4 4 4
4 4 4 4 5 17 17 1 1 1 1 1 1 1 1 1 1 1 4 1 1 1 6 5 4 4 4 4 4 4
4 4 4 5 5 1 1 1 1 1 1 1 1 1 1 1 1 4 4 1 1 1 1 5 5 5 4 4 9 4
4 4 4 5 1 1 1 1 1 1 1 1 1 1 1 1 1 1 1 1 1 1 1 1 1 5 4 4 4 4
4 4 4 5 5 5 1 1 1 1 1 1 1 1 1 1 1 1 1 1 1 1 5 5 5 5 4 4 4 4
4 4 4 4 4 5 5 1 1 1 1 1 1 5 5 5 1 1 1 1 1 5 5 4 4 4 4 4 4 4
4 4 4 16 4 4 5 5 5 5 5 5 5 5 5 5 5 5 5 5 5 5 4 4 4 4 4 4 4 4
4 4 16 16 16 4 4 4 4 4 4 5 5 5 5 5 5 5 4 4 4 4 4 4 4 4 9 4 4 4
4 16 16 16 16 16 4 4 4 4 5 5 5 5 5 5 5 5 5 4 4 4 4 4 4 9 9 9 4 4
4 4 16 16 16 4 4 4 4 4 5 5 5 5 5 5 5 5 5 4 4 4 4 4 4 4 9 4 4 4
4 4 4 16 4 4 4 4 4 4 5 5 5 5 5 5 5 5 5 4 4 4 4 4 4 4 4 4 4 4
4 4 4 4 4 4 4 4 4 4 4 4 4 4 4 4 4 4 4 4 4 4 4 4 4 4 4 4 4 4
