0 0 0 0 0 10 10 10 0 0 0 0 0
0 0 7 7 0 10 10 10 0 7 7 0 0
0 7 7 7 7 10 10 10 7 7 7 7 0
0 7 7 7 7 10 10 10 7 7 7 7 0
0 0 7 7 7 15 15 15 7 7 7 0 0
10 10 10 10 15 15 15 15 15 10 10 10 10
10 10 10 10 15 15 15 15 15 10 10 10 10
10 10 10 10 15 15 15 15 15 10 10 10 10
0 0 7 7 7 15 15 15 7 7 7 0 0
0 7 7 7 7 10 10 10 7 7 7 7 0
0 7 7 7 7 10 10 10 7 7 7 7 0
0 0 7 7 0 10 10 10 0 7 7 0 0
0 0 0 0 0 10 10 10 0 0 0 0 0
0 0 0 0 0 0 6 0 0 0 0 0 0
0 0 0 0 0 0 6 0 0 0 0 0 6
6 0 0 0 0 0 6 0 0 0 0 0 6
6 6 6 6 0 0 6 0 0 6 6 6 6
0 6 6 6 6 0 6 0 6 6 6 6 0
0 0 6 6 6 6 6 6 6 6 6 0 0
0 0 0 6 6 6 6 6 6 6 0 0 0
0 0 0 0 0 6 6 6 0 0 0 0 0
0 0 0 0 0 0 6 0 0 0 0 0 0
0 0 0 0 0 0 6 0 0 0 0 0 0
