14 14 14 14 14 14 6 6 6 14 14 14 14 14
14 14 14 14 6 6 6 6 17 17 14 14 14 14
14 14 14 6 6 6 17 17 17 17 17 14 14 14
14 14 14 6 6 17 17 17 17 17 17 14 14 14
14 14 14 14 17 17 17 17 17 14 14 14 14 14
14 14 6 6 6 6 17 17 17 17 14 6 6 14
14 6 6 6 17 6 6 6 17 6 6 6 17 17
6 6 17 17 17 6 17 17 17 6 6 17 17 17
6 6 17 17 6 17 17 17 14 6 17 17 17 17
17 17 17 17 17 14 16 16 14 16 16 17 17 14
14 17 17 14 16 16 16 16 16 16 14 14 14 14
14 14 14 14 14 14 16 16 14 14 14 14 14 14
14 14 14 14 14 16 16 16 14 14 14 14 14 14
14 14 14 14 16 16 16 16 16 14 14 14 14 14
---
6 6 6 6 6 14 14 14 14 14 14 14 6 6
6 6 6 6 6 14 14 14 14 14 14 14 14 6
6 6 6 6 6 14 14 14 14 14 14 14 14 6
6 6 6 6 6 14 14 14 14 14 14 14 14 6
6 6 14 14 14 14 14 14 14 14 14 14 14 6
6 14 14 14 14 14 14 14 14 14 14 14 14 6
14 14 14 14 14 14 14 14 14 14 14 14 14 6
14 14 14 14 14 14 14 14 14 14 14 14 14 6
14 14 14 14 17 17 17 14 14 14 6 6 6 6
17 17 17 16 16 16 16 17 17 17 17 17 17 17
17 17 16 16 16 16 16 17 17 17 17 17 17 17
17 17 17 16 16 16 16 17 17 17 17 17 17 17
17 17 17 16 16 16 16 17 17 17 17 17 17 17
17 17 17 16 16 16 17 17 17 17 17 17 17 17
