15 16 16 15 15 15 15 16 16 15 15 15
15 16 9 16 15 15 16 9 16 15 15 15
15 16 9 9 16 16 9 9 16 15 16 15
16 9 9 9 9 9 9 9 9 16 9 16
16 9 9 9 9 9 9 9 9 16 9 16
16 9 9 9 9 9 9 9 9 16 16 9
16 9 9 18 9 9 18 9 9 16 16 9
16 16 9 18 8 8 18 9 9 16 16 9
15 16 16 8 8 8 8 9 1 9 9 9
15 15 16 1 1 1 1 1 1 9 9 16
15 15 16 9 9 9 9 9 9 9 9 16
15 15 16 8 16 8 16 16 8 16 8 16
