3 3 3 3 3 15 15 15 15 13 13 3 3 3 3 3 3 3 3 13 13 15 15 15 15 3 3 3 3 3
10 3 3 3 3 3 15 15 14 14 14 14 14 14 14 14 3 3 3 13 15 15 15 15 3 3 3 3 3 10
10 10 3 3 3 3 15 14 14 18 18 18 18 18 18 14 14 3 3 13 15 15 15 15 3 3 3 3 10 10
10 10 10 3 3 3 14 14 18 9 14 14 9 9 9 18 14 14 13 15 15 15 15 3 3 3 3 10 10 10
13 10 10 10 3 3 14 18 9 14 14 14 14 9 9 9 18 14 13 15 15 15 3 3 3 3 10 10 10 13
13 13 10 10 10 3 14 18 9 9 14 14 9 9 9 13 18 14 15 15 15 15 3 3 3 10 10 10 13 13
15 13 13 10 10 10 14 18 9 9 9 9 9 9 9 13 18 14 15 15 15 3 3 3 10 10 10 13 13 15
15 15 13 13 10 10 14 18 9 9 9 9 9 9 13 13 18 14 15 15 3 3 3 10 10 10 13 13 15 15
3 15 15 13 13 10 14 18 13 9 9 9 13 13 13 13 18 14 15 15 3 3 10 10 10 13 13 15 15 3
3 3 15 15 13 13 14 14 18 13 13 13 13 13 13 18 14 14 15 3 3 10 10 10 13 13 15 15 3 3
3 3 3 15 15 13 10 14 14 18 18 18 18 18 18 14 14 14 14 3 10 10 10 13 13 15 15 3 3 3
3 3 3 3 15 15 13 10 14 14 18 14 14 18 18 18 18 18 14 14 14 10 10 13 15 15 3 3 3 3
13 3 3 3 3 15 15 14 14 18 18 14 14 18 18 14 14 15 18 18 14 14 14 15 15 3 3 3 3 13
15 13 3 3 3 14 14 14 18 1 18 14 14 18 1 18 15 15 15 15 18 18 14 14 14 3 3 3 13 15
15 15 13 14 14 14 18 18 18 14 1 18 18 1 1 18 15 15 15 15 15 15 18 18 14 14 14 13 15 15
15 15 14 14 18 18 14 15 18 1 14 14 14 1 1 18 15 15 15 15 10 10 15 14 18 18 14 14 15 15
15 15 14 18 18 14 15 15 15 18 18 1 1 18 18 15 15 15 15 10 10 10 15 15 15 18 18 14 15 15
15 15 14 18 14 14 15 15 15 15 18 18 18 18 15 15 5 5 15 11 11 11 15 15 14 14 18 14 15 15
13 15 14 18 3 3 14 14 15 15 15 15 15 15 15 5 5 5 15 15 15 15 14 14 1 1 18 14 15 13
10 13 14 18 3 3 3 3 14 14 15 15 15 15 15 17 17 17 15 15 14 14 1 1 1 1 18 14 13 10
10 10 14 18 4 3 3 3 3 3 14 14 15 15 15 15 15 15 14 14 1 1 1 1 1 4 18 14 10 10
10 10 14 14 18 4 4 3 3 3 3 3 14 14 15 15 14 14 1 1 1 1 1 4 4 18 14 14 10 10
10 10 10 14 18 18 4 4 3 3 3 3 3 3 14 14 1 1 1 1 1 1 4 4 18 18 14 10 10 10
6 6 5 14 14 14 18 18 4 4 3 3 3 3 3 1 1 1 1 1 4 4 18 18 14 14 14 5 6 6
6 6 5 5 6 14 14 14 18 18 4 4 3 3 3 1 1 1 4 4 18 18 14 14 14 6 5 5 6 6
5 5 6 6 5 5 6 14 14 14 18 18 4 4 3 1 4 4 18 18 14 14 14 6 5 5 6 6 5 5
5 5 6 6 5 5 6 6 5 14 14 14 18 18 4 4 18 18 14 14 14 5 6 6 5 5 6 6 5 5
6 6 5 5 6 6 5 5 6 6 5 14 14 14 18 18 14 14 14 5 6 6 5 5 6 6 5 5 6 6
6 6 5 5 6 6 5 5 6 6 5 5 6 14 14 14 14 6 5 5 6 6 5 5 6 6 5 5 6 6
5 5 6 6 5 5 6 6 5 5 6 6 5 5 6 6 5 5 6 6 5 5 6 6 5 5 6 6 5 5
---
14 14 14 14 14 14 14 14 14 14 14 14 14 14 14 14 14 14 14 15 15 14 14 14 14 14 14 14 14 14
14 14 14 14 14 14 14 14 15 15 15 15 15 15 15 15 14 14 14 15 14 14 14 14 14 14 14 14 14 14
14 14 14 14 14 14 14 10 10 3 3 3 3 3 3 15 15 14 14 15 14 14 14 14 14 14 14 14 14 14
14 14 14 14 14 14 10 10 3 10 10 10 10 10 10 3 15 15 15 14 14 14 14 14 14 14 14 14 14 14
5 14 14 14 14 14 10 3 10 10 10 10 10 10 10 10 3 15 15 14 14 14 14 14 14 14 14 14 14 6
5 5 14 14 14 14 10 3 10 10 10 10 10 10 10 10 3 15 14 14 14 14 14 14 14 14 14 14 6 6
5 5 5 14 14 14 10 3 10 10 10 10 10 10 10 10 3 9 14 14 14 14 14 14 14 14 14 6 6 6
5 5 5 5 14 14 10 3 10 10 10 10 10 10 10 10 3 9 14 14 14 14 14 14 14 14 6 6 6 6
5 5 5 5 5 5 10 3 10 10 10 10 10 10 10 10 3 9 14 14 14 14 14 14 14 6 6 6 6 6
5 5 5 5 5 5 10 10 3 10 10 10 10 10 10 3 9 9 14 14 14 14 14 14 6 6 6 6 6 6
5 5 5 5 5 5 4 10 10 3 3 3 3 3 3 9 9 9 9 14 14 14 14 6 6 6 6 6 6 6
5 5 5 5 5 5 5 4 10 10 3 4 4 3 3 3 3 3 9 9 9 14 14 6 6 6 6 6 6 6
5 5 5 5 5 5 5 1 1 3 3 4 4 3 3 4 4 13 3 3 9 9 9 6 6 6 6 6 6 10
5 5 5 5 5 1 1 1 3 4 3 4 4 3 4 3 13 13 13 13 3 3 9 9 9 6 6 6 10 6
5 5 5 1 1 1 3 3 3 4 4 3 3 4 4 3 13 13 13 13 13 13 3 3 9 9 9 10 6 6
5 5 1 1 3 3 1 13 3 4 4 4 4 4 4 3 13 13 13 13 18 18 13 1 3 3 9 9 6 6
5 5 1 3 3 1 13 13 13 3 3 4 4 3 3 13 13 13 13 18 18 18 13 14 14 3 3 9 6 6
5 5 1 3 1 1 13 13 13 13 3 3 3 3 13 13 18 18 13 18 18 18 13 13 1 1 3 9 6 6
5 5 1 3 18 18 1 1 13 13 13 13 13 13 13 18 18 18 13 13 13 13 1 1 18 18 3 9 6 6
5 5 1 3 18 18 18 18 1 1 13 13 13 13 13 18 18 18 13 13 1 1 18 18 18 18 3 9 6 6
5 5 1 3 18 18 18 18 18 18 1 1 13 13 13 13 13 13 1 1 18 18 18 18 18 18 3 9 6 6
5 5 1 11 3 18 18 18 18 18 18 18 1 1 13 13 1 1 18 18 18 18 18 18 18 3 17 9 6 6
5 5 5 11 3 3 18 18 18 18 18 18 18 18 1 1 18 18 18 18 18 18 18 18 3 3 17 6 6 6
15 15 15 11 3 3 3 3 18 18 18 18 18 18 18 18 18 18 18 18 18 18 3 3 3 3 17 15 15 15
15 15 15 15 15 3 3 3 3 3 18 18 18 18 18 18 18 18 18 18 3 3 3 3 3 15 15 15 15 15
15 15 15 15 15 15 15 3 3 3 3 3 18 18 18 18 18 18 3 3 3 3 3 15 15 15 15 15 15 15
15 15 15 15 15 15 15 15 15 3 3 3 3 3 18 18 3 3 3 3 3 15 15 15 15 15 15 15 15 15
15 15 15 15 15 15 15 15 15 15 15 3 3 3 3 3 3 3 3 15 15 15 15 15 15 15 15 15 15 15
15 15 15 15 15 15 15 15 15 15 15 15 15 3 3 3 3 15 15 15 15 15 15 15 15 15 15 15 15 15
15 15 15 15 15 15 15 15 15 15 15 15 15 15 15 15 15 15 15 15 15 15 15 15 15 15 15 15 15 15
